state_name,active,recovered,death,new_active,new_cured,new_death,new_positive,confirmed,Date
Andaman and Nicobar Islands,147,4820,62,152,3469,52,3673,4941,2021-01-01 17:39:44
Andhra Pradesh,78836,871588,7104,74518,551821,5410,631749,881948,2021-01-01 17:39:44
Arunachal Pradesh,1964,16549,56,1939,5643,13,7595,16711,2021-01-01 17:39:44
Assam,28780,211838,1043,29609,129133,578,159320,216139,2021-01-01 17:39:44
Bihar,13005,245156,1393,12539,156242,870,169651,251348,2021-01-01 17:39:44
Chandigarh,2821,18967,316,2761,7411,126,10298,19682,2021-01-01 17:39:44
Chhattisgarh,37853,263251,3350,37927,49564,690,88181,278540,2021-01-01 17:39:44
Dadra and Nagar Haveli and Daman and Diu,229,3364,2,220,2711,2,2933,3375,2021-01-01 17:39:44
Delhi,32097,608434,10523,30941,213304,5014,249259,624795,2021-01-01 17:39:44
Goa,5781,49313,737,5667,22726,360,28753,50981,2021-01-01 17:39:44
Gujarat,16208,229977,4302,16305,104964,3336,124605,244258,2021-01-01 17:39:44
Haryana,21411,255356,2899,21014,90884,1177,113075,262054,2021-01-01 17:39:44
Himachal Pradesh,4444,51387,931,4458,7853,127,12438,55114,2021-01-01 17:39:44
Jammu and Kashmir,22032,115830,1880,21887,42115,1024,65026,120744,2021-01-01 17:39:44
Jharkhand,13791,112206,1027,13504,58543,626,72673,114873,2021-01-01 17:39:44
Karnataka,98062,894834,12081,95354,423377,8145,526876,918544,2021-01-01 17:39:44
Kerala,39484,687104,3042,39354,98724,553,138631,755718,2021-01-01 17:39:44
Ladakh,1013,9132,127,1047,2735,50,3832,9447,2021-01-01 17:39:44
Lakshadweep,0,0,0,0,0,0,0,0,2021-01-01 17:39:44
Madhya Pradesh,22300,227965,3595,22542,83618,2007,108167,240947,2021-01-01 17:39:44
Maharashtra,291630,1824934,49463,275017,916348,33015,1224380,1928603,2021-01-01 17:39:44
Manipur,2070,26601,354,2113,6838,59,9010,28137,2021-01-01 17:39:44
Meghalaya,2111,13085,139,2169,2527,37,4733,13408,2021-01-01 17:39:44
Mizoram,583,4091,8,680,1012,0,1692,4204,2021-01-01 17:39:44
Nagaland,1184,11624,79,1052,4477,15,5544,11921,2021-01-01 17:39:44
Odisha,33504,325103,1871,34033,149379,710,184122,329306,2021-01-01 17:39:44
Puducherry,4908,37100,633,4659,18065,467,23191,38096,2021-01-01 17:39:44
Punjab,22278,157043,5331,21661,75409,2860,99930,166239,2021-01-01 17:39:44
Rajasthan,18184,295030,2689,18245,97284,1352,116881,307554,2021-01-01 17:39:44
Sikkim,469,5218,127,513,1986,29,2528,5877,2021-01-01 17:39:44
Tamil Nadu,46703,796353,12109,46495,491971,8871,547337,817077,2021-01-01 17:39:44
Telengana,29636,278839,1541,29649,144073,1052,174774,286354,2021-01-01 17:39:44
Tripura,6566,32751,385,6700,15883,251,22834,33264,2021-01-01 17:39:44
Uttarakhand,12455,562459,8352,12075,29201,501,41777,584966,2021-01-01 17:39:44
Uttar Pradesh,65954,84149,1504,64164,289594,5135,358893,90616,2021-01-01 17:39:44
West Bengal,24806,528829,9683,24898,198983,4421,228302,550893,2021-01-01 17:39:44
Andaman and Nicobar Islands,54,4830,62,48,4837,62,4947,4946,2021-01-03 20:00:03.072053
Andhra Pradesh,3238,872266,7108,3194,872545,7111,882850,882612,2021-01-03 20:00:03.072053
Arunachal Pradesh,97,16566,56,95,16576,56,16727,16719,2021-01-03 20:00:03.072053
Assam,3210,211992,1049,3166,212072,1051,216289,216251,2021-01-03 20:00:03.072053
Bihar,4945,245874,1400,4792,246389,1403,252584,252219,2021-01-03 20:00:03.072053
Chandigarh,372,19109,318,320,19226,319,19865,19799,2021-01-03 20:00:03.072053
Chhattisgarh,11344,265788,3375,10517,267751,3386,281654,280507,2021-01-03 20:00:03.072053
Dadra and Nagar Haveli and Daman and Diu,11,3365,2,11,3365,2,3378,3378,2021-01-03 20:00:03.072053
Delhi,5358,610039,10557,5342,610535,10571,626448,625954,2021-01-03 20:00:03.072053
Goa,930,49466,739,921,49570,739,51230,51135,2021-01-03 20:00:03.072053
Gujarat,9663,231800,4309,9477,232722,4314,246513,245772,2021-01-03 20:00:03.072053
Haryana,3314,256386,2911,3124,256811,2915,262850,262611,2021-01-03 20:00:03.072053
Himachal Pradesh,2394,52140,936,2202,52479,938,55619,55470,2021-01-03 20:00:03.072053
Jammu and Kashmir,3016,116327,1884,2999,116587,1885,121471,121227,2021-01-03 20:00:03.072053
Jharkhand,1682,112529,1030,1624,112734,1034,115392,115241,2021-01-03 20:00:03.072053
Karnataka,11077,897200,12096,10853,898176,12099,921128,920373,2021-01-03 20:00:03.072053
Kerala,65238,697591,3095,65560,702576,3116,771252,765924,2021-01-03 20:00:03.072053
Ladakh,245,9153,127,260,9163,127,9550,9525,2021-01-03 20:00:03.072053
Lakshadweep,0,0,0,0,0,0,0,0,2021-01-03 20:00:03.072053
Madhya Pradesh,9222,229731,3618,9089,230586,3627,243302,242571,2021-01-03 20:00:03.072053
Maharashtra,53231,1832825,49580,54288,1834935,49631,1938854,1935636,2021-01-03 20:00:03.072053
Manipur,1108,26742,356,1104,26782,357,28243,28206,2021-01-03 20:00:03.072053
Meghalaya,164,13142,139,136,13173,139,13448,13445,2021-01-03 20:00:03.072053
Mizoram,111,4100,8,104,4111,8,4223,4219,2021-01-03 20:00:03.072053
Nagaland,191,11659,79,186,11664,79,11929,11929,2021-01-03 20:00:03.072053
Odisha,2257,325733,1876,2272,325965,1880,330117,329866,2021-01-03 20:00:03.072053
Puducherry,366,37165,633,346,37195,633,38174,38164,2021-01-03 20:00:03.072053
Punjab,3517,157904,5349,3429,158219,5364,167012,166770,2021-01-03 20:00:03.072053
Rajasthan,9223,296929,2700,8795,297819,2705,309319,308852,2021-01-03 20:00:03.072053
Sikkim,534,5238,128,530,5252,129,5911,5900,2021-01-03 20:00:03.072053
Tamil Nadu,8380,798420,12135,8272,799427,12146,819845,818935,2021-01-03 20:00:03.072053
Telengana,5571,279991,1546,5388,280565,1549,287502,287108,2021-01-03 20:00:03.072053
Tripura,96,32795,385,88,32809,385,33282,33276,2021-01-03 20:00:03.072053
Uttarakhand,4577,85189,1515,4364,85658,1522,91544,91281,2021-01-03 20:00:03.072053
Uttar Pradesh,13831,564541,8379,13316,565731,8387,587434,586751,2021-01-03 20:00:03.072053
West Bengal,11616,531862,9738,11008,533305,9766,554079,553216,2021-01-03 20:00:03.072053
Andaman and Nicobar Islands,48,4837,62,40,4846,62,4948,4947,2021-01-04 20:07:09.142390
Andhra Pradesh,3194,872545,7111,3070,872897,7115,883082,882850,2021-01-04 20:07:09.142390
Arunachal Pradesh,95,16576,56,93,16583,56,16732,16727,2021-01-04 20:07:09.142390
Assam,3166,212072,1051,3120,212132,1052,216304,216289,2021-01-04 20:07:09.142390
Bihar,4792,246389,1403,4473,246979,1405,252857,252584,2021-01-04 20:07:09.142390
Chandigarh,320,19226,319,281,19280,320,19881,19865,2021-01-04 20:07:09.142390
Chhattisgarh,10517,267751,3386,9980,268988,3400,282368,281654,2021-01-04 20:07:09.142390
Dadra and Nagar Haveli and Daman and Diu,11,3365,2,9,3368,2,3379,3378,2021-01-04 20:07:09.142390
Delhi,5342,610535,10571,5044,611243,10585,626872,626448,2021-01-04 20:07:09.142390
Goa,921,49570,739,901,49653,741,51295,51230,2021-01-04 20:07:09.142390
Gujarat,9477,232722,4314,9250,233660,4318,247228,246513,2021-01-04 20:07:09.142390
Haryana,3124,256811,2915,2890,257261,2917,263068,262850,2021-01-04 20:07:09.142390
Himachal Pradesh,2202,52479,938,1830,52912,944,55686,55619,2021-01-04 20:07:09.142390
Jammu and Kashmir,2999,116587,1885,2975,116792,1886,121653,121471,2021-01-04 20:07:09.142390
Jharkhand,1624,112734,1034,1601,112893,1035,115529,115392,2021-01-04 20:07:09.142390
Karnataka,10853,898176,12099,10912,898919,12107,921938,921128,2021-01-04 20:07:09.142390
Kerala,65560,702576,3116,65467,707244,3141,775852,771252,2021-01-04 20:07:09.142390
Ladakh,260,9163,127,256,9173,127,9556,9550,2021-01-04 20:07:09.142390
Lakshadweep,0,0,0,0,0,0,0,0,2021-01-04 20:07:09.142390
Madhya Pradesh,9089,230586,3627,8852,231533,3641,244026,243302,2021-01-04 20:07:09.142390
Maharashtra,54288,1834935,49631,55471,1836999,49666,1942136,1938854,2021-01-04 20:07:09.142390
Manipur,1104,26782,357,1108,26815,358,28281,28243,2021-01-04 20:07:09.142390
Meghalaya,136,13173,139,135,13186,139,13460,13448,2021-01-04 20:07:09.142390
Mizoram,104,4111,8,88,4127,8,4223,4223,2021-01-04 20:07:09.142390
Nagaland,186,11664,79,178,11673,79,11930,11929,2021-01-04 20:07:09.142390
Odisha,2272,325965,1880,2217,326209,1883,330309,330117,2021-01-04 20:07:09.142390
Puducherry,346,37195,633,358,37233,633,38224,38174,2021-01-04 20:07:09.142390
Punjab,3429,158219,5364,3361,158482,5376,167219,167012,2021-01-04 20:07:09.142390
Rajasthan,8795,297819,2705,8491,298620,2710,309821,309319,2021-01-04 20:07:09.142390
Sikkim,530,5252,129,506,5285,129,5920,5911,2021-01-04 20:07:09.142390
Tamil Nadu,8272,799427,12146,8127,800429,12156,820712,819845,2021-01-04 20:07:09.142390
Telengana,5388,280565,1549,5106,281083,1551,287740,287502,2021-01-04 20:07:09.142390
Tripura,88,32809,385,83,32815,385,33283,33282,2021-01-04 20:07:09.142390
Uttarakhand,4364,85658,1522,4376,85908,1527,91811,91544,2021-01-04 20:07:09.142390
Uttar Pradesh,13316,565731,8387,12858,566910,8403,588171,587434,2021-01-04 20:07:09.142390
West Bengal,11008,533305,9766,10446,534737,9792,554975,554079,2021-01-04 20:07:09.142390
Andaman and Nicobar Islands,40,4846,62,38,4848,62,4948,4948,2021-01-05 20:22:45.109229
Andhra Pradesh,3070,872897,7115,2943,873149,7118,883210,883082,2021-01-05 20:22:45.109229
Arunachal Pradesh,93,16583,56,87,16598,56,16741,16732,2021-01-05 20:22:45.109229
Assam,3120,212132,1052,3087,212199,1054,216340,216304,2021-01-05 20:22:45.109229
Bihar,4473,246979,1405,4380,247484,1408,253272,252857,2021-01-05 20:22:45.109229
Chandigarh,281,19280,320,267,19348,321,19936,19881,2021-01-05 20:22:45.109229
Chhattisgarh,9980,268988,3400,9766,270337,3412,283515,282368,2021-01-05 20:22:45.109229
Dadra and Nagar Haveli and Daman and Diu,9,3368,2,8,3369,2,3379,3379,2021-01-05 20:22:45.109229
Delhi,5044,611243,10585,4689,611970,10597,627256,626872,2021-01-05 20:22:45.109229
Goa,901,49653,741,851,49741,743,51335,51295,2021-01-05 20:22:45.109229
Gujarat,9250,233660,4318,9047,234558,4321,247926,247228,2021-01-05 20:22:45.109229
Haryana,2890,257261,2917,2737,257652,2923,263312,263068,2021-01-05 20:22:45.109229
Himachal Pradesh,1830,52912,944,1646,53216,946,55808,55686,2021-01-05 20:22:45.109229
Jammu and Kashmir,2975,116792,1886,2684,117211,1891,121786,121653,2021-01-05 20:22:45.109229
Jharkhand,1601,112893,1035,1528,113125,1036,115689,115529,2021-01-05 20:22:45.109229
Karnataka,10912,898919,12107,10226,900202,12110,922538,921938,2021-01-05 20:22:45.109229
Kerala,65467,707244,3141,63324,712389,3160,778873,775852,2021-01-05 20:22:45.109229
Ladakh,256,9173,127,240,9194,127,9561,9556,2021-01-05 20:22:45.109229
Lakshadweep,0,0,0,0,0,0,0,0,2021-01-05 20:22:45.109229
Madhya Pradesh,8852,231533,3641,8609,232390,3648,244647,244026,2021-01-05 20:22:45.109229
Maharashtra,55471,1836999,49666,49955,1847361,49695,1947011,1942136,2021-01-05 20:22:45.109229
Manipur,1108,26815,358,1109,26862,361,28332,28281,2021-01-05 20:22:45.109229
Meghalaya,135,13186,139,139,13204,139,13482,13460,2021-01-05 20:22:45.109229
Mizoram,88,4127,8,79,4147,8,4234,4223,2021-01-05 20:22:45.109229
Nagaland,178,11673,79,173,11683,79,11935,11930,2021-01-05 20:22:45.109229
Odisha,2217,326209,1883,2100,326507,1885,330492,330309,2021-01-05 20:22:45.109229
Puducherry,358,37233,633,357,37261,635,38253,38224,2021-01-05 20:22:45.109229
Punjab,3361,158482,5376,3069,158972,5400,167441,167219,2021-01-05 20:22:45.109229
Rajasthan,8491,298620,2710,8189,299375,2714,310278,309821,2021-01-05 20:22:45.109229
Sikkim,506,5285,129,485,5307,129,5921,5920,2021-01-05 20:22:45.109229
Tamil Nadu,8127,800429,12156,7970,801414,12166,821550,820712,2021-01-05 20:22:45.109229
Telengana,5106,281083,1551,5039,281400,1554,287993,287740,2021-01-05 20:22:45.109229
Tripura,83,32815,385,73,32826,385,33284,33283,2021-01-05 20:22:45.109229
Uttarakhand,4376,85908,1527,3966,86611,1535,92112,91811,2021-01-05 20:22:45.109229
Uttar Pradesh,12858,566910,8403,12505,567964,8413,588882,588171,2021-01-05 20:22:45.109229
West Bengal,10446,534737,9792,9671,536084,9817,555572,554975,2021-01-05 20:22:45.109229
Andaman and Nicobar Islands,147,4848,62,152,3469,52,3673,4948,2021-01-06 17:39:44
Andhra Pradesh,78836,873149,7118,74518,551821,5410,631749,883210,2021-01-06 17:39:44
Arunachal Pradesh,1964,16598,56,1939,5643,13,7595,16741,2021-01-06 17:39:44
Assam,28780,212199,1054,29609,129133,578,159320,216340,2021-01-06 17:39:44
Bihar,13005,247484,1408,12539,156242,870,169651,253272,2021-01-06 17:39:44
Chandigarh,2821,19348,321,2761,7411,126,10298,19936,2021-01-06 17:39:44
Chhattisgarh,37853,270337,3412,37927,49564,690,88181,283515,2021-01-06 17:39:44
Dadra and Nagar Haveli and Daman and Diu,229,3369,2,220,2711,2,2933,3379,2021-01-06 17:39:44
Delhi,32097,611970,10597,30941,213304,5014,249259,627256,2021-01-06 17:39:44
Goa,5781,49741,743,5667,22726,360,28753,51335,2021-01-06 17:39:44
Gujarat,16208,234558,4321,16305,104964,3336,124605,247926,2021-01-06 17:39:44
Haryana,21411,257652,2923,21014,90884,1177,113075,263312,2021-01-06 17:39:44
Himachal Pradesh,4444,53216,946,4458,7853,127,12438,55808,2021-01-06 17:39:44
Jammu and Kashmir,22032,117211,1891,21887,42115,1024,65026,121786,2021-01-06 17:39:44
Jharkhand,13791,113125,1036,13504,58543,626,72673,115689,2021-01-06 17:39:44
Karnataka,98062,900202,12110,95354,423377,8145,526876,922538,2021-01-06 17:39:44
Kerala,39484,712389,3160,39354,98724,553,138631,778873,2021-01-06 17:39:44
Ladakh,1013,9194,127,1047,2735,50,3832,9561,2021-01-06 17:39:44
Lakshadweep,0,0,0,0,0,0,0,0,2021-01-06 17:39:44
Madhya Pradesh,22300,232390,3648,22542,83618,2007,108167,244647,2021-01-06 17:39:44
Maharashtra,291630,1847361,49695,275017,916348,33015,1224380,1947011,2021-01-06 17:39:44
Manipur,2070,26862,361,2113,6838,59,9010,28332,2021-01-06 17:39:44
Meghalaya,2111,13204,139,2169,2527,37,4733,13482,2021-01-06 17:39:44
Mizoram,583,4147,8,680,1012,0,1692,4234,2021-01-06 17:39:44
Nagaland,1184,11683,79,1052,4477,15,5544,11935,2021-01-06 17:39:44
Odisha,33504,326507,1885,34033,149379,710,184122,330492,2021-01-06 17:39:44
Puducherry,4908,37261,635,4659,18065,467,23191,38253,2021-01-06 17:39:44
Punjab,22278,158972,5400,21661,75409,2860,99930,167441,2021-01-06 17:39:44
Rajasthan,18184,299375,2714,18245,97284,1352,116881,310278,2021-01-06 17:39:44
Sikkim,469,5307,129,513,1986,29,2528,5921,2021-01-06 17:39:44
Tamil Nadu,46703,801414,12166,46495,491971,8871,547337,821550,2021-01-06 17:39:44
Telengana,29636,281400,1554,29649,144073,1052,174774,287993,2021-01-06 17:39:44
Tripura,6566,32826,385,6700,15883,251,22834,33284,2021-01-06 17:39:44
Uttarakhand,12455,567964,8413,12075,29201,501,41777,588882,2021-01-06 17:39:44
Uttar Pradesh,65954,86611,1535,64164,289594,5135,358893,92112,2021-01-06 17:39:44
West Bengal,24806,536084,9817,24898,198983,4421,228302,555572,2021-01-06 17:39:44
Andaman and Nicobar Islands,147,4856,62,152,3469,52,3673,4949,2021-01-07 17:39:44
Andhra Pradesh,78836,873427,7122,74518,551821,5410,631749,883587,2021-01-07 17:39:44
Arunachal Pradesh,1964,16609,56,1939,5643,13,7595,16744,2021-01-07 17:39:44
Assam,28780,212249,1057,29609,129133,578,159320,216381,2021-01-07 17:39:44
Bihar,13005,247929,1415,12539,156242,870,169651,253695,2021-01-07 17:39:44
Chandigarh,2821,19464,322,2761,7411,126,10298,20026,2021-01-07 17:39:44
Chhattisgarh,37853,271988,3437,37927,49564,690,88181,284536,2021-01-07 17:39:44
Dadra and Nagar Haveli and Daman and Diu,229,3370,2,220,2711,2,2933,3379,2021-01-07 17:39:44
Delhi,32097,612527,10609,30941,213304,5014,249259,627698,2021-01-07 17:39:44
Goa,5781,49811,744,5667,22726,360,28753,51415,2021-01-07 17:39:44
Gujarat,16208,235426,4325,16305,104964,3336,124605,248581,2021-01-07 17:39:44
Haryana,21411,257952,2927,21014,90884,1177,113075,263571,2021-01-07 17:39:44
Himachal Pradesh,4444,53523,948,4458,7853,127,12438,55910,2021-01-07 17:39:44
Jammu and Kashmir,22032,117426,1897,21887,42115,1024,65026,121923,2021-01-07 17:39:44
Jharkhand,13791,113380,1038,13504,58543,626,72673,115840,2021-01-07 17:39:44
Karnataka,98062,901579,12118,95354,423377,8145,526876,923353,2021-01-07 17:39:44
Kerala,39484,717311,3184,39354,98724,553,138631,784488,2021-01-07 17:39:44
Ladakh,1013,9215,127,1047,2735,50,3832,9577,2021-01-07 17:39:44
Lakshadweep,0,0,0,0,0,0,0,0,2021-01-07 17:39:44
Madhya Pradesh,22300,233229,3662,22542,83618,2007,108167,245318,2021-01-07 17:39:44
Maharashtra,291630,1850189,49759,275017,916348,33015,1224380,1950171,2021-01-07 17:39:44
Manipur,2070,27613,363,2113,6838,59,9010,28418,2021-01-07 17:39:44
Meghalaya,2111,13216,141,2169,2527,37,4733,13506,2021-01-07 17:39:44
Mizoram,583,4153,8,680,1012,0,1692,4247,2021-01-07 17:39:44
Nagaland,1184,11714,79,1052,4477,15,5544,11937,2021-01-07 17:39:44
Odisha,33504,326778,1887,34033,149379,710,184122,330690,2021-01-07 17:39:44
Puducherry,4908,37292,635,4659,18065,467,23191,38300,2021-01-07 17:39:44
Punjab,22278,159265,5404,21661,75409,2860,99930,167652,2021-01-07 17:39:44
Rajasthan,18184,300126,2719,18245,97284,1352,116881,310675,2021-01-07 17:39:44
Sikkim,469,5316,129,513,1986,29,2528,5938,2021-01-07 17:39:44
Tamil Nadu,46703,802385,12177,46495,491971,8871,547337,822370,2021-01-07 17:39:44
Telengana,29636,281872,1556,29649,144073,1052,174774,288410,2021-01-07 17:39:44
Tripura,6566,32835,387,6700,15883,251,22834,33286,2021-01-07 17:39:44
Uttarakhand,12455,568892,8433,12075,29201,501,41777,589611,2021-01-07 17:39:44
Uttar Pradesh,65954,87105,1544,64164,289594,5135,358893,92366,2021-01-07 17:39:44
West Bengal,24806,537250,9841,24898,198983,4421,228302,556384,2021-01-07 17:39:44
Andaman and Nicobar Islands,147,4859,62,152,3469,52,3673,4949,2021-01-08 17:39:44
Andhra Pradesh,78836,873855,7125,74518,551821,5410,631749,883876,2021-01-08 17:39:44
Arunachal Pradesh,1964,16609,56,1939,5643,13,7595,16753,2021-01-08 17:39:44
Assam,28780,212328,1057,29609,129133,578,159320,216424,2021-01-08 17:39:44
Bihar,13005,248410,1420,12539,156242,870,169651,254014,2021-01-08 17:39:44
Chandigarh,2821,19525,323,2761,7411,126,10298,20104,2021-01-08 17:39:44
Chhattisgarh,37853,273030,3447,37927,49564,690,88181,285586,2021-01-08 17:39:44
Dadra and Nagar Haveli and Daman and Diu,229,3372,2,220,2711,2,2933,3379,2021-01-08 17:39:44
Delhi,32097,613246,10625,30941,213304,5014,249259,628352,2021-01-08 17:39:44
Goa,5781,49893,744,5667,22726,360,28753,51507,2021-01-08 17:39:44
Gujarat,16208,236323,4329,16305,104964,3336,124605,249246,2021-01-08 17:39:44
Haryana,21411,258281,2934,21014,90884,1177,113075,263887,2021-01-08 17:39:44
Himachal Pradesh,4444,53782,952,4458,7853,127,12438,56015,2021-01-08 17:39:44
Jammu and Kashmir,22032,117690,1900,21887,42115,1024,65026,122049,2021-01-08 17:39:44
Jharkhand,13791,113545,1040,13504,58543,626,72673,116034,2021-01-08 17:39:44
Karnataka,98062,902817,12124,95354,423377,8145,526876,924137,2021-01-08 17:39:44
Kerala,39484,722421,3209,39354,98724,553,138631,790882,2021-01-08 17:39:44
Ladakh,1013,9243,127,1047,2735,50,3832,9589,2021-01-08 17:39:44
Lakshadweep,0,0,0,0,0,0,0,0,2021-01-08 17:39:44
Madhya Pradesh,22300,233862,3670,22542,83618,2007,108167,246048,2021-01-08 17:39:44
Maharashtra,291630,1852759,49825,275017,916348,33015,1224380,1954553,2021-01-08 17:39:44
Manipur,2070,27642,363,2113,6838,59,9010,28484,2021-01-08 17:39:44
Meghalaya,2111,13230,141,2169,2527,37,4733,13525,2021-01-08 17:39:44
Mizoram,583,4160,8,680,1012,0,1692,4256,2021-01-08 17:39:44
Nagaland,1184,11737,80,1052,4477,15,5544,11954,2021-01-08 17:39:44
Odisha,33504,327008,1887,34033,149379,710,184122,330921,2021-01-08 17:39:44
Puducherry,4908,37327,635,4659,18065,467,23191,38334,2021-01-08 17:39:44
Punjab,22278,159500,5412,21661,75409,2860,99930,167910,2021-01-08 17:39:44
Rajasthan,18184,300690,2723,18245,97284,1352,116881,311111,2021-01-08 17:39:44
Sikkim,469,5358,129,513,1986,29,2528,5951,2021-01-08 17:39:44
Tamil Nadu,46703,803328,12188,46495,491971,8871,547337,823181,2021-01-08 17:39:44
Telengana,29636,282177,1559,29649,144073,1052,174774,288789,2021-01-08 17:39:44
Tripura,6566,32843,387,6700,15883,251,22834,33294,2021-01-08 17:39:44
Uttarakhand,12455,569959,8441,12075,29201,501,41777,590339,2021-01-08 17:39:44
Uttar Pradesh,65954,87529,1549,64164,289594,5135,358893,92593,2021-01-08 17:39:44
West Bengal,24806,538521,9863,24898,198983,4421,228302,557252,2021-01-08 17:39:44
Andaman and Nicobar Islands,147,4864,62,152,3469,52,3673,4958,2021-01-09 17:39:44
Andhra Pradesh,78836,874223,7126,74518,551821,5410,631749,884171,2021-01-09 17:39:44
Arunachal Pradesh,1964,16622,56,1939,5643,13,7595,16757,2021-01-09 17:39:44
Assam,28780,212376,1059,29609,129133,578,159320,216481,2021-01-09 17:39:44
Bihar,13005,248762,1424,12539,156242,870,169651,254447,2021-01-09 17:39:44
Chandigarh,2821,19582,325,2761,7411,126,10298,20147,2021-01-09 17:39:44
Chhattisgarh,37853,274283,3454,37927,49564,690,88181,286596,2021-01-09 17:39:44
Dadra and Nagar Haveli and Daman and Diu,229,3372,2,220,2711,2,2933,3379,2021-01-09 17:39:44
Delhi,32097,614026,10644,30941,213304,5014,249259,628838,2021-01-09 17:39:44
Goa,5781,49983,744,5667,22726,360,28753,51626,2021-01-09 17:39:44
Gujarat,16208,237222,4332,16305,104964,3336,124605,249913,2021-01-09 17:39:44
Haryana,21411,258658,2940,21014,90884,1177,113075,264161,2021-01-09 17:39:44
Himachal Pradesh,4444,53973,953,4458,7853,127,12438,56146,2021-01-09 17:39:44
Jammu and Kashmir,22032,117877,1903,21887,42115,1024,65026,122176,2021-01-09 17:39:44
Jharkhand,13791,113740,1041,13504,58543,626,72673,116229,2021-01-09 17:39:44
Karnataka,98062,903629,12131,95354,423377,8145,526876,924898,2021-01-09 17:39:44
Kerala,39484,728060,3234,39354,98724,553,138631,795933,2021-01-09 17:39:44
Ladakh,1013,9258,127,1047,2735,50,3832,9600,2021-01-09 17:39:44
Lakshadweep,0,0,0,0,0,0,0,0,2021-01-09 17:39:44
Madhya Pradesh,22300,234612,3682,22542,83618,2007,108167,246822,2021-01-09 17:39:44
Maharashtra,291630,1856109,49897,275017,916348,33015,1224380,1958282,2021-01-09 17:39:44
Manipur,2070,27677,364,2113,6838,59,9010,28531,2021-01-09 17:39:44
Meghalaya,2111,13257,141,2169,2527,37,4733,13536,2021-01-09 17:39:44
Mizoram,583,4172,8,680,1012,0,1692,4259,2021-01-09 17:39:44
Nagaland,1184,11747,82,1052,4477,15,5544,11960,2021-01-09 17:39:44
Odisha,33504,327290,1888,34033,149379,710,184122,331151,2021-01-09 17:39:44
Puducherry,4908,37374,636,4659,18065,467,23191,38369,2021-01-09 17:39:44
Punjab,22278,159790,5422,21661,75409,2860,99930,168187,2021-01-09 17:39:44
Rajasthan,18184,301425,2727,18245,97284,1352,116881,311620,2021-01-09 17:39:44
Sikkim,469,5371,129,513,1986,29,2528,5965,2021-01-09 17:39:44
Tamil Nadu,46703,804239,12200,46495,491971,8871,547337,823986,2021-01-09 17:39:44
Telengana,29636,282574,1561,29649,144073,1052,174774,289135,2021-01-09 17:39:44
Tripura,6566,32852,388,6700,15883,251,22834,33299,2021-01-09 17:39:44
Uttarakhand,12455,570605,8452,12075,29201,501,41777,590844,2021-01-09 17:39:44
Uttar Pradesh,65954,87978,1555,64164,289594,5135,358893,92842,2021-01-09 17:39:44
West Bengal,24806,539816,9881,24898,198983,4421,228302,558173,2021-01-09 17:39:44
Andaman and Nicobar Islands,147,4866,62,152,3469,52,3673,4959,2021-01-10 17:39:44
Andhra Pradesh,78836,874531,7127,74518,551821,5410,631749,884490,2021-01-10 17:39:44
Arunachal Pradesh,1964,16631,56,1939,5643,13,7595,16764,2021-01-10 17:39:44
Assam,28780,212430,1059,29609,129133,578,159320,216531,2021-01-10 17:39:44
Bihar,13005,249198,1428,12539,156242,870,169651,254701,2021-01-10 17:39:44
Chandigarh,2821,19637,326,2761,7411,126,10298,20201,2021-01-10 17:39:44
Chhattisgarh,37853,275042,3469,37927,49564,690,88181,287556,2021-01-10 17:39:44
Dadra and Nagar Haveli and Daman and Diu,229,3373,2,220,2711,2,2933,3380,2021-01-10 17:39:44
Delhi,32097,614849,10654,30941,213304,5014,249259,629282,2021-01-10 17:39:44
Goa,5781,50088,744,5667,22726,360,28753,51709,2021-01-10 17:39:44
Gujarat,16208,238114,4335,16305,104964,3336,124605,250598,2021-01-10 17:39:44
Haryana,21411,258998,2943,21014,90884,1177,113075,264442,2021-01-10 17:39:44
Himachal Pradesh,4444,54145,955,4458,7853,127,12438,56282,2021-01-10 17:39:44
Jammu and Kashmir,22032,118155,1907,21887,42115,1024,65026,122303,2021-01-10 17:39:44
Jharkhand,13791,113928,1043,13504,58543,626,72673,116436,2021-01-10 17:39:44
Karnataka,98062,904286,12134,95354,423377,8145,526876,925868,2021-01-10 17:39:44
Kerala,39484,733384,3257,39354,98724,553,138631,801075,2021-01-10 17:39:44
Ladakh,1013,9271,127,1047,2735,50,3832,9601,2021-01-10 17:39:44
Lakshadweep,0,0,0,0,0,0,0,0,2021-01-10 17:39:44
Madhya Pradesh,22300,235421,3691,22542,83618,2007,108167,247436,2021-01-10 17:39:44
Maharashtra,291630,1858999,49970,275017,916348,33015,1224380,1961975,2021-01-10 17:39:44
Manipur,2070,27735,364,2113,6838,59,9010,28579,2021-01-10 17:39:44
Meghalaya,2111,13262,143,2169,2527,37,4733,13560,2021-01-10 17:39:44
Mizoram,583,4185,8,680,1012,0,1692,4275,2021-01-10 17:39:44
Nagaland,1184,11752,83,1052,4477,15,5544,11964,2021-01-10 17:39:44
Odisha,33504,327534,1890,34033,149379,710,184122,331396,2021-01-10 17:39:44
Puducherry,4908,37410,636,4659,18065,467,23191,38389,2021-01-10 17:39:44
Punjab,22278,160042,5437,21661,75409,2860,99930,168486,2021-01-10 17:39:44
Rajasthan,18184,301962,2727,18245,97284,1352,116881,312091,2021-01-10 17:39:44
Sikkim,469,5457,129,513,1986,29,2528,5979,2021-01-10 17:39:44
Tamil Nadu,46703,805136,12208,46495,491971,8871,547337,824776,2021-01-10 17:39:44
Telengana,29636,283048,1563,29649,144073,1052,174774,289433,2021-01-10 17:39:44
Tripura,6566,32854,388,6700,15883,251,22834,33302,2021-01-10 17:39:44
Uttarakhand,12455,571606,8469,12075,29201,501,41777,591610,2021-01-10 17:39:44
Uttar Pradesh,65954,88370,1562,64164,289594,5135,358893,93111,2021-01-10 17:39:44
West Bengal,24806,540952,9902,24898,198983,4421,228302,559099,2021-01-10 17:39:44
Andaman and Nicobar Islands,24,4873,62,23,4875,62,4960,4959,2021-01-11 11:30:13.215680
Andhra Pradesh,2607,874954,7128,2544,875243,7129,884916,884689,2021-01-11 11:30:13.215680
Arunachal Pradesh,64,16647,56,66,16650,56,16772,16767,2021-01-11 11:30:13.215680
Assam,3019,212486,1060,3014,212515,1061,216590,216565,2021-01-11 11:30:13.215680
Bihar,4247,249709,1430,4178,250088,1434,255700,255386,2021-01-11 11:30:13.215680
Chandigarh,228,19696,327,241,19727,327,20295,20251,2021-01-11 11:30:13.215680
Chhattisgarh,9274,275812,3484,8967,276774,3490,289231,288570,2021-01-11 11:30:13.215680
Dadra and Nagar Haveli and Daman and Diu,4,3374,2,2,3376,2,3380,3380,2021-01-11 11:30:13.215680
Delhi,3683,615452,10666,3468,616054,10678,630200,629801,2021-01-11 11:30:13.215680
Goa,867,50177,746,832,50277,747,51856,51790,2021-01-11 11:30:13.215680
Gujarat,7968,238965,4340,7829,239771,4344,251944,251273,2021-01-11 11:30:13.215680
Haryana,2563,259209,2949,2510,259495,2950,264955,264721,2021-01-11 11:30:13.215680
Himachal Pradesh,1088,54320,958,971,54522,959,56452,56366,2021-01-11 11:30:13.215680
Jammu and Kashmir,2094,118422,1909,2011,118617,1910,122538,122425,2021-01-11 11:30:13.215680
Jharkhand,1494,114133,1045,1468,114302,1047,116817,116672,2021-01-11 11:30:13.215680
Karnataka,9471,905158,12138,9668,905751,12140,927559,926767,2021-01-11 11:30:13.215680
Kerala,64516,738808,3279,64379,743467,3302,811148,806603,2021-01-11 11:30:13.215680
Ladakh,203,9278,127,197,9294,127,9618,9608,2021-01-11 11:30:13.215680
Lakshadweep,0,0,0,0,0,0,0,0,2021-01-11 11:30:13.215680
Madhya Pradesh,8029,236247,3701,7823,237063,3711,248597,247977,2021-01-11 11:30:13.215680
Maharashtra,54129,1861400,50027,55351,1863702,50061,1969114,1965556,2021-01-11 11:30:13.215680
Manipur,515,27766,365,490,27805,365,28660,28646,2021-01-11 11:30:13.215680
Meghalaya,163,13286,143,155,13313,143,13611,13592,2021-01-11 11:30:13.215680
Mizoram,98,4186,8,92,4192,9,4293,4292,2021-01-11 11:30:13.215680
Nagaland,113,11778,84,116,11778,84,11978,11975,2021-01-11 11:30:13.215680
Odisha,1908,327803,1891,1928,328043,1891,331862,331602,2021-01-11 11:30:13.215680
Puducherry,328,37461,636,316,37501,638,38455,38425,2021-01-11 11:30:13.215680
Punjab,2952,160343,5439,2933,160655,5445,169033,168734,2021-01-11 11:30:13.215680
Rajasthan,6730,303060,2731,6726,303536,2734,312996,312521,2021-01-11 11:30:13.215680
Sikkim,369,5486,129,351,5508,129,5988,5984,2021-01-11 11:30:13.215680
Tamil Nadu,7304,806018,12215,7164,806875,12222,826261,825537,2021-01-11 11:30:13.215680
Telengana,4756,283463,1565,4518,283924,1566,290008,289784,2021-01-11 11:30:13.215680
Tripura,57,32862,388,50,32869,388,33307,33307,2021-01-11 11:30:13.215680
Uttarakhand,3215,88615,1568,3130,88918,1573,93621,93398,2021-01-11 11:30:13.215680
Uttar Pradesh,11221,572773,8481,11134,573542,8495,593171,592475,2021-01-11 11:30:13.215680
West Bengal,8034,541930,9922,7881,542887,9941,560709,559886,2021-01-11 11:30:13.215680
Andaman and Nicobar Islands,23,4875,62,17,4884,62,4963,4960,2021-01-12 20:47:21.672694
Andhra Pradesh,2544,875243,7129,2450,875456,7131,885037,884916,2021-01-12 20:47:21.672694
Arunachal Pradesh,66,16650,56,63,16658,56,16777,16772,2021-01-12 20:47:21.672694
Assam,3014,212515,1061,2992,212579,1064,216635,216590,2021-01-12 20:47:21.672694
Bihar,4178,250088,1434,4054,250439,1439,255932,255700,2021-01-12 20:47:21.672694
Chandigarh,241,19727,327,259,19756,327,20342,20295,2021-01-12 20:47:21.672694
Chhattisgarh,8967,276774,3490,8550,278029,3505,290084,289231,2021-01-12 20:47:21.672694
Dadra and Nagar Haveli and Daman and Diu,2,3376,2,4,3376,2,3382,3380,2021-01-12 20:47:21.672694
Delhi,3468,616054,10678,3354,616461,10691,630506,630200,2021-01-12 20:47:21.672694
Goa,832,50277,747,799,50343,749,51891,51856,2021-01-12 20:47:21.672694
Gujarat,7829,239771,4344,7695,240517,4347,252559,251944,2021-01-12 20:47:21.672694
Haryana,2510,259495,2950,2547,259696,2956,265199,264955,2021-01-12 20:47:21.672694
Himachal Pradesh,971,54522,959,874,54686,961,56521,56452,2021-01-12 20:47:21.672694
Jammu and Kashmir,2011,118617,1910,1768,118972,1911,122651,122538,2021-01-12 20:47:21.672694
Jharkhand,1468,114302,1047,1382,114531,1048,116961,116817,2021-01-12 20:47:21.672694
Karnataka,9668,905751,12140,9363,906548,12144,928055,927559,2021-01-12 20:47:21.672694
Kerala,64379,743467,3302,63547,747389,3322,814258,811148,2021-01-12 20:47:21.672694
Ladakh,197,9294,127,183,9311,127,9621,9618,2021-01-12 20:47:21.672694
Lakshadweep,0,0,0,0,0,0,0,0,2021-01-12 20:47:21.672694
Madhya Pradesh,7823,237063,3711,7651,237713,3718,249082,248597,2021-01-12 20:47:21.672694
Maharashtra,55351,1863702,50061,53463,1867988,50101,1971552,1969114,2021-01-12 20:47:21.672694
Manipur,490,27805,365,477,27851,365,28693,28660,2021-01-12 20:47:21.672694
Meghalaya,155,13313,143,151,13337,143,13631,13611,2021-01-12 20:47:21.672694
Mizoram,92,4192,9,96,4194,9,4299,4293,2021-01-12 20:47:21.672694
Nagaland,116,11778,84,108,11795,84,11987,11978,2021-01-12 20:47:21.672694
Odisha,1928,328043,1891,1943,328271,1892,332106,331862,2021-01-12 20:47:21.672694
Puducherry,316,37501,638,304,37535,638,38477,38455,2021-01-12 20:47:21.672694
Punjab,2933,160655,5445,2858,160920,5447,169225,169033,2021-01-12 20:47:21.672694
Rajasthan,6726,303536,2734,6585,304104,2736,313425,312996,2021-01-12 20:47:21.672694
Sikkim,351,5508,129,322,5538,129,5989,5988,2021-01-12 20:47:21.672694
Tamil Nadu,7164,806875,12222,6971,807744,12228,826943,826261,2021-01-12 20:47:21.672694
Telengana,4518,283924,1566,4524,284217,1568,290309,290008,2021-01-12 20:47:21.672694
Tripura,50,32869,388,49,32872,388,33309,33307,2021-01-12 20:47:21.672694
Uttarakhand,3130,88918,1573,2753,89446,1578,93777,93621,2021-01-12 20:47:21.672694
Uttar Pradesh,11134,573542,8495,10864,574312,8504,593680,593171,2021-01-12 20:47:21.672694
West Bengal,7881,542887,9941,7538,543826,9957,561321,560709,2021-01-12 20:47:21.672694
Andaman and Nicobar Islands,17,4884,62,18,4886,62,4966,4963,2021-01-13 19:57:31.174032
Andhra Pradesh,2450,875456,7131,2411,875690,7133,885234,885037,2021-01-13 19:57:31.174032
Arunachal Pradesh,63,16658,56,61,16665,56,16782,16777,2021-01-13 19:57:31.174032
Assam,2992,212579,1064,2994,212632,1064,216690,216635,2021-01-13 19:57:31.174032
Bihar,4054,250439,1439,4234,250632,1443,256309,255932,2021-01-13 19:57:31.174032
Chandigarh,259,19756,327,270,19780,328,20378,20342,2021-01-13 19:57:31.174032
Chhattisgarh,8550,278029,3505,8060,279236,3517,290813,290084,2021-01-13 19:57:31.174032
Dadra and Nagar Haveli and Daman and Diu,4,3376,2,4,3376,2,3382,3382,2021-01-13 19:57:31.174032
Delhi,3354,616461,10691,3179,617006,10707,630892,630506,2021-01-13 19:57:31.174032
Goa,799,50343,749,797,50437,749,51983,51891,2021-01-13 19:57:31.174032
Gujarat,7695,240517,4347,7439,241372,4350,253161,252559,2021-01-13 19:57:31.174032
Haryana,2547,259696,2956,2441,259986,2964,265391,265199,2021-01-13 19:57:31.174032
Himachal Pradesh,874,54686,961,810,54825,961,56596,56521,2021-01-13 19:57:31.174032
Jammu and Kashmir,1768,118972,1911,1682,119170,1912,122764,122651,2021-01-13 19:57:31.174032
Jharkhand,1382,114531,1048,1356,114684,1048,117088,116961,2021-01-13 19:57:31.174032
Karnataka,9363,906548,12144,8928,907729,12149,928806,928055,2021-01-13 19:57:31.174032
Kerala,63547,747389,3322,64759,751659,3347,819765,814258,2021-01-13 19:57:31.174032
Ladakh,183,9311,127,180,9326,128,9634,9621,2021-01-13 19:57:31.174032
Lakshadweep,0,0,0,0,0,0,0,0,2021-01-13 19:57:31.174032
Madhya Pradesh,7651,237713,3718,7499,238328,3726,249553,249082,2021-01-13 19:57:31.174032
Maharashtra,53463,1867988,50101,53067,1871270,50151,1974488,1971552,2021-01-13 19:57:31.174032
Manipur,477,27851,365,481,27879,365,28725,28693,2021-01-13 19:57:31.174032
Meghalaya,151,13337,143,152,13356,143,13651,13631,2021-01-13 19:57:31.174032
Mizoram,96,4194,9,94,4200,9,4303,4299,2021-01-13 19:57:31.174032
Nagaland,108,11795,84,106,11807,84,11997,11987,2021-01-13 19:57:31.174032
Odisha,1943,328271,1892,1985,328452,1894,332331,332106,2021-01-13 19:57:31.174032
Puducherry,304,37535,638,293,37563,639,38495,38477,2021-01-13 19:57:31.174032
Punjab,2858,160920,5447,2788,161235,5456,169479,169225,2021-01-13 19:57:31.174032
Rajasthan,6585,304104,2736,6200,304779,2739,313718,313425,2021-01-13 19:57:31.174032
Sikkim,322,5538,129,313,5554,129,5996,5989,2021-01-13 19:57:31.174032
Tamil Nadu,6971,807744,12228,6807,808571,12236,827614,826943,2021-01-13 19:57:31.174032
Telengana,4524,284217,1568,4458,284611,1571,290640,290309,2021-01-13 19:57:31.174032
Tripura,49,32872,388,46,32880,389,33315,33309,2021-01-13 19:57:31.174032
Uttarakhand,2753,89446,1578,2643,89729,1589,93961,93777,2021-01-13 19:57:31.174032
Uttar Pradesh,10864,574312,8504,10560,575101,8514,594175,593680,2021-01-13 19:57:31.174032
West Bengal,7538,543826,9957,7392,544705,9975,562072,561321,2021-01-13 19:57:31.174032
Andaman and Nicobar Islands,147,4886,62,152,3469,52,3673,4966,2021-01-14 17:39:44
Andhra Pradesh,78836,875690,7133,74518,551821,5410,631749,885234,2021-01-14 17:39:44
Arunachal Pradesh,1964,16665,56,1939,5643,13,7595,16782,2021-01-14 17:39:44
Assam,28780,212632,1064,29609,129133,578,159320,216690,2021-01-14 17:39:44
Bihar,13005,250632,1443,12539,156242,870,169651,256309,2021-01-14 17:39:44
Chandigarh,2821,19780,328,2761,7411,126,10298,20378,2021-01-14 17:39:44
Chhattisgarh,37853,279236,3517,37927,49564,690,88181,290813,2021-01-14 17:39:44
Dadra and Nagar Haveli and Daman and Diu,229,3376,2,220,2711,2,2933,3382,2021-01-14 17:39:44
Delhi,32097,617006,10707,30941,213304,5014,249259,630892,2021-01-14 17:39:44
Goa,5781,50437,749,5667,22726,360,28753,51983,2021-01-14 17:39:44
Gujarat,16208,241372,4350,16305,104964,3336,124605,253161,2021-01-14 17:39:44
Haryana,21411,259986,2964,21014,90884,1177,113075,265391,2021-01-14 17:39:44
Himachal Pradesh,4444,54825,961,4458,7853,127,12438,56596,2021-01-14 17:39:44
Jammu and Kashmir,22032,119170,1912,21887,42115,1024,65026,122764,2021-01-14 17:39:44
Jharkhand,13791,114684,1048,13504,58543,626,72673,117088,2021-01-14 17:39:44
Karnataka,98062,907729,12149,95354,423377,8145,526876,928806,2021-01-14 17:39:44
Kerala,39484,751659,3347,39354,98724,553,138631,819765,2021-01-14 17:39:44
Ladakh,1013,9326,128,1047,2735,50,3832,9634,2021-01-14 17:39:44
Lakshadweep,0,0,0,0,0,0,0,0,2021-01-14 17:39:44
Madhya Pradesh,22300,238328,3726,22542,83618,2007,108167,249553,2021-01-14 17:39:44
Maharashtra,291630,1871270,50151,275017,916348,33015,1224380,1974488,2021-01-14 17:39:44
Manipur,2070,27879,365,2113,6838,59,9010,28725,2021-01-14 17:39:44
Meghalaya,2111,13356,143,2169,2527,37,4733,13651,2021-01-14 17:39:44
Mizoram,583,4200,9,680,1012,0,1692,4303,2021-01-14 17:39:44
Nagaland,1184,11807,84,1052,4477,15,5544,11997,2021-01-14 17:39:44
Odisha,33504,328452,1894,34033,149379,710,184122,332331,2021-01-14 17:39:44
Puducherry,4908,37563,639,4659,18065,467,23191,38495,2021-01-14 17:39:44
Punjab,22278,161235,5456,21661,75409,2860,99930,169479,2021-01-14 17:39:44
Rajasthan,18184,304779,2739,18245,97284,1352,116881,313718,2021-01-14 17:39:44
Sikkim,469,5554,129,513,1986,29,2528,5996,2021-01-14 17:39:44
Tamil Nadu,46703,808571,12236,46495,491971,8871,547337,827614,2021-01-14 17:39:44
Telengana,29636,284611,1571,29649,144073,1052,174774,290640,2021-01-14 17:39:44
Tripura,6566,32880,389,6700,15883,251,22834,33315,2021-01-14 17:39:44
Uttarakhand,12455,575101,8514,12075,29201,501,41777,594175,2021-01-14 17:39:44
Uttar Pradesh,65954,89729,1589,64164,289594,5135,358893,93961,2021-01-14 17:39:44
West Bengal,24806,544705,9975,24898,198983,4421,228302,562072,2021-01-14 17:39:44
Andaman and Nicobar Islands,16,4891,62,23,4891,62,4976,4969,2021-01-15 20:53:31.755791
Andhra Pradesh,2382,875921,7134,2338,876140,7138,885616,885437,2021-01-15 20:53:31.755791
Arunachal Pradesh,58,16669,56,68,16674,56,16798,16783,2021-01-15 20:53:31.755791
Assam,3003,212675,1065,2991,212706,1065,216762,216743,2021-01-15 20:53:31.755791
Bihar,4115,251027,1445,4170,251278,1447,256895,256587,2021-01-15 20:53:31.755791
Chandigarh,292,19794,329,273,19835,330,20438,20415,2021-01-15 20:53:31.755791
Chhattisgarh,7791,280166,3527,7418,281136,3537,292091,291484,2021-01-15 20:53:31.755791
Dadra and Nagar Haveli and Daman and Diu,4,3377,2,6,3377,2,3385,3383,2021-01-15 20:53:31.755791
Delhi,2991,617540,10718,2937,617930,10722,631589,631249,2021-01-15 20:53:31.755791
Goa,814,50515,750,848,50582,752,52182,52079,2021-01-15 20:53:31.755791
Gujarat,7226,242164,4354,7056,242901,4357,254314,253744,2021-01-15 20:53:31.755791
Haryana,2414,260236,2966,2266,260565,2972,265803,265616,2021-01-15 20:53:31.755791
Himachal Pradesh,830,54896,963,811,54977,963,56751,56689,2021-01-15 20:53:31.755791
Jammu and Kashmir,1629,119344,1912,1468,119581,1915,122964,122885,2021-01-15 20:53:31.755791
Jharkhand,1356,114836,1048,1327,115009,1048,117384,117240,2021-01-15 20:53:31.755791
Karnataka,8906,908494,12152,8747,909058,12155,929960,929552,2021-01-15 20:53:31.755791
Kerala,65579,756817,3373,66713,761154,3392,831259,825769,2021-01-15 20:53:31.755791
Ladakh,136,9375,128,114,9404,128,9646,9639,2021-01-15 20:53:31.755791
Lakshadweep,0,0,0,0,0,0,0,0,2021-01-15 20:53:31.755791
Madhya Pradesh,7294,238983,3732,7108,239581,3740,250429,250009,2021-01-15 20:53:31.755791
Maharashtra,53544,1874279,50221,53744,1877588,50291,1981623,1978044,2021-01-15 20:53:31.755791
Manipur,469,27935,365,446,27976,365,28787,28769,2021-01-15 20:53:31.755791
Meghalaya,160,13365,144,161,13382,144,13687,13669,2021-01-15 20:53:31.755791
Mizoram,101,4200,9,96,4205,9,4310,4310,2021-01-15 20:53:31.755791
Nagaland,103,11814,86,124,11825,86,12035,12003,2021-01-15 20:53:31.755791
Odisha,2024,328622,1895,2035,328832,1896,332763,332541,2021-01-15 20:53:31.755791
Puducherry,278,37607,639,298,37629,640,38567,38524,2021-01-15 20:53:31.755791
Punjab,2817,161457,5463,2767,161710,5473,169950,169737,2021-01-15 20:53:31.755791
Rajasthan,5780,305569,2742,5675,305953,2744,314372,314091,2021-01-15 20:53:31.755791
Sikkim,311,5564,129,162,5719,130,6011,6004,2021-01-15 20:53:31.755791
Tamil Nadu,6653,809392,12242,6488,810218,12246,828952,828287,2021-01-15 20:53:31.755791
Telengana,4495,284849,1572,4442,285102,1574,291118,290916,2021-01-15 20:53:31.755791
Tripura,45,32886,389,45,32890,390,33325,33320,2021-01-15 20:53:31.755791
Uttarakhand,2552,90025,1593,2510,90218,1596,94324,94170,2021-01-15 20:53:31.755791
Uttar Pradesh,10132,575980,8529,10080,576519,8543,595142,594641,2021-01-15 20:53:31.755791
West Bengal,7303,545499,9993,7272,546193,10010,563475,562795,2021-01-15 20:53:31.755791
Andaman and Nicobar Islands,23,4891,62,22,4895,62,4979,4976,2021-01-16 20:00:10.662428
Andhra Pradesh,2338,876140,7138,2199,876372,7139,885710,885616,2021-01-16 20:00:10.662428
Arunachal Pradesh,68,16674,56,64,16682,56,16802,16798,2021-01-16 20:00:10.662428
Assam,2991,212706,1065,2963,212748,1066,216777,216762,2021-01-16 20:00:10.662428
Bihar,4170,251278,1447,4112,251632,1449,257193,256895,2021-01-16 20:00:10.662428
Chandigarh,273,19835,330,266,19868,330,20464,20438,2021-01-16 20:00:10.662428
Chhattisgarh,7418,281136,3537,6923,282145,3544,292612,292091,2021-01-16 20:00:10.662428
Dadra and Nagar Haveli and Daman and Diu,6,3377,2,9,3377,2,3388,3385,2021-01-16 20:00:10.662428
Delhi,2937,617930,10722,2795,618357,10732,631884,631589,2021-01-16 20:00:10.662428
Goa,848,50582,752,866,50643,753,52262,52182,2021-01-16 20:00:10.662428
Gujarat,7056,242901,4357,6850,243639,4360,254849,254314,2021-01-16 20:00:10.662428
Haryana,2266,260565,2972,2184,260801,2979,265964,265803,2021-01-16 20:00:10.662428
Himachal Pradesh,811,54977,963,767,55072,963,56802,56751,2021-01-16 20:00:10.662428
Jammu and Kashmir,1468,119581,1915,1428,119760,1920,123108,122964,2021-01-16 20:00:10.662428
Jharkhand,1327,115009,1048,1289,115142,1049,117480,117384,2021-01-16 20:00:10.662428
Karnataka,8747,909058,12155,8809,909701,12158,930668,929960,2021-01-16 20:00:10.662428
Kerala,66713,761154,3392,67711,765757,3415,836883,831259,2021-01-16 20:00:10.662428
Ladakh,114,9404,128,104,9416,128,9648,9646,2021-01-16 20:00:10.662428
Lakshadweep,0,0,0,0,0,0,0,0,2021-01-16 20:00:10.662428
Madhya Pradesh,7108,239581,3740,6957,240155,3746,250858,250429,2021-01-16 20:00:10.662428
Maharashtra,53744,1877588,50291,53344,1881088,50336,1984768,1981623,2021-01-16 20:00:10.662428
Manipur,446,27976,365,436,28010,365,28811,28787,2021-01-16 20:00:10.662428
Meghalaya,161,13382,144,161,13386,144,13691,13687,2021-01-16 20:00:10.662428
Mizoram,96,4205,9,80,4225,9,4314,4310,2021-01-16 20:00:10.662428
Nagaland,124,11825,86,104,11847,88,12039,12035,2021-01-16 20:00:10.662428
Odisha,2035,328832,1896,1963,329088,1898,332949,332763,2021-01-16 20:00:10.662428
Puducherry,298,37629,640,294,37661,640,38595,38567,2021-01-16 20:00:10.662428
Punjab,2767,161710,5473,2739,161967,5485,170191,169950,2021-01-16 20:00:10.662428
Rajasthan,5675,305953,2744,5608,306330,2744,314682,314372,2021-01-16 20:00:10.662428
Sikkim,162,5719,130,163,5731,130,6024,6011,2021-01-16 20:00:10.662428
Tamil Nadu,6488,810218,12246,6299,811023,12251,829573,828952,2021-01-16 20:00:10.662428
Telengana,4442,285102,1574,4273,285519,1575,291367,291118,2021-01-16 20:00:10.662428
Tripura,45,32890,390,41,32897,391,33329,33325,2021-01-16 20:00:10.662428
Uttarakhand,2510,90218,1596,2406,90457,1602,94465,94324,2021-01-16 20:00:10.662428
Uttar Pradesh,10080,576519,8543,9581,577475,8558,595614,595142,2021-01-16 20:00:10.662428
West Bengal,7272,546193,10010,7223,546849,10026,564098,563475,2021-01-16 20:00:10.662428
Andaman and Nicobar Islands,147,4895,62,152,3469,52,3673,4979,2021-01-17 17:39:44
Andhra Pradesh,78836,876372,7139,74518,551821,5410,631749,885710,2021-01-17 17:39:44
Arunachal Pradesh,1964,16682,56,1939,5643,13,7595,16802,2021-01-17 17:39:44
Assam,28780,212748,1066,29609,129133,578,159320,216777,2021-01-17 17:39:44
Bihar,13005,251632,1449,12539,156242,870,169651,257193,2021-01-17 17:39:44
Chandigarh,2821,19868,330,2761,7411,126,10298,20464,2021-01-17 17:39:44
Chhattisgarh,37853,282145,3544,37927,49564,690,88181,292612,2021-01-17 17:39:44
Dadra and Nagar Haveli and Daman and Diu,229,3377,2,220,2711,2,2933,3388,2021-01-17 17:39:44
Delhi,32097,618357,10732,30941,213304,5014,249259,631884,2021-01-17 17:39:44
Goa,5781,50643,753,5667,22726,360,28753,52262,2021-01-17 17:39:44
Gujarat,16208,243639,4360,16305,104964,3336,124605,254849,2021-01-17 17:39:44
Haryana,21411,260801,2979,21014,90884,1177,113075,265964,2021-01-17 17:39:44
Himachal Pradesh,4444,55072,963,4458,7853,127,12438,56802,2021-01-17 17:39:44
Jammu and Kashmir,22032,119760,1920,21887,42115,1024,65026,123108,2021-01-17 17:39:44
Jharkhand,13791,115142,1049,13504,58543,626,72673,117480,2021-01-17 17:39:44
Karnataka,98062,909701,12158,95354,423377,8145,526876,930668,2021-01-17 17:39:44
Kerala,39484,765757,3415,39354,98724,553,138631,836883,2021-01-17 17:39:44
Ladakh,1013,9416,128,1047,2735,50,3832,9648,2021-01-17 17:39:44
Lakshadweep,0,0,0,0,0,0,0,0,2021-01-17 17:39:44
Madhya Pradesh,22300,240155,3746,22542,83618,2007,108167,250858,2021-01-17 17:39:44
Maharashtra,291630,1881088,50336,275017,916348,33015,1224380,1984768,2021-01-17 17:39:44
Manipur,2070,28010,365,2113,6838,59,9010,28811,2021-01-17 17:39:44
Meghalaya,2111,13386,144,2169,2527,37,4733,13691,2021-01-17 17:39:44
Mizoram,583,4225,9,680,1012,0,1692,4314,2021-01-17 17:39:44
Nagaland,1184,11847,88,1052,4477,15,5544,12039,2021-01-17 17:39:44
Odisha,33504,329088,1898,34033,149379,710,184122,332949,2021-01-17 17:39:44
Puducherry,4908,37661,640,4659,18065,467,23191,38595,2021-01-17 17:39:44
Punjab,22278,161967,5485,21661,75409,2860,99930,170191,2021-01-17 17:39:44
Rajasthan,18184,306330,2744,18245,97284,1352,116881,314682,2021-01-17 17:39:44
Sikkim,469,5731,130,513,1986,29,2528,6024,2021-01-17 17:39:44
Tamil Nadu,46703,811023,12251,46495,491971,8871,547337,829573,2021-01-17 17:39:44
Telengana,29636,285519,1575,29649,144073,1052,174774,291367,2021-01-17 17:39:44
Tripura,6566,32897,391,6700,15883,251,22834,33329,2021-01-17 17:39:44
Uttarakhand,12455,577475,8558,12075,29201,501,41777,595614,2021-01-17 17:39:44
Uttar Pradesh,65954,90457,1602,64164,289594,5135,358893,94465,2021-01-17 17:39:44
West Bengal,24806,546849,10026,24898,198983,4421,228302,564098,2021-01-17 17:39:44
Andaman and Nicobar Islands,25,4895,62,25,4896,62,4983,4982,2021-01-18 20:17:40.758455
Andhra Pradesh,1987,876698,7139,1896,876949,7140,885985,885824,2021-01-18 20:17:40.758455
Arunachal Pradesh,62,16690,56,58,16697,56,16811,16808,2021-01-18 20:17:40.758455
Assam,2930,212809,1070,2919,212839,1073,216831,216809,2021-01-18 20:17:40.758455
Bihar,4046,251975,1453,3822,252331,1457,257610,257474,2021-01-18 20:17:40.758455
Chandigarh,238,19935,330,229,19978,330,20537,20503,2021-01-18 20:17:40.758455
Chhattisgarh,6867,282760,3551,6832,283111,3558,293501,293178,2021-01-18 20:17:40.758455
Dadra and Nagar Haveli and Daman and Diu,9,3377,2,11,3377,2,3390,3388,2021-01-18 20:17:40.758455
Delhi,2691,618754,10738,2544,619139,10746,632429,632183,2021-01-18 20:17:40.758455
Goa,877,50712,756,878,50771,756,52405,52345,2021-01-18 20:17:40.758455
Gujarat,6588,244403,4363,6400,245107,4365,255872,255354,2021-01-18 20:17:40.758455
Haryana,2129,261019,2983,2094,261230,2985,266309,266131,2021-01-18 20:17:40.758455
Himachal Pradesh,755,55154,964,697,55280,966,56943,56873,2021-01-18 20:17:40.758455
Jammu and Kashmir,1280,120016,1921,1224,120198,1921,123343,123217,2021-01-18 20:17:40.758455
Jharkhand,1249,115300,1050,1225,115411,1050,117686,117599,2021-01-18 20:17:40.758455
Karnataka,8713,910377,12162,8599,911232,12166,931997,931252,2021-01-18 20:17:40.758455
Kerala,68633,770768,3442,69209,775176,3463,847848,842843,2021-01-18 20:17:40.758455
Ladakh,93,9428,128,91,9437,128,9656,9649,2021-01-18 20:17:40.758455
Lakshadweep,0,0,0,0,0,0,0,0,2021-01-18 20:17:40.758455
Madhya Pradesh,6524,240948,3751,6399,241426,3753,251578,251223,2021-01-18 20:17:40.758455
Maharashtra,53163,1884127,50388,53852,1886469,50438,1990759,1987678,2021-01-18 20:17:40.758455
Manipur,380,28089,366,343,28147,366,28856,28835,2021-01-18 20:17:40.758455
Meghalaya,148,13401,144,148,13412,144,13704,13693,2021-01-18 20:17:40.758455
Mizoram,85,4228,9,79,4235,9,4323,4322,2021-01-18 20:17:40.758455
Nagaland,117,11849,88,116,11854,88,12058,12054,2021-01-18 20:17:40.758455
Odisha,1910,329318,1899,1864,329546,1900,333310,333127,2021-01-18 20:17:40.758455
Puducherry,286,37683,642,284,37720,642,38646,38611,2021-01-18 20:17:40.758455
Punjab,2578,162289,5499,2617,162484,5504,170605,170366,2021-01-18 20:17:40.758455
Rajasthan,5286,306888,2746,5050,307384,2747,315181,314920,2021-01-18 20:17:40.758455
Sikkim,158,5741,130,161,5747,130,6038,6029,2021-01-18 20:17:40.758455
Tamil Nadu,6128,811798,12257,5940,812568,12264,830772,830183,2021-01-18 20:17:40.758455
Telengana,4191,285898,1577,4049,286244,1579,291872,291666,2021-01-18 20:17:40.758455
Tripura,38,32902,391,39,32902,391,33332,33331,2021-01-18 20:17:40.758455
Uttarakhand,2349,90736,1606,2354,90838,1611,94803,94691,2021-01-18 20:17:40.758455
Uttar Pradesh,9162,578405,8570,8881,579071,8576,596528,596137,2021-01-18 20:17:40.758455
West Bengal,7151,547515,10041,7083,548136,10053,565272,564707,2021-01-18 20:17:40.758455
Andaman and Nicobar Islands,25,4896,62,29,4897,62,4988,4983,2021-01-19 20:08:06.801629
Andhra Pradesh,1896,876949,7140,1713,877212,7141,886066,885985,2021-01-19 20:08:06.801629
Arunachal Pradesh,58,16697,56,57,16699,56,16812,16811,2021-01-19 20:08:06.801629
Assam,2919,212839,1073,2811,212978,1075,216864,216831,2021-01-19 20:08:06.801629
Bihar,3822,252331,1457,3308,253007,1460,257775,257610,2021-01-19 20:08:06.801629
Chandigarh,229,19978,330,203,20031,330,20564,20537,2021-01-19 20:08:06.801629
Chhattisgarh,6832,283111,3558,5995,284412,3565,293972,293501,2021-01-19 20:08:06.801629
Dadra and Nagar Haveli and Daman and Diu,11,3377,2,11,3377,2,3390,3390,2021-01-19 20:08:06.801629
Delhi,2544,619139,10746,2335,619501,10754,632590,632429,2021-01-19 20:08:06.801629
Goa,878,50771,756,865,50837,756,52458,52405,2021-01-19 20:08:06.801629
Gujarat,6400,245107,4365,6193,245807,4367,256367,255872,2021-01-19 20:08:06.801629
Haryana,2094,261230,2985,1929,261510,2989,266428,266309,2021-01-19 20:08:06.801629
Himachal Pradesh,697,55280,966,628,55383,967,56978,56943,2021-01-19 20:08:06.801629
Jammu and Kashmir,1224,120198,1921,1111,120392,1922,123425,123343,2021-01-19 20:08:06.801629
Jharkhand,1225,115411,1050,1190,115542,1054,117786,117686,2021-01-19 20:08:06.801629
Karnataka,8599,911232,12166,8052,912205,12175,932432,931997,2021-01-19 20:08:06.801629
Kerala,69209,775176,3463,68617,779097,3480,851194,847848,2021-01-19 20:08:06.801629
Ladakh,91,9437,128,81,9448,128,9657,9656,2021-01-19 20:08:06.801629
Lakshadweep,0,0,0,14,0,0,14,0,2021-01-19 20:08:06.801629
Madhya Pradesh,6399,241426,3753,6160,241966,3756,251882,251578,2021-01-19 20:08:06.801629
Maharashtra,53852,1886469,50438,51887,1890323,50473,1992683,1990759,2021-01-19 20:08:06.801629
Manipur,343,28147,366,296,28205,366,28867,28856,2021-01-19 20:08:06.801629
Meghalaya,148,13412,144,148,13415,144,13707,13704,2021-01-19 20:08:06.801629
Mizoram,79,4235,9,79,4241,9,4329,4323,2021-01-19 20:08:06.801629
Nagaland,116,11854,88,115,11858,88,12061,12058,2021-01-19 20:08:06.801629
Odisha,1864,329546,1900,1742,329801,1901,333444,333310,2021-01-19 20:08:06.801629
Puducherry,284,37720,642,286,37740,643,38669,38646,2021-01-19 20:08:06.801629
Punjab,2617,162484,5504,2458,162762,5509,170729,170605,2021-01-19 20:08:06.801629
Rajasthan,5050,307384,2747,4634,308010,2750,315394,315181,2021-01-19 20:08:06.801629
Sikkim,161,5747,130,152,5756,130,6038,6038,2021-01-19 20:08:06.801629
Tamil Nadu,5940,812568,12264,5725,813326,12272,831323,830772,2021-01-19 20:08:06.801629
Telengana,4049,286244,1579,4005,286542,1581,292128,291872,2021-01-19 20:08:06.801629
Tripura,39,32902,391,39,32905,391,33335,33332,2021-01-19 20:08:06.801629
Uttarakhand,2354,90838,1611,2136,91170,1617,94923,94803,2021-01-19 20:08:06.801629
Uttar Pradesh,8881,579071,8576,8631,579693,8580,596904,596528,2021-01-19 20:08:06.801629
West Bengal,7083,548136,10053,6893,548705,10063,565661,565272,2021-01-19 20:08:06.801629
Andaman and Nicobar Islands,29,4897,62,30,4897,62,4989,4988,2021-01-20 22:26:25.204633
Andhra Pradesh,1713,877212,7141,1660,877443,7142,886245,886066,2021-01-20 22:26:25.204633
Arunachal Pradesh,57,16699,56,52,16707,56,16815,16812,2021-01-20 22:26:25.204633
Assam,2811,212978,1075,2728,213084,1075,216887,216864,2021-01-20 22:26:25.204633
Bihar,3308,253007,1460,3241,253289,1461,257991,257775,2021-01-20 22:26:25.204633
Chandigarh,203,20031,330,185,20080,330,20595,20564,2021-01-20 22:26:25.204633
Chhattisgarh,5995,284412,3565,5932,284848,3575,294355,293972,2021-01-20 22:26:25.204633
Dadra and Nagar Haveli and Daman and Diu,11,3377,2,9,3380,2,3391,3390,2021-01-20 22:26:25.204633
Delhi,2335,619501,10754,2334,619723,10764,632821,632590,2021-01-20 22:26:25.204633
Goa,865,50837,756,862,50952,756,52570,52458,2021-01-20 22:26:25.204633
Gujarat,6193,245807,4367,5967,246516,4369,256852,256367,2021-01-20 22:26:25.204633
Haryana,1929,261510,2989,1837,261751,2993,266581,266428,2021-01-20 22:26:25.204633
Himachal Pradesh,628,55383,967,584,55468,967,57019,56978,2021-01-20 22:26:25.204633
Jammu and Kashmir,1111,120392,1922,1103,120512,1923,123538,123425,2021-01-20 22:26:25.204633
Jharkhand,1190,115542,1054,1147,115683,1057,117887,117786,2021-01-20 22:26:25.204633
Karnataka,8052,912205,12175,7884,913012,12181,933077,932432,2021-01-20 22:26:25.204633
Kerala,68617,779097,3480,70481,783393,3506,857380,851194,2021-01-20 22:26:25.204633
Ladakh,81,9448,128,79,9454,129,9662,9657,2021-01-20 22:26:25.204633
Lakshadweep,14,0,0,21,0,0,21,14,2021-01-20 22:26:25.204633
Madhya Pradesh,6160,241966,3756,5732,242691,3763,252186,251882,2021-01-20 22:26:25.204633
Maharashtra,51887,1890323,50473,49615,1894839,50523,1994977,1992683,2021-01-20 22:26:25.204633
Manipur,296,28205,366,235,28298,367,28900,28867,2021-01-20 22:26:25.204633
Meghalaya,148,13415,144,133,13433,144,13710,13707,2021-01-20 22:26:25.204633
Mizoram,79,4241,9,67,4258,9,4334,4329,2021-01-20 22:26:25.204633
Nagaland,115,11858,88,112,11866,88,12066,12061,2021-01-20 22:26:25.204633
Odisha,1742,329801,1901,1613,330051,1902,333566,333444,2021-01-20 22:26:25.204633
Puducherry,286,37740,643,297,37766,643,38706,38669,2021-01-20 22:26:25.204633
Punjab,2458,162762,5509,2412,163009,5516,170937,170729,2021-01-20 22:26:25.204633
Rajasthan,4634,308010,2750,4304,308547,2752,315603,315394,2021-01-20 22:26:25.204633
Sikkim,152,5756,130,156,5765,131,6052,6038,2021-01-20 22:26:25.204633
Tamil Nadu,5725,813326,12272,5487,814098,12281,831866,831323,2021-01-20 22:26:25.204633
Telengana,4005,286542,1581,3919,286893,1583,292395,292128,2021-01-20 22:26:25.204633
Tripura,39,32905,391,38,32907,391,33336,33335,2021-01-20 22:26:25.204633
Uttarakhand,2136,91170,1617,1992,91428,1619,95039,94923,2021-01-20 22:26:25.204633
Uttar Pradesh,8631,579693,8580,8172,580482,8584,597238,596904,2021-01-20 22:26:25.204633
West Bengal,6893,548705,10063,6781,549218,10074,566073,565661,2021-01-20 22:26:25.204633
Andaman and Nicobar Islands,30,4897,62,29,4900,62,4991,4989,2021-01-21 20:19:14.203882
Andhra Pradesh,1660,877443,7142,1637,877639,7142,886418,886245,2021-01-21 20:19:14.203882
Arunachal Pradesh,52,16707,56,46,16713,56,16815,16815,2021-01-21 20:19:14.203882
Assam,2728,213084,1075,2663,213179,1077,216919,216887,2021-01-21 20:19:14.203882
Bihar,3241,253289,1461,3143,253569,1464,258176,257991,2021-01-21 20:19:14.203882
Chandigarh,185,20080,330,171,20122,330,20623,20595,2021-01-21 20:19:14.203882
Chhattisgarh,5932,284848,3575,5798,285566,3585,294949,294355,2021-01-21 20:19:14.203882
Dadra and Nagar Haveli and Daman and Diu,9,3380,2,11,3380,2,3393,3391,2021-01-21 20:19:14.203882
Delhi,2334,619723,10764,2147,620128,10774,633049,632821,2021-01-21 20:19:14.203882
Goa,862,50952,756,865,51036,756,52657,52570,2021-01-21 20:19:14.203882
Gujarat,5967,246516,4369,5748,247223,4371,257342,256852,2021-01-21 20:19:14.203882
Haryana,1837,261751,2993,1734,261955,2997,266686,266581,2021-01-21 20:19:14.203882
Himachal Pradesh,584,55468,967,575,55540,967,57082,57019,2021-01-21 20:19:14.203882
Jammu and Kashmir,1103,120512,1923,1099,120625,1923,123647,123538,2021-01-21 20:19:14.203882
Jharkhand,1147,115683,1057,1102,115853,1057,118012,117887,2021-01-21 20:19:14.203882
Karnataka,7884,913012,12181,7716,913677,12185,933578,933077,2021-01-21 20:19:14.203882
Kerala,70481,783393,3506,69914,790757,3524,864195,857380,2021-01-21 20:19:14.203882
Ladakh,79,9454,129,76,9463,129,9668,9662,2021-01-21 20:19:14.203882
Lakshadweep,21,0,0,30,0,0,30,21,2021-01-21 20:19:14.203882
Madhya Pradesh,5732,242691,3763,5008,243688,3770,252466,252186,2021-01-21 20:19:14.203882
Maharashtra,49615,1894839,50523,47982,1899428,50582,1997992,1994977,2021-01-21 20:19:14.203882
Manipur,235,28298,367,244,28308,367,28919,28900,2021-01-21 20:19:14.203882
Meghalaya,133,13433,144,133,13440,144,13717,13710,2021-01-21 20:19:14.203882
Mizoram,67,4258,9,69,4268,9,4346,4334,2021-01-21 20:19:14.203882
Nagaland,112,11866,88,106,11873,88,12067,12066,2021-01-21 20:19:14.203882
Odisha,1613,330051,1902,1500,330321,1902,333723,333566,2021-01-21 20:19:14.203882
Puducherry,297,37766,643,296,37798,643,38737,38706,2021-01-21 20:19:14.203882
Punjab,2412,163009,5516,2405,163211,5520,171136,170937,2021-01-21 20:19:14.203882
Rajasthan,4304,308547,2752,4077,308985,2754,315816,315603,2021-01-21 20:19:14.203882
Sikkim,156,5765,131,160,5766,131,6057,6052,2021-01-21 20:19:14.203882
Tamil Nadu,5487,814098,12281,5314,814811,12290,832415,831866,2021-01-21 20:19:14.203882
Telengana,3919,286893,1583,3920,287117,1584,292621,292395,2021-01-21 20:19:14.203882
Tripura,38,32907,391,37,32911,391,33339,33336,2021-01-21 20:19:14.203882
Uttarakhand,1992,91428,1619,2005,91565,1622,95192,95039,2021-01-21 20:19:14.203882
Uttar Pradesh,8172,580482,8584,7873,581164,8591,597628,597238,2021-01-21 20:19:14.203882
West Bengal,6781,549218,10074,6675,549727,10080,566482,566073,2021-01-21 20:19:14.203882
Andaman and Nicobar Islands,29,4900,62,25,4904,62,4991,4991,2021-01-22 20:26:07.151984
Andhra Pradesh,1637,877639,7142,1522,877893,7142,886557,886418,2021-01-22 20:26:07.151984
Arunachal Pradesh,46,16713,56,38,16722,56,16816,16815,2021-01-22 20:26:07.151984
Assam,2663,213179,1077,2568,213295,1077,216940,216919,2021-01-22 20:26:07.151984
Bihar,3143,253569,1464,2923,254023,1468,258414,258176,2021-01-22 20:26:07.151984
Chandigarh,171,20122,330,146,20162,331,20639,20623,2021-01-22 20:26:07.151984
Chhattisgarh,5798,285566,3585,5638,286277,3594,295509,294949,2021-01-22 20:26:07.151984
Dadra and Nagar Haveli and Daman and Diu,11,3380,2,10,3381,2,3393,3393,2021-01-22 20:26:07.151984
Delhi,2147,620128,10774,2120,620374,10782,633276,633049,2021-01-22 20:26:07.151984
Goa,865,51036,756,865,51090,757,52712,52657,2021-01-22 20:26:07.151984
Gujarat,5748,247223,4371,5491,247950,4372,257813,257342,2021-01-22 20:26:07.151984
Haryana,1734,261955,2997,1679,262140,3000,266819,266686,2021-01-22 20:26:07.151984
Himachal Pradesh,575,55540,967,556,55595,970,57121,57082,2021-01-22 20:26:07.151984
Jammu and Kashmir,1099,120625,1923,1111,120729,1924,123764,123647,2021-01-22 20:26:07.151984
Jharkhand,1102,115853,1057,1032,115989,1058,118079,118012,2021-01-22 20:26:07.151984
Karnataka,7716,913677,12185,7573,914492,12187,934252,933578,2021-01-22 20:26:07.151984
Kerala,69914,790757,3524,69998,796986,3545,870529,864195,2021-01-22 20:26:07.151984
Ladakh,76,9463,129,73,9471,129,9673,9668,2021-01-22 20:26:07.151984
Lakshadweep,30,0,0,48,0,0,48,30,2021-01-22 20:26:07.151984
Madhya Pradesh,5008,243688,3770,4599,244392,3776,252767,252466,2021-01-22 20:26:07.151984
Maharashtra,47982,1899428,50582,46836,1903408,50634,2000878,1997992,2021-01-22 20:26:07.151984
Manipur,244,28308,367,220,28351,367,28938,28919,2021-01-22 20:26:07.151984
Meghalaya,133,13440,144,129,13446,146,13721,13717,2021-01-22 20:26:07.151984
Mizoram,69,4268,9,64,4276,9,4349,4346,2021-01-22 20:26:07.151984
Nagaland,106,11873,88,107,11875,88,12070,12067,2021-01-22 20:26:07.151984
Odisha,1500,330321,1902,1418,330545,1903,333866,333723,2021-01-22 20:26:07.151984
Puducherry,296,37798,643,299,37830,643,38772,38737,2021-01-22 20:26:07.151984
Punjab,2405,163211,5520,2343,163438,5535,171316,171136,2021-01-22 20:26:07.151984
Rajasthan,4077,308985,2754,3934,309391,2756,316081,315816,2021-01-22 20:26:07.151984
Sikkim,160,5766,131,148,5783,131,6062,6057,2021-01-22 20:26:07.151984
Tamil Nadu,5314,814811,12290,5196,815516,12299,833011,832415,2021-01-22 20:26:07.151984
Telengana,3920,287117,1584,3781,287468,1586,292835,292621,2021-01-22 20:26:07.151984
Tripura,37,32911,391,40,32911,391,33342,33339,2021-01-22 20:26:07.151984
Uttarakhand,2005,91565,1622,1876,91852,1626,95354,95192,2021-01-22 20:26:07.151984
Uttar Pradesh,7873,581164,8591,7717,581509,8597,597823,597628,2021-01-22 20:26:07.151984
West Bengal,6675,549727,10080,6565,550244,10089,566898,566482,2021-01-22 20:26:07.151984
Andaman and Nicobar Islands,25,4904,62,23,4907,62,4992,4991,2021-01-23 20:03:39.819906
Andhra Pradesh,1522,877893,7142,1488,878060,7146,886694,886557,2021-01-23 20:03:39.819906
Arunachal Pradesh,38,16722,56,37,16724,56,16817,16816,2021-01-23 20:03:39.819906
Assam,2568,213295,1077,2482,213398,1077,216957,216940,2021-01-23 20:03:39.819906
Bihar,2923,254023,1468,2682,254359,1472,258513,258414,2021-01-23 20:03:39.819906
Chandigarh,146,20162,331,137,20195,332,20664,20639,2021-01-23 20:03:39.819906
Chhattisgarh,5638,286277,3594,5308,287040,3601,295949,295509,2021-01-23 20:03:39.819906
Dadra and Nagar Haveli and Daman and Diu,10,3381,2,10,3382,2,3394,3393,2021-01-23 20:03:39.819906
Delhi,2120,620374,10782,2060,620693,10789,633542,633276,2021-01-23 20:03:39.819906
Goa,865,51090,757,854,51170,758,52782,52712,2021-01-23 20:03:39.819906
Gujarat,5491,247950,4372,5240,248650,4374,258264,257813,2021-01-23 20:03:39.819906
Haryana,1679,262140,3000,1585,262349,3005,266939,266819,2021-01-23 20:03:39.819906
Himachal Pradesh,556,55595,970,516,55676,970,57162,57121,2021-01-23 20:03:39.819906
Jammu and Kashmir,1111,120729,1924,1098,120826,1928,123852,123764,2021-01-23 20:03:39.819906
Jharkhand,1032,115989,1058,978,116116,1060,118154,118079,2021-01-23 20:03:39.819906
Karnataka,7573,914492,12187,7004,915382,12190,934576,934252,2021-01-23 20:03:39.819906
Kerala,69998,796986,3545,70624,803094,3564,877282,870529,2021-01-23 20:03:39.819906
Ladakh,73,9471,129,68,9476,129,9673,9673,2021-01-23 20:03:39.819906
Lakshadweep,48,0,0,50,0,0,50,48,2021-01-23 20:03:39.819906
Madhya Pradesh,4599,244392,3776,4479,244855,3780,253114,252767,2021-01-23 20:03:39.819906
Maharashtra,46836,1903408,50634,46146,1906827,50684,2003657,2000878,2021-01-23 20:03:39.819906
Manipur,220,28351,367,197,28387,369,28953,28938,2021-01-23 20:03:39.819906
Meghalaya,129,13446,146,128,13449,146,13723,13721,2021-01-23 20:03:39.819906
Mizoram,64,4276,9,58,4282,9,4349,4349,2021-01-23 20:03:39.819906
Nagaland,107,11875,88,104,11880,88,12072,12070,2021-01-23 20:03:39.819906
Odisha,1418,330545,1903,1360,330757,1903,334020,333866,2021-01-23 20:03:39.819906
Puducherry,299,37830,643,294,37857,643,38794,38772,2021-01-23 20:03:39.819906
Punjab,2343,163438,5535,2324,163655,5543,171522,171316,2021-01-23 20:03:39.819906
Rajasthan,3934,309391,2756,3719,309807,2756,316282,316081,2021-01-23 20:03:39.819906
Sikkim,148,5783,131,140,5792,131,6063,6062,2021-01-23 20:03:39.819906
Tamil Nadu,5196,815516,12299,5073,816205,12307,833585,833011,2021-01-23 20:03:39.819906
Telengana,3781,287468,1586,3569,287899,1588,293056,292835,2021-01-23 20:03:39.819906
Tripura,40,32911,391,34,32919,391,33344,33342,2021-01-23 20:03:39.819906
Uttarakhand,1876,91852,1626,1795,92040,1629,95464,95354,2021-01-23 20:03:39.819906
Uttar Pradesh,7717,581509,8597,7528,581993,8605,598126,597823,2021-01-23 20:03:39.819906
West Bengal,6565,550244,10089,6470,550737,10097,567304,566898,2021-01-23 20:03:39.819906
Andaman and Nicobar Islands,23,4907,62,24,4907,62,4993,4992,2021-01-24 20:26:12.219568
Andhra Pradesh,1488,878060,7146,1473,878232,7147,886852,886694,2021-01-24 20:26:12.219568
Arunachal Pradesh,37,16724,56,37,16725,56,16818,16817,2021-01-24 20:26:12.219568
Assam,2482,213398,1077,2407,213492,1077,216976,216957,2021-01-24 20:26:12.219568
Bihar,2682,254359,1472,2599,254563,1476,258638,258513,2021-01-24 20:26:12.219568
Chandigarh,137,20195,332,127,20226,333,20686,20664,2021-01-24 20:26:12.219568
Chhattisgarh,5308,287040,3601,5040,287677,3609,296326,295949,2021-01-24 20:26:12.219568
Dadra and Nagar Haveli and Daman and Diu,10,3382,2,10,3382,2,3394,3394,2021-01-24 20:26:12.219568
Delhi,2060,620693,10789,1880,621060,10799,633739,633542,2021-01-24 20:26:12.219568
Goa,854,51170,758,873,51233,761,52867,52782,2021-01-24 20:26:12.219568
Gujarat,5240,248650,4374,4960,249352,4375,258687,258264,2021-01-24 20:26:12.219568
Haryana,1585,262349,3005,1559,262507,3009,267075,266939,2021-01-24 20:26:12.219568
Himachal Pradesh,516,55676,970,469,55749,971,57189,57162,2021-01-24 20:26:12.219568
Jammu and Kashmir,1098,120826,1928,1103,120914,1929,123946,123852,2021-01-24 20:26:12.219568
Jharkhand,978,116116,1060,878,116293,1061,118232,118154,2021-01-24 20:26:12.219568
Karnataka,7004,915382,12190,7361,915924,12193,935478,934576,2021-01-24 20:26:12.219568
Kerala,70624,803094,3564,72278,808377,3587,884242,877282,2021-01-24 20:26:12.219568
Ladakh,68,9476,129,62,9484,129,9675,9673,2021-01-24 20:26:12.219568
Lakshadweep,50,0,0,57,0,0,57,50,2021-01-24 20:26:12.219568
Madhya Pradesh,4479,244855,3780,4310,245309,3786,253405,253114,2021-01-24 20:26:12.219568
Maharashtra,46146,1906827,50684,45093,1910521,50740,2006354,2003657,2021-01-24 20:26:12.219568
Manipur,197,28387,369,196,28405,369,28970,28953,2021-01-24 20:26:12.219568
Meghalaya,128,13449,146,122,13459,146,13727,13723,2021-01-24 20:26:12.219568
Mizoram,58,4282,9,58,4284,9,4351,4349,2021-01-24 20:26:12.219568
Nagaland,104,11880,88,104,11884,88,12076,12072,2021-01-24 20:26:12.219568
Odisha,1360,330757,1903,1284,330962,1904,334150,334020,2021-01-24 20:26:12.219568
Puducherry,294,37857,643,302,37884,644,38830,38794,2021-01-24 20:26:12.219568
Punjab,2324,163655,5543,2293,163887,5553,171733,171522,2021-01-24 20:26:12.219568
Rajasthan,3719,309807,2756,3448,310279,2758,316485,316282,2021-01-24 20:26:12.219568
Sikkim,140,5792,131,134,5802,132,6068,6063,2021-01-24 20:26:12.219568
Tamil Nadu,5073,816205,12307,4984,816878,12309,834171,833585,2021-01-24 20:26:12.219568
Telengana,3569,287899,1588,3389,288275,1589,293253,293056,2021-01-24 20:26:12.219568
Tripura,34,32919,391,35,32919,391,33345,33344,2021-01-24 20:26:12.219568
Uttarakhand,1795,92040,1629,1733,92224,1629,95586,95464,2021-01-24 20:26:12.219568
Uttar Pradesh,7528,581993,8605,7330,582506,8609,598445,598126,2021-01-24 20:26:12.219568
West Bengal,6470,550737,10097,6396,551211,10107,567714,567304,2021-01-24 20:26:12.219568
Andaman and Nicobar Islands,147,4907,62,152,3469,52,3673,4993,2021-01-25 17:39:44
Andhra Pradesh,78836,878232,7147,74518,551821,5410,631749,886852,2021-01-25 17:39:44
Arunachal Pradesh,1964,16725,56,1939,5643,13,7595,16818,2021-01-25 17:39:44
Assam,28780,213492,1077,29609,129133,578,159320,216976,2021-01-25 17:39:44
Bihar,13005,254563,1476,12539,156242,870,169651,258638,2021-01-25 17:39:44
Chandigarh,2821,20226,333,2761,7411,126,10298,20686,2021-01-25 17:39:44
Chhattisgarh,37853,287677,3609,37927,49564,690,88181,296326,2021-01-25 17:39:44
Dadra and Nagar Haveli and Daman and Diu,229,3382,2,220,2711,2,2933,3394,2021-01-25 17:39:44
Delhi,32097,621060,10799,30941,213304,5014,249259,633739,2021-01-25 17:39:44
Goa,5781,51233,761,5667,22726,360,28753,52867,2021-01-25 17:39:44
Gujarat,16208,249352,4375,16305,104964,3336,124605,258687,2021-01-25 17:39:44
Haryana,21411,262507,3009,21014,90884,1177,113075,267075,2021-01-25 17:39:44
Himachal Pradesh,4444,55749,971,4458,7853,127,12438,57189,2021-01-25 17:39:44
Jammu and Kashmir,22032,120914,1929,21887,42115,1024,65026,123946,2021-01-25 17:39:44
Jharkhand,13791,116293,1061,13504,58543,626,72673,118232,2021-01-25 17:39:44
Karnataka,98062,915924,12193,95354,423377,8145,526876,935478,2021-01-25 17:39:44
Kerala,39484,808377,3587,39354,98724,553,138631,884242,2021-01-25 17:39:44
Ladakh,1013,9484,129,1047,2735,50,3832,9675,2021-01-25 17:39:44
Lakshadweep,0,0,0,0,0,0,0,57,2021-01-25 17:39:44
Madhya Pradesh,22300,245309,3786,22542,83618,2007,108167,253405,2021-01-25 17:39:44
Maharashtra,291630,1910521,50740,275017,916348,33015,1224380,2006354,2021-01-25 17:39:44
Manipur,2070,28405,369,2113,6838,59,9010,28970,2021-01-25 17:39:44
Meghalaya,2111,13459,146,2169,2527,37,4733,13727,2021-01-25 17:39:44
Mizoram,583,4284,9,680,1012,0,1692,4351,2021-01-25 17:39:44
Nagaland,1184,11884,88,1052,4477,15,5544,12076,2021-01-25 17:39:44
Odisha,33504,330962,1904,34033,149379,710,184122,334150,2021-01-25 17:39:44
Puducherry,4908,37884,644,4659,18065,467,23191,38830,2021-01-25 17:39:44
Punjab,22278,163887,5553,21661,75409,2860,99930,171733,2021-01-25 17:39:44
Rajasthan,18184,310279,2758,18245,97284,1352,116881,316485,2021-01-25 17:39:44
Sikkim,469,5802,132,513,1986,29,2528,6068,2021-01-25 17:39:44
Tamil Nadu,46703,816878,12309,46495,491971,8871,547337,834171,2021-01-25 17:39:44
Telengana,29636,288275,1589,29649,144073,1052,174774,293253,2021-01-25 17:39:44
Tripura,6566,32919,391,6700,15883,251,22834,33345,2021-01-25 17:39:44
Uttarakhand,12455,582506,8609,12075,29201,501,41777,598445,2021-01-25 17:39:44
Uttar Pradesh,65954,92224,1629,64164,289594,5135,358893,95586,2021-01-25 17:39:44
West Bengal,24806,551211,10107,24898,198983,4421,228302,567714,2021-01-25 17:39:44
Andaman and Nicobar Islands,23,4908,62,15,4917,62,4994,4993,2021-01-26 20:25:12.454589
Andhra Pradesh,1476,878387,7147,1389,878528,7149,887066,887010,2021-01-26 20:25:12.454589
Arunachal Pradesh,18,16745,56,15,16749,56,16820,16819,2021-01-26 20:25:12.454589
Assam,2323,213591,1078,2265,213674,1078,217017,216992,2021-01-26 20:25:12.454589
Bihar,2317,254991,1479,2359,255019,1483,258861,258787,2021-01-26 20:25:12.454589
Chandigarh,136,20248,334,142,20273,334,20749,20718,2021-01-26 20:25:12.454589
Chhattisgarh,4943,288066,3617,4896,288582,3630,297108,296626,2021-01-26 20:25:12.454589
Dadra and Nagar Haveli and Daman and Diu,6,3386,2,5,3387,2,3394,3394,2021-01-26 20:25:12.454589
Delhi,1741,621375,10808,1694,621565,10813,634072,633924,2021-01-26 20:25:12.454589
Goa,824,51335,761,767,51448,762,52977,52920,2021-01-26 20:25:12.454589
Gujarat,4665,250056,4376,4345,250763,4379,259487,259097,2021-01-26 20:25:12.454589
Haryana,1511,262682,3010,1378,262929,3014,267321,267203,2021-01-26 20:25:12.454589
Himachal Pradesh,436,55801,973,408,55864,973,57245,57210,2021-01-26 20:25:12.454589
Jammu and Kashmir,1103,120987,1929,1084,121070,1929,124083,124019,2021-01-26 20:25:12.454589
Jharkhand,821,116402,1063,772,116524,1064,118360,118286,2021-01-26 20:25:12.454589
Karnataka,7529,916325,12197,6865,917361,12200,936426,936051,2021-01-26 20:25:12.454589
Kerala,73121,813550,3607,70859,819156,3624,893639,890278,2021-01-26 20:25:12.454589
Ladakh,65,9493,129,54,9504,129,9687,9687,2021-01-26 20:25:12.454589
Lakshadweep,59,0,0,67,0,0,67,59,2021-01-26 20:25:12.454589
Madhya Pradesh,4171,245697,3789,3508,246558,3791,253857,253657,2021-01-26 20:25:12.454589
Maharashtra,46057,1912264,50785,44789,1915344,50815,2010948,2009106,2021-01-26 20:25:12.454589
Manipur,201,28416,369,186,28442,369,28997,28986,2021-01-26 20:25:12.454589
Meghalaya,111,13475,146,104,13484,146,13734,13732,2021-01-26 20:25:12.454589
Mizoram,53,4289,9,49,4298,9,4356,4351,2021-01-26 20:25:12.454589
Nagaland,103,11885,88,96,11895,88,12079,12076,2021-01-26 20:25:12.454589
Odisha,1251,331144,1905,1240,331284,1906,334430,334300,2021-01-26 20:25:12.454589
Puducherry,288,37927,645,280,37953,645,38878,38860,2021-01-26 20:25:12.454589
Punjab,2256,164119,5555,2152,164377,5560,172089,171930,2021-01-26 20:25:12.454589
Rajasthan,3147,310747,2758,2968,311117,2760,316845,316652,2021-01-26 20:25:12.454589
Sikkim,127,5811,133,115,5824,133,6072,6071,2021-01-26 20:25:12.454589
Tamil Nadu,4904,817520,12316,4813,818147,12320,835280,834740,2021-01-26 20:25:12.454589
Telengana,3234,288577,1590,3072,288926,1592,293590,293401,2021-01-26 20:25:12.454589
Tripura,32,32922,391,28,32927,391,33346,33345,2021-01-26 20:25:12.454589
Uttarakhand,1725,92284,1631,1523,92544,1635,95702,95640,2021-01-26 20:25:12.454589
Uttar Pradesh,7082,583014,8617,6813,583470,8624,598907,598713,2021-01-26 20:25:12.454589
West Bengal,6323,551665,10115,6151,552082,10122,568355,568103,2021-01-26 20:25:12.454589
Andaman and Nicobar Islands,147,4917,62,152,3469,52,3673,4994,2021-01-28 17:39:44
Andhra Pradesh,78836,878731,7150,74518,551821,5410,631749,887238,2021-01-28 17:39:44
Arunachal Pradesh,1964,16751,56,1939,5643,13,7595,16821,2021-01-28 17:39:44
Assam,28780,213763,1079,29609,129133,578,159320,217025,2021-01-28 17:39:44
Bihar,13005,255174,1486,12539,156242,870,169651,258996,2021-01-28 17:39:44
Chandigarh,2821,20302,334,2761,7411,126,10298,20775,2021-01-28 17:39:44
Chhattisgarh,37853,288764,3644,37927,49564,690,88181,297429,2021-01-28 17:39:44
Dadra and Nagar Haveli and Daman and Diu,229,3388,2,220,2711,2,2933,3395,2021-01-28 17:39:44
Delhi,32097,621783,10820,30941,213304,5014,249259,634229,2021-01-28 17:39:44
Goa,5781,51510,763,5667,22726,360,28753,53047,2021-01-28 17:39:44
Gujarat,16208,251400,4381,16305,104964,3336,124605,259867,2021-01-28 17:39:44
Haryana,21411,263119,3014,21014,90884,1177,113075,267417,2021-01-28 17:39:44
Himachal Pradesh,4444,55923,973,4458,7853,127,12438,57257,2021-01-28 17:39:44
Jammu and Kashmir,22032,121124,1930,21887,42115,1024,65026,124157,2021-01-28 17:39:44
Jharkhand,13791,116589,1064,13504,58543,626,72673,118425,2021-01-28 17:39:44
Karnataka,98062,918099,12204,95354,423377,8145,526876,936955,2021-01-28 17:39:44
Kerala,39484,824446,3643,39354,98724,553,138631,899932,2021-01-28 17:39:44
Ladakh,1013,9508,129,1047,2735,50,3832,9688,2021-01-28 17:39:44
Lakshadweep,0,0,0,0,0,0,0,69,2021-01-28 17:39:44
Madhya Pradesh,22300,247073,3793,22542,83618,2007,108167,254085,2021-01-28 17:39:44
Maharashtra,291630,1917450,50862,275017,916348,33015,1224380,2013353,2021-01-28 17:39:44
Manipur,2070,28463,369,2113,6838,59,9010,29003,2021-01-28 17:39:44
Meghalaya,2111,13496,146,2169,2527,37,4733,13740,2021-01-28 17:39:44
Mizoram,583,4303,9,680,1012,0,1692,4359,2021-01-28 17:39:44
Nagaland,1184,11898,88,1052,4477,15,5544,12081,2021-01-28 17:39:44
Odisha,33504,331427,1906,34033,149379,710,184122,334529,2021-01-28 17:39:44
Puducherry,4908,37970,645,4659,18065,467,23191,38910,2021-01-28 17:39:44
Punjab,22278,164541,5571,21661,75409,2860,99930,172218,2021-01-28 17:39:44
Rajasthan,18184,311374,2760,18245,97284,1352,116881,316970,2021-01-28 17:39:44
Sikkim,469,5841,133,513,1986,29,2528,6078,2021-01-28 17:39:44
Tamil Nadu,46703,818742,12325,46495,491971,8871,547337,835803,2021-01-28 17:39:44
Telengana,29636,289325,1593,29649,144073,1052,174774,293737,2021-01-28 17:39:44
Tripura,6566,32931,391,6700,15883,251,22834,33346,2021-01-28 17:39:44
Uttarakhand,12455,584039,8632,12075,29201,501,41777,599208,2021-01-28 17:39:44
Uttar Pradesh,65954,92650,1636,64164,289594,5135,358893,95741,2021-01-28 17:39:44
West Bengal,24806,552491,10131,24898,198983,4421,228302,568650,2021-01-28 17:39:44
Andaman and Nicobar Islands,10,4922,62,8,4924,62,4994,4994,2021-01-29 20:00:22.696940
Andhra Pradesh,1369,878828,7152,1358,878956,7152,887466,887349,2021-01-29 20:00:22.696940
Arunachal Pradesh,15,16753,56,15,16756,56,16827,16824,2021-01-29 20:00:22.696940
Assam,2104,213857,1081,2038,213952,1081,217071,217042,2021-01-29 20:00:22.696940
Bihar,1645,256014,1490,1043,256679,1492,259214,259149,2021-01-29 20:00:22.696940
Chandigarh,146,20339,334,158,20363,334,20855,20819,2021-01-29 20:00:22.696940
Chhattisgarh,4513,289708,3647,4450,296187,3682,304319,297868,2021-01-29 20:00:22.696940
Dadra and Nagar Haveli and Daman and Diu,6,3388,2,7,3388,2,3397,3396,2021-01-29 20:00:22.696940
Delhi,1501,621995,10829,1575,622114,10835,634524,634325,2021-01-29 20:00:22.696940
Goa,737,51600,763,768,51652,765,53185,53100,2021-01-29 20:00:22.696940
Gujarat,3976,251862,4382,3718,252464,4384,260566,260220,2021-01-29 20:00:22.696940
Haryana,1254,263236,3014,1240,263347,3014,267601,267504,2021-01-29 20:00:22.696940
Himachal Pradesh,331,55991,974,339,56043,974,57356,57296,2021-01-29 20:00:22.696940
Jammu and Kashmir,1050,121253,1931,963,121402,1932,124297,124234,2021-01-29 20:00:22.696940
Jharkhand,723,116706,1066,670,116818,1069,118557,118495,2021-01-29 20:00:22.696940
Karnataka,6317,918859,12207,6221,919503,12209,937933,937383,2021-01-29 20:00:22.696940
Kerala,72476,829452,3663,72634,835046,3682,911362,905591,2021-01-29 20:00:22.696940
Ladakh,48,9511,129,63,9513,129,9705,9688,2021-01-29 20:00:22.696940
Lakshadweep,69,0,0,69,0,0,69,69,2021-01-29 20:00:22.696940
Madhya Pradesh,3053,247418,3799,2955,247739,3802,254496,254270,2021-01-29 20:00:22.696940
Maharashtra,44624,1920006,50894,44282,1923187,50944,2018413,2015524,2021-01-29 20:00:22.696940
Manipur,161,28476,370,153,28499,370,29022,29007,2021-01-29 20:00:22.696940
Meghalaya,89,13506,146,90,13513,146,13749,13741,2021-01-29 20:00:22.696940
Mizoram,42,4311,9,41,4313,9,4363,4362,2021-01-29 20:00:22.696940
Nagaland,57,11938,88,52,11944,88,12084,12083,2021-01-29 20:00:22.696940
Odisha,1226,331535,1906,1207,331667,1906,334780,334667,2021-01-29 20:00:22.696940
Puducherry,282,38006,646,291,38035,647,38973,38934,2021-01-29 20:00:22.696940
Punjab,2080,164745,5581,2079,164937,5590,172606,172406,2021-01-29 20:00:22.696940
Rajasthan,2664,311679,2761,2559,311867,2763,317189,317104,2021-01-29 20:00:22.696940
Sikkim,102,5844,133,104,5847,133,6084,6079,2021-01-29 20:00:22.696940
Tamil Nadu,4676,819306,12333,4629,819850,12339,836818,836315,2021-01-29 20:00:22.696940
Telengana,2698,289631,1594,2537,289987,1596,294120,293923,2021-01-29 20:00:22.696940
Tripura,21,32934,391,21,32936,391,33348,33346,2021-01-29 20:00:22.696940
Uttarakhand,1439,92748,1639,1338,92928,1642,95908,95826,2021-01-29 20:00:22.696940
Uttar Pradesh,6368,584372,8636,6230,584752,8642,599624,599376,2021-01-29 20:00:22.696940
West Bengal,5868,552877,10139,5781,553244,10148,569173,568884,2021-01-29 20:00:22.696940
Andaman and Nicobar Islands,8,4924,62,5,4927,62,4994,4994,2021-01-30 20:01:41.827250
Andhra Pradesh,1358,878956,7152,1308,879131,7152,887591,887466,2021-01-30 20:01:41.827250
Arunachal Pradesh,15,16756,56,13,16758,56,16827,16827,2021-01-30 20:01:41.827250
Assam,2038,213952,1081,1956,214054,1081,217091,217071,2021-01-30 20:01:41.827250
Bihar,1043,256679,1492,1021,256857,1495,259373,259214,2021-01-30 20:01:41.827250
Chandigarh,158,20363,334,159,20389,334,20882,20855,2021-01-30 20:01:41.827250
Chhattisgarh,4450,296187,3682,4358,296642,3689,304689,304319,2021-01-30 20:01:41.827250
Dadra and Nagar Haveli and Daman and Diu,7,3388,2,8,3388,2,3398,3397,2021-01-30 20:01:41.827250
Delhi,1575,622114,10835,1551,622381,10841,634773,634524,2021-01-30 20:01:41.827250
Goa,768,51652,765,742,51755,766,53263,53185,2021-01-30 20:01:41.827250
Gujarat,3718,252464,4384,3589,252927,4385,260901,260566,2021-01-30 20:01:41.827250
Haryana,1240,263347,3014,1192,263501,3015,267708,267601,2021-01-30 20:01:41.827250
Himachal Pradesh,339,56043,974,343,56083,974,57400,57356,2021-01-30 20:01:41.827250
Jammu and Kashmir,963,121402,1932,823,121617,1933,124373,124297,2021-01-30 20:01:41.827250
Jharkhand,670,116818,1069,628,116904,1070,118602,118557,2021-01-30 20:01:41.827250
Karnataka,6221,919503,12209,6080,920110,12211,938401,937933,2021-01-30 20:01:41.827250
Kerala,72634,835046,3682,72482,841444,3704,917630,911362,2021-01-30 20:01:41.827250
Ladakh,63,9513,129,68,9517,129,9714,9705,2021-01-30 20:01:41.827250
Lakshadweep,69,0,0,56,14,0,70,69,2021-01-30 20:01:41.827250
Madhya Pradesh,2955,247739,3802,2826,248036,3805,254667,254496,2021-01-30 20:01:41.827250
Maharashtra,44282,1923187,50944,44384,1925800,51000,2021184,2018413,2021-01-30 20:01:41.827250
Manipur,153,28499,370,142,28524,371,29037,29022,2021-01-30 20:01:41.827250
Meghalaya,90,13513,146,83,13524,146,13753,13749,2021-01-30 20:01:41.827250
Mizoram,41,4313,9,39,4318,9,4366,4363,2021-01-30 20:01:41.827250
Nagaland,52,11944,88,53,11947,88,12088,12084,2021-01-30 20:01:41.827250
Odisha,1207,331667,1906,1120,331824,1906,334850,334780,2021-01-30 20:01:41.827250
Puducherry,291,38035,647,295,38062,647,39004,38973,2021-01-30 20:01:41.827250
Punjab,2079,164937,5590,2114,165145,5601,172860,172606,2021-01-30 20:01:41.827250
Rajasthan,2559,311867,2763,2395,312132,2765,317292,317189,2021-01-30 20:01:41.827250
Sikkim,104,5847,133,97,5855,133,6085,6084,2021-01-30 20:01:41.827250
Tamil Nadu,4629,819850,12339,4601,820381,12345,837327,836818,2021-01-30 20:01:41.827250
Telengana,2537,289987,1596,2354,290354,1598,294306,294120,2021-01-30 20:01:41.827250
Tripura,21,32936,391,21,32938,391,33350,33348,2021-01-30 20:01:41.827250
Uttarakhand,1338,92928,1642,1289,93055,1642,95986,95908,2021-01-30 20:01:41.827250
Uttar Pradesh,6230,584752,8642,5918,585273,8646,599837,599624,2021-01-30 20:01:41.827250
West Bengal,5781,553244,10148,5711,553593,10155,569459,569173,2021-01-30 20:01:41.827250
Andaman and Nicobar Islands,5,4927,62,4,4928,62,4994,4994,2021-01-31 20:13:39.051023
Andhra Pradesh,1308,879131,7152,1289,879278,7153,887720,887591,2021-01-31 20:13:39.051023
Arunachal Pradesh,13,16758,56,14,16758,56,16828,16827,2021-01-31 20:13:39.051023
Assam,1956,214054,1081,1914,214124,1082,217120,217091,2021-01-31 20:13:39.051023
Bihar,1021,256857,1495,976,257021,1499,259496,259373,2021-01-31 20:13:39.051023
Chandigarh,159,20389,334,151,20414,334,20899,20882,2021-01-31 20:13:39.051023
Chhattisgarh,4358,296642,3689,4260,297144,3698,305102,304689,2021-01-31 20:13:39.051023
Dadra and Nagar Haveli and Daman and Diu,8,3388,2,6,3390,2,3398,3398,2021-01-31 20:13:39.051023
Delhi,1551,622381,10841,1436,622671,10849,634956,634773,2021-01-31 20:13:39.051023
Goa,742,51755,766,759,51831,766,53356,53263,2021-01-31 20:13:39.051023
Gujarat,3589,252927,4385,3469,253368,4387,261224,260901,2021-01-31 20:13:39.051023
Haryana,1192,263501,3015,1134,263654,3017,267805,267708,2021-01-31 20:13:39.051023
Himachal Pradesh,343,56083,974,383,56135,976,57494,57400,2021-01-31 20:13:39.051023
Jammu and Kashmir,823,121617,1933,761,121752,1936,124449,124373,2021-01-31 20:13:39.051023
Jharkhand,628,116904,1070,576,117004,1071,118651,118602,2021-01-31 20:13:39.051023
Karnataka,6080,920110,12211,5995,920657,12213,938865,938401,2021-01-31 20:13:39.051023
Kerala,72482,841444,3704,71714,848476,3722,923912,917630,2021-01-31 20:13:39.051023
Ladakh,68,9517,129,70,9519,130,9719,9714,2021-01-31 20:13:39.051023
Lakshadweep,56,14,0,49,30,0,79,70,2021-01-31 20:13:39.051023
Madhya Pradesh,2826,248036,3805,2760,248319,3807,254886,254667,2021-01-31 20:13:39.051023
Maharashtra,44384,1925800,51000,45437,1927335,51042,2023814,2021184,2021-01-31 20:13:39.051023
Manipur,142,28524,371,136,28545,371,29052,29037,2021-01-31 20:13:39.051023
Meghalaya,83,13524,146,74,13541,146,13761,13753,2021-01-31 20:13:39.051023
Mizoram,39,4318,9,40,4323,9,4372,4366,2021-01-31 20:13:39.051023
Nagaland,53,11947,88,52,11950,88,12090,12088,2021-01-31 20:13:39.051023
Odisha,1120,331824,1906,1090,331962,1906,334958,334850,2021-01-31 20:13:39.051023
Puducherry,295,38062,647,306,38094,647,39047,39004,2021-01-31 20:13:39.051023
Punjab,2114,165145,5601,2184,165291,5609,173084,172860,2021-01-31 20:13:39.051023
Rajasthan,2395,312132,2765,2260,312370,2766,317396,317292,2021-01-31 20:13:39.051023
Sikkim,97,5855,133,94,5861,133,6088,6085,2021-01-31 20:13:39.051023
Tamil Nadu,4601,820381,12345,4575,820907,12350,837832,837327,2021-01-31 20:13:39.051023
Telengana,2354,290354,1598,2240,290630,1599,294469,294306,2021-01-31 20:13:39.051023
Tripura,21,32938,391,21,32939,391,33351,33350,2021-01-31 20:13:39.051023
Uttarakhand,1289,93055,1642,1202,93223,1643,96068,95986,2021-01-31 20:13:39.051023
Uttar Pradesh,5918,585273,8646,5682,585747,8650,600079,599837,2021-01-31 20:13:39.051023
West Bengal,5711,553593,10155,5671,553934,10164,569769,569459,2021-01-31 20:13:39.051023
Andaman and Nicobar Islands,4,4928,62,4,4928,62,4994,4994,2021-02-01 20:10:57.937462
Andhra Pradesh,1289,879278,7153,1278,879405,7153,887836,887720,2021-02-01 20:10:57.937462
Arunachal Pradesh,14,16758,56,13,16759,56,16828,16828,2021-02-01 20:10:57.937462
Assam,1914,214124,1082,1881,214178,1082,217141,217120,2021-02-01 20:10:57.937462
Bihar,976,257021,1499,893,257169,1501,259563,259496,2021-02-01 20:10:57.937462
Chandigarh,151,20414,334,165,20426,334,20925,20899,2021-02-01 20:10:57.937462
Chhattisgarh,4260,297144,3698,4327,297339,3701,305367,305102,2021-02-01 20:10:57.937462
Dadra and Nagar Haveli and Daman and Diu,6,3390,2,6,3390,2,3398,3398,2021-02-01 20:10:57.937462
Delhi,1436,622671,10849,1361,622882,10853,635096,634956,2021-02-01 20:10:57.937462
Goa,759,51831,766,750,51891,768,53409,53356,2021-02-01 20:10:57.937462
Gujarat,3469,253368,4387,3450,253703,4387,261540,261224,2021-02-01 20:10:57.937462
Haryana,1134,263654,3017,1115,263764,3018,267897,267805,2021-02-01 20:10:57.937462
Himachal Pradesh,383,56135,976,390,56167,979,57536,57494,2021-02-01 20:10:57.937462
Jammu and Kashmir,761,121752,1936,748,121822,1936,124506,124449,2021-02-01 20:10:57.937462
Jharkhand,576,117004,1071,553,117067,1072,118692,118651,2021-02-01 20:10:57.937462
Karnataka,5995,920657,12213,6048,921122,12217,939387,938865,2021-02-01 20:10:57.937462
Kerala,71714,848476,3722,71229,854206,3743,929178,923912,2021-02-01 20:10:57.937462
Ladakh,70,9519,130,67,9523,130,9720,9719,2021-02-01 20:10:57.937462
Lakshadweep,49,30,0,38,49,0,87,79,2021-02-01 20:10:57.937462
Madhya Pradesh,2760,248319,3807,2665,248637,3810,255112,254886,2021-02-01 20:10:57.937462
Maharashtra,45437,1927335,51042,46312,1929005,51082,2026399,2023814,2021-02-01 20:10:57.937462
Manipur,136,28545,371,144,28553,371,29068,29052,2021-02-01 20:10:57.937462
Meghalaya,74,13541,146,68,13550,146,13764,13761,2021-02-01 20:10:57.937462
Mizoram,40,4323,9,33,4330,9,4372,4372,2021-02-01 20:10:57.937462
Nagaland,52,11950,88,56,11950,88,12094,12090,2021-02-01 20:10:57.937462
Odisha,1090,331962,1906,1063,332103,1906,335072,334958,2021-02-01 20:10:57.937462
Puducherry,306,38094,647,285,38135,648,39068,39047,2021-02-01 20:10:57.937462
Punjab,2184,165291,5609,2128,165533,5615,173276,173084,2021-02-01 20:10:57.937462
Rajasthan,2260,312370,2766,2161,312564,2766,317491,317396,2021-02-01 20:10:57.937462
Sikkim,94,5861,133,86,5870,134,6090,6088,2021-02-01 20:10:57.937462
Tamil Nadu,4575,820907,12350,4554,821430,12356,838340,837832,2021-02-01 20:10:57.937462
Telengana,2240,290630,1599,2092,290894,1601,294587,294469,2021-02-01 20:10:57.937462
Tripura,21,32939,391,19,32941,391,33351,33351,2021-02-01 20:10:57.937462
Uttarakhand,1202,93223,1643,1175,93310,1644,96129,96068,2021-02-01 20:10:57.937462
Uttar Pradesh,5682,585747,8650,5525,586116,8658,600299,600079,2021-02-01 20:10:57.937462
West Bengal,5671,553934,10164,5553,554272,10173,569998,569769,2021-02-01 20:10:57.937462
Andaman and Nicobar Islands,4,4928,62,0,4932,62,4994,4994,2021-02-02 20:01:51.821360
Andhra Pradesh,1278,879405,7153,1242,879504,7154,887900,887836,2021-02-02 20:01:51.821360
Arunachal Pradesh,13,16759,56,10,16762,56,16828,16828,2021-02-02 20:01:51.821360
Assam,1881,214178,1082,1823,214248,1083,217154,217141,2021-02-02 20:01:51.821360
Bihar,893,257169,1501,851,257306,1503,259660,259563,2021-02-02 20:01:51.821360
Chandigarh,165,20426,334,176,20447,334,20957,20925,2021-02-02 20:01:51.821360
Chhattisgarh,4327,297339,3701,4124,297859,3706,305689,305367,2021-02-02 20:01:51.821360
Dadra and Nagar Haveli and Daman and Diu,6,3390,2,5,3391,2,3398,3398,2021-02-02 20:01:51.821360
Delhi,1361,622882,10853,1265,623096,10856,635217,635096,2021-02-02 20:01:51.821360
Goa,750,51891,768,724,51977,768,53469,53409,2021-02-02 20:01:51.821360
Gujarat,3450,253703,4387,3341,254109,4388,261838,261540,2021-02-02 20:01:51.821360
Haryana,1115,263764,3018,1081,263886,3022,267989,267897,2021-02-02 20:01:51.821360
Himachal Pradesh,390,56167,979,378,56204,979,57561,57536,2021-02-02 20:01:51.821360
Jammu and Kashmir,748,121822,1936,709,121905,1936,124550,124506,2021-02-02 20:01:51.821360
Jharkhand,553,117067,1072,513,117148,1073,118734,118692,2021-02-02 20:01:51.821360
Karnataka,6048,921122,12217,5963,921592,12220,939775,939387,2021-02-02 20:01:51.821360
Kerala,71229,854206,3743,69456,859421,3760,932637,929178,2021-02-02 20:01:51.821360
Ladakh,67,9523,130,68,9526,130,9724,9720,2021-02-02 20:01:51.821360
Lakshadweep,38,49,0,43,56,0,99,87,2021-02-02 20:01:51.821360
Madhya Pradesh,2665,248637,3810,2554,248897,3812,255263,255112,2021-02-02 20:01:51.821360
Maharashtra,46312,1929005,51082,44944,1932294,51109,2028347,2026399,2021-02-02 20:01:51.821360
Manipur,144,28553,371,139,28562,371,29072,29068,2021-02-02 20:01:51.821360
Meghalaya,68,13550,146,62,13556,146,13764,13764,2021-02-02 20:01:51.821360
Mizoram,33,4330,9,31,4333,9,4373,4372,2021-02-02 20:01:51.821360
Nagaland,56,11950,88,54,11957,88,12099,12094,2021-02-02 20:01:51.821360
Odisha,1063,332103,1906,1006,332239,1906,335151,335072,2021-02-02 20:01:51.821360
Puducherry,285,38135,648,285,38160,651,39096,39068,2021-02-02 20:01:51.821360
Punjab,2128,165533,5615,2101,165753,5616,173470,173276,2021-02-02 20:01:51.821360
Rajasthan,2161,312564,2766,1948,312873,2766,317587,317491,2021-02-02 20:01:51.821360
Sikkim,86,5870,134,82,5874,135,6091,6090,2021-02-02 20:01:51.821360
Tamil Nadu,4554,821430,12356,4532,821947,12363,838842,838340,2021-02-02 20:01:51.821360
Telengana,2092,290894,1601,2022,291115,1602,294739,294587,2021-02-02 20:01:51.821360
Tripura,19,32941,391,17,32943,391,33351,33351,2021-02-02 20:01:51.821360
Uttarakhand,1175,93310,1644,1081,93451,1648,96180,96129,2021-02-02 20:01:51.821360
Uttar Pradesh,5525,586116,8658,5303,586505,8662,600470,600299,2021-02-02 20:01:51.821360
West Bengal,5553,554272,10173,5420,554578,10179,570177,569998,2021-02-02 20:01:51.821360
Andaman and Nicobar Islands,0,4932,62,0,4932,62,4994,4994,2021-02-03 20:02:56.701663
Andhra Pradesh,1242,879504,7154,1197,879651,7156,888004,887900,2021-02-03 20:02:56.701663
Arunachal Pradesh,10,16762,56,11,16762,56,16829,16828,2021-02-03 20:02:56.701663
Assam,1823,214248,1083,1793,214285,1083,217161,217154,2021-02-03 20:02:56.701663
Bihar,851,257306,1503,802,257474,1505,259781,259660,2021-02-03 20:02:56.701663
Chandigarh,176,20447,334,182,20462,335,20979,20957,2021-02-03 20:02:56.701663
Chhattisgarh,4124,297859,3706,4173,298135,3711,306019,305689,2021-02-03 20:02:56.701663
Dadra and Nagar Haveli and Daman and Diu,5,3391,2,4,3392,2,3398,3398,2021-02-03 20:02:56.701663
Delhi,1265,623096,10856,1217,623256,10858,635331,635217,2021-02-03 20:02:56.701663
Goa,724,51977,768,768,52039,768,53575,53469,2021-02-03 20:02:56.701663
Gujarat,3341,254109,4388,3203,254531,4389,262123,261838,2021-02-03 20:02:56.701663
Haryana,1081,263886,3022,1055,263989,3023,268067,267989,2021-02-03 20:02:56.701663
Himachal Pradesh,378,56204,979,365,56242,980,57587,57561,2021-02-03 20:02:56.701663
Jammu and Kashmir,709,121905,1936,668,121988,1938,124594,124550,2021-02-03 20:02:56.701663
Jharkhand,513,117148,1073,489,117229,1075,118793,118734,2021-02-03 20:02:56.701663
Karnataka,5963,921592,12220,5943,922004,12223,940170,939775,2021-02-03 20:02:56.701663
Kerala,69456,859421,3760,69409,865168,3776,938353,932637,2021-02-03 20:02:56.701663
Ladakh,68,9526,130,66,9530,130,9726,9724,2021-02-03 20:02:56.701663
Lakshadweep,43,56,0,63,56,0,119,99,2021-02-03 20:02:56.701663
Madhya Pradesh,2554,248897,3812,2423,249193,3815,255431,255263,2021-02-03 20:02:56.701663
Maharashtra,44944,1932294,51109,42830,1936305,51139,2030274,2028347,2021-02-03 20:02:56.701663
Manipur,139,28562,371,138,28568,371,29077,29072,2021-02-03 20:02:56.701663
Meghalaya,62,13556,146,56,13565,147,13768,13764,2021-02-03 20:02:56.701663
Mizoram,31,4333,9,33,4334,9,4376,4373,2021-02-03 20:02:56.701663
Nagaland,54,11957,88,55,11958,88,12101,12099,2021-02-03 20:02:56.701663
Odisha,1006,332239,1906,928,332377,1906,335211,335151,2021-02-03 20:02:56.701663
Puducherry,285,38160,651,286,38186,651,39123,39096,2021-02-03 20:02:56.701663
Punjab,2101,165753,5616,2122,165924,5628,173674,173470,2021-02-03 20:02:56.701663
Rajasthan,1948,312873,2766,1798,313108,2768,317674,317587,2021-02-03 20:02:56.701663
Sikkim,82,5874,135,85,5876,135,6096,6091,2021-02-03 20:02:56.701663
Tamil Nadu,4532,821947,12363,4517,822468,12367,839352,838842,2021-02-03 20:02:56.701663
Telengana,2022,291115,1602,2008,291312,1604,294924,294739,2021-02-03 20:02:56.701663
Tripura,17,32943,391,15,32945,391,33351,33351,2021-02-03 20:02:56.701663
Uttarakhand,1081,93451,1648,1043,93533,1651,96227,96180,2021-02-03 20:02:56.701663
Uttar Pradesh,5303,586505,8662,5007,586967,8668,600642,600470,2021-02-03 20:02:56.701663
West Bengal,5420,554578,10179,5305,554887,10188,570380,570177,2021-02-03 20:02:56.701663
Andaman and Nicobar Islands,0,4932,62,0,4932,62,4994,4994,2021-02-04 21:02:38.167194
Andhra Pradesh,1197,879651,7156,1162,879780,7157,888099,888004,2021-02-04 21:02:38.167194
Arunachal Pradesh,11,16762,56,9,16764,56,16829,16829,2021-02-04 21:02:38.167194
Assam,1793,214285,1083,1748,214344,1083,217175,217161,2021-02-04 21:02:38.167194
Bihar,802,257474,1505,732,257618,1508,259858,259781,2021-02-04 21:02:38.167194
Chandigarh,182,20462,335,186,20493,336,21015,20979,2021-02-04 21:02:38.167194
Chhattisgarh,4173,298135,3711,4315,298337,3718,306370,306019,2021-02-04 21:02:38.167194
Dadra and Nagar Haveli and Daman and Diu,4,3392,2,4,3392,2,3398,3398,2021-02-04 21:02:38.167194
Delhi,1217,623256,10858,1208,623409,10864,635481,635331,2021-02-04 21:02:38.167194
Goa,768,52039,768,761,52109,768,53638,53575,2021-02-04 21:02:38.167194
Gujarat,3203,254531,4389,2956,255059,4391,262406,262123,2021-02-04 21:02:38.167194
Haryana,1055,263989,3023,1019,264093,3024,268136,268067,2021-02-04 21:02:38.167194
Himachal Pradesh,365,56242,980,409,56256,981,57646,57587,2021-02-04 21:02:38.167194
Jammu and Kashmir,668,121988,1938,669,122049,1941,124659,124594,2021-02-04 21:02:38.167194
Jharkhand,489,117229,1075,453,117309,1077,118839,118793,2021-02-04 21:02:38.167194
Karnataka,5943,922004,12223,5934,922437,12225,940596,940170,2021-02-04 21:02:38.167194
Kerala,69409,865168,3776,69365,871548,3796,944709,938353,2021-02-04 21:02:38.167194
Ladakh,66,9530,130,70,9535,130,9735,9726,2021-02-04 21:02:38.167194
Lakshadweep,63,56,0,61,61,0,122,119,2021-02-04 21:02:38.167194
Madhya Pradesh,2423,249193,3815,2430,249443,3816,255689,255431,2021-02-04 21:02:38.167194
Maharashtra,42830,1936305,51139,38762,1943335,51169,2033266,2030274,2021-02-04 21:02:38.167194
Manipur,138,28568,371,111,28603,372,29086,29077,2021-02-04 21:02:38.167194
Meghalaya,56,13565,147,52,13575,147,13774,13768,2021-02-04 21:02:38.167194
Mizoram,33,4334,9,30,4337,9,4376,4376,2021-02-04 21:02:38.167194
Nagaland,55,11958,88,66,11963,88,12117,12101,2021-02-04 21:02:38.167194
Odisha,928,332377,1906,877,332499,1906,335282,335211,2021-02-04 21:02:38.167194
Puducherry,286,38186,651,279,38215,652,39146,39123,2021-02-04 21:02:38.167194
Punjab,2122,165924,5628,2130,166103,5628,173861,173674,2021-02-04 21:02:38.167194
Rajasthan,1798,313108,2768,1692,313304,2770,317766,317674,2021-02-04 21:02:38.167194
Sikkim,85,5876,135,86,5877,135,6098,6096,2021-02-04 21:02:38.167194
Tamil Nadu,4517,822468,12367,4494,823001,12371,839866,839352,2021-02-04 21:02:38.167194
Telengana,2008,291312,1604,1985,291510,1606,295101,294924,2021-02-04 21:02:38.167194
Tripura,15,32945,391,12,32948,391,33351,33351,2021-02-04 21:02:38.167194
Uttarakhand,1043,93533,1651,997,93629,1655,96281,96227,2021-02-04 21:02:38.167194
Uttar Pradesh,5007,586967,8668,4765,587398,8674,600837,600642,2021-02-04 21:02:38.167194
West Bengal,5305,554887,10188,5196,555190,10195,570581,570380,2021-02-04 21:02:38.167194
Andaman and Nicobar Islands,0,4932,62,0,4932,62,4994,4994,2021-02-05 20:31:17.262842
Andhra Pradesh,1162,879780,7157,1154,879867,7157,888178,888099,2021-02-05 20:31:17.262842
Arunachal Pradesh,9,16764,56,8,16765,56,16829,16829,2021-02-05 20:31:17.262842
Assam,1748,214344,1083,1728,214374,1084,217186,217175,2021-02-05 20:31:17.262842
Bihar,732,257618,1508,724,257702,1510,259936,259858,2021-02-05 20:31:17.262842
Chandigarh,186,20493,336,187,20512,337,21036,21015,2021-02-05 20:31:17.262842
Chhattisgarh,4315,298337,3718,4295,298724,3724,306743,306370,2021-02-05 20:31:17.262842
Dadra and Nagar Haveli and Daman and Diu,4,3392,2,4,3392,2,3398,3398,2021-02-05 20:31:17.262842
Delhi,1208,623409,10864,1194,623574,10871,635639,635481,2021-02-05 20:31:17.262842
Goa,761,52109,768,782,52165,770,53717,53638,2021-02-05 20:31:17.262842
Gujarat,2956,255059,4391,2800,255489,4392,262681,262406,2021-02-05 20:31:17.262842
Haryana,1019,264093,3024,962,264221,3026,268209,268136,2021-02-05 20:31:17.262842
Himachal Pradesh,409,56256,981,439,56272,982,57693,57646,2021-02-05 20:31:17.262842
Jammu and Kashmir,669,122049,1941,652,122124,1943,124719,124659,2021-02-05 20:31:17.262842
Jharkhand,453,117309,1077,447,117373,1077,118897,118839,2021-02-05 20:31:17.262842
Karnataka,5934,922437,12225,5936,922907,12227,941070,940596,2021-02-05 20:31:17.262842
Kerala,69365,871548,3796,69109,877889,3813,950811,944709,2021-02-05 20:31:17.262842
Ladakh,70,9535,130,72,9538,130,9740,9735,2021-02-05 20:31:17.262842
Lakshadweep,61,61,0,65,61,0,126,122,2021-02-05 20:31:17.262842
Madhya Pradesh,2430,249443,3816,2331,249706,3818,255855,255689,2021-02-05 20:31:17.262842
Maharashtra,38762,1943335,51169,36113,1948674,51215,2036002,2033266,2021-02-05 20:31:17.262842
Manipur,111,28603,372,113,28614,372,29099,29086,2021-02-05 20:31:17.262842
Meghalaya,52,13575,147,63,13584,147,13794,13774,2021-02-05 20:31:17.262842
Mizoram,30,4337,9,25,4342,9,4376,4376,2021-02-05 20:31:17.262842
Nagaland,66,11963,88,63,11970,88,12121,12117,2021-02-05 20:31:17.262842
Odisha,877,332499,1906,851,332611,1907,335369,335282,2021-02-05 20:31:17.262842
Puducherry,279,38215,652,293,38240,652,39185,39146,2021-02-05 20:31:17.262842
Punjab,2130,166103,5628,2159,166263,5635,174057,173861,2021-02-05 20:31:17.262842
Rajasthan,1692,313304,2770,1638,313496,2771,317905,317766,2021-02-05 20:31:17.262842
Sikkim,86,5877,135,82,5886,135,6103,6098,2021-02-05 20:31:17.262842
Tamil Nadu,4494,823001,12371,4467,823518,12375,840360,839866,2021-02-05 20:31:17.262842
Telengana,1985,291510,1606,1964,291699,1607,295270,295101,2021-02-05 20:31:17.262842
Tripura,12,32948,391,12,32949,391,33352,33351,2021-02-05 20:31:17.262842
Uttarakhand,997,93629,1655,1002,93723,1659,96384,96281,2021-02-05 20:31:17.262842
Uttar Pradesh,4765,587398,8674,4629,587661,8680,600970,600837,2021-02-05 20:31:17.262842
West Bengal,5196,555190,10195,5097,555491,10199,570787,570581,2021-02-05 20:31:17.262842
Andaman and Nicobar Islands,0,4932,62,3,4932,62,4997,4994,2021-02-06 20:00:52.194435
Andhra Pradesh,1154,879867,7157,1071,880046,7158,888275,888178,2021-02-06 20:00:52.194435
Arunachal Pradesh,8,16765,56,8,16765,56,16829,16829,2021-02-06 20:00:52.194435
Assam,1728,214374,1084,1706,214403,1084,217193,217186,2021-02-06 20:00:52.194435
Bihar,724,257702,1510,608,257914,1512,260034,259936,2021-02-06 20:00:52.194435
Chandigarh,187,20512,337,187,20535,338,21060,21036,2021-02-06 20:00:52.194435
Chhattisgarh,4295,298724,3724,4360,298987,3732,307079,306743,2021-02-06 20:00:52.194435
Dadra and Nagar Haveli and Daman and Diu,4,3392,2,2,3394,2,3398,3398,2021-02-06 20:00:52.194435
Delhi,1194,623574,10871,1206,623714,10873,635793,635639,2021-02-06 20:00:52.194435
Goa,782,52165,770,760,52243,770,53773,53717,2021-02-06 20:00:52.194435
Gujarat,2800,255489,4392,2641,255914,4393,262948,262681,2021-02-06 20:00:52.194435
Haryana,962,264221,3026,949,264317,3027,268293,268209,2021-02-06 20:00:52.194435
Himachal Pradesh,439,56272,982,462,56320,982,57764,57693,2021-02-06 20:00:52.194435
Jammu and Kashmir,652,122124,1943,654,122187,1944,124785,124719,2021-02-06 20:00:52.194435
Jharkhand,447,117373,1077,441,117420,1077,118938,118897,2021-02-06 20:00:52.194435
Karnataka,5936,922907,12227,5893,923377,12230,941500,941070,2021-02-06 20:00:52.194435
Kerala,69109,877889,3813,68047,884542,3832,956421,950811,2021-02-06 20:00:52.194435
Ladakh,72,9538,130,72,9541,130,9743,9740,2021-02-06 20:00:52.194435
Lakshadweep,65,61,0,76,65,0,141,126,2021-02-06 20:00:52.194435
Madhya Pradesh,2331,249706,3818,2193,250005,3819,256017,255855,2021-02-06 20:00:52.194435
Maharashtra,36113,1948674,51215,35188,1952187,51255,2038630,2036002,2021-02-06 20:00:52.194435
Manipur,113,28614,372,113,28625,372,29110,29099,2021-02-06 20:00:52.194435
Meghalaya,63,13584,147,81,13593,147,13821,13794,2021-02-06 20:00:52.194435
Mizoram,25,4342,9,27,4345,9,4381,4376,2021-02-06 20:00:52.194435
Nagaland,63,11970,88,68,11970,88,12126,12121,2021-02-06 20:00:52.194435
Odisha,851,332611,1907,825,332733,1908,335466,335369,2021-02-06 20:00:52.194435
Puducherry,293,38240,652,314,38267,654,39235,39185,2021-02-06 20:00:52.194435
Punjab,2159,166263,5635,2144,166477,5635,174256,174057,2021-02-06 20:00:52.194435
Rajasthan,1638,313496,2771,1581,313669,2771,318021,317905,2021-02-06 20:00:52.194435
Sikkim,82,5886,135,77,5893,135,6105,6103,2021-02-06 20:00:52.194435
Tamil Nadu,4467,823518,12375,4446,824024,12379,840849,840360,2021-02-06 20:00:52.194435
Telengana,1964,291699,1607,1977,291846,1608,295431,295270,2021-02-06 20:00:52.194435
Tripura,12,32949,391,11,32950,391,33352,33352,2021-02-06 20:00:52.194435
Uttarakhand,1002,93723,1659,945,93824,1662,96431,96384,2021-02-06 20:00:52.194435
Uttar Pradesh,4629,587661,8680,4462,587984,8682,601128,600970,2021-02-06 20:00:52.194435
West Bengal,5097,555491,10199,4992,555788,10201,570981,570787,2021-02-06 20:00:52.194435
Andaman and Nicobar Islands,3,4932,62,6,4932,62,5000,4997,2021-02-07 20:00:48.566076
Andhra Pradesh,1071,880046,7158,1012,880179,7159,888350,888275,2021-02-07 20:00:48.566076
Arunachal Pradesh,8,16765,56,7,16767,56,16830,16829,2021-02-07 20:00:48.566076
Assam,1706,214403,1084,1695,214423,1084,217202,217193,2021-02-07 20:00:48.566076
Bihar,608,257914,1512,609,257971,1515,260095,260034,2021-02-07 20:00:48.566076
Chandigarh,187,20535,338,184,20565,339,21088,21060,2021-02-07 20:00:48.566076
Chhattisgarh,4360,298987,3732,4320,299284,3735,307339,307079,2021-02-07 20:00:48.566076
Dadra and Nagar Haveli and Daman and Diu,2,3394,2,1,3395,2,3398,3398,2021-02-07 20:00:48.566076
Delhi,1206,623714,10873,1174,623865,10877,635916,635793,2021-02-07 20:00:48.566076
Goa,760,52243,770,769,52299,770,53838,53773,2021-02-07 20:00:48.566076
Gujarat,2641,255914,4393,2491,256315,4394,263200,262948,2021-02-07 20:00:48.566076
Haryana,949,264317,3027,908,264429,3027,268364,268293,2021-02-07 20:00:48.566076
Himachal Pradesh,462,56320,982,497,56371,983,57851,57764,2021-02-07 20:00:48.566076
Jammu and Kashmir,654,122187,1944,631,122275,1944,124850,124785,2021-02-07 20:00:48.566076
Jharkhand,441,117420,1077,428,117474,1077,118979,118938,2021-02-07 20:00:48.566076
Karnataka,5893,923377,12230,5987,923811,12233,942031,941500,2021-02-07 20:00:48.566076
Kerala,68047,884542,3832,67795,890720,3848,962363,956421,2021-02-07 20:00:48.566076
Ladakh,72,9541,130,72,9542,130,9744,9743,2021-02-07 20:00:48.566076
Lakshadweep,76,65,0,86,65,0,151,141,2021-02-07 20:00:48.566076
Madhya Pradesh,2193,250005,3819,2074,250320,3820,256214,256017,2021-02-07 20:00:48.566076
Maharashtra,35188,1952187,51255,36192,1953926,51280,2041398,2038630,2021-02-07 20:00:48.566076
Manipur,113,28625,372,109,28636,372,29117,29110,2021-02-07 20:00:48.566076
Meghalaya,81,13593,147,102,13596,147,13845,13821,2021-02-07 20:00:48.566076
Mizoram,27,4345,9,23,4350,9,4382,4381,2021-02-07 20:00:48.566076
Nagaland,68,11970,88,85,11975,88,12148,12126,2021-02-07 20:00:48.566076
Odisha,825,332733,1908,797,332842,1909,335548,335466,2021-02-07 20:00:48.566076
Puducherry,314,38267,654,317,38299,654,39270,39235,2021-02-07 20:00:48.566076
Punjab,2144,166477,5635,2156,166643,5640,174439,174256,2021-02-07 20:00:48.566076
Rajasthan,1581,313669,2771,1527,313819,2772,318118,318021,2021-02-07 20:00:48.566076
Sikkim,77,5893,135,75,5898,135,6108,6105,2021-02-07 20:00:48.566076
Tamil Nadu,4446,824024,12379,4417,824527,12382,841326,840849,2021-02-07 20:00:48.566076
Telengana,1977,291846,1608,1939,292032,1610,295581,295431,2021-02-07 20:00:48.566076
Tripura,11,32950,391,11,32950,391,33352,33352,2021-02-07 20:00:48.566076
Uttarakhand,945,93824,1662,937,93877,1664,96478,96431,2021-02-07 20:00:48.566076
Uttar Pradesh,4462,587984,8682,4438,588148,8686,601272,601128,2021-02-07 20:00:48.566076
West Bengal,4992,555788,10201,4895,556081,10202,571178,570981,2021-02-07 20:00:48.566076
Andaman and Nicobar Islands,6,4932,62,7,4932,62,5001,5000,2021-02-08 20:00:27.387007
Andhra Pradesh,1012,880179,7159,1003,880261,7159,888423,888350,2021-02-08 20:00:27.387007
Arunachal Pradesh,7,16767,56,7,16767,56,16830,16830,2021-02-08 20:00:27.387007
Assam,1695,214423,1084,1679,214447,1084,217210,217202,2021-02-08 20:00:27.387007
Bihar,609,257971,1515,533,258221,1516,260270,260095,2021-02-08 20:00:27.387007
Chandigarh,184,20565,339,169,20598,340,21107,21088,2021-02-08 20:00:27.387007
Chhattisgarh,4320,299284,3735,4290,299494,3741,307525,307339,2021-02-08 20:00:27.387007
Dadra and Nagar Haveli and Daman and Diu,1,3395,2,1,3395,2,3398,3398,2021-02-08 20:00:27.387007
Delhi,1174,623865,10877,1112,624044,10879,636035,635916,2021-02-08 20:00:27.387007
Goa,769,52299,770,761,52347,772,53880,53838,2021-02-08 20:00:27.387007
Gujarat,2491,256315,4394,2379,256670,4395,263444,263200,2021-02-08 20:00:27.387007
Haryana,908,264429,3027,883,264519,3029,268431,268364,2021-02-08 20:00:27.387007
Himachal Pradesh,497,56371,983,464,56448,984,57896,57851,2021-02-08 20:00:27.387007
Jammu and Kashmir,631,122275,1944,630,122335,1944,124909,124850,2021-02-08 20:00:27.387007
Jharkhand,428,117474,1077,431,117508,1078,119017,118979,2021-02-08 20:00:27.387007
Karnataka,5987,923811,12233,5978,924304,12236,942518,942031,2021-02-08 20:00:27.387007
Kerala,67795,890720,3848,67903,896668,3867,968438,962363,2021-02-08 20:00:27.387007
Ladakh,72,9542,130,72,9545,130,9747,9744,2021-02-08 20:00:27.387007
Lakshadweep,86,65,0,88,65,0,153,151,2021-02-08 20:00:27.387007
Madhya Pradesh,2074,250320,3820,2041,250537,3820,256398,256214,2021-02-08 20:00:27.387007
Maharashtra,36192,1953926,51280,37213,1955548,51310,2044071,2041398,2021-02-08 20:00:27.387007
Manipur,109,28636,372,99,28654,373,29126,29117,2021-02-08 20:00:27.387007
Meghalaya,102,13596,147,137,13601,147,13885,13845,2021-02-08 20:00:27.387007
Mizoram,23,4350,9,24,4350,9,4383,4382,2021-02-08 20:00:27.387007
Nagaland,85,11975,88,95,11975,88,12158,12148,2021-02-08 20:00:27.387007
Odisha,797,332842,1909,763,332948,1909,335620,335548,2021-02-08 20:00:27.387007
Puducherry,317,38299,654,312,38326,654,39292,39270,2021-02-08 20:00:27.387007
Punjab,2156,166643,5640,2176,166828,5642,174646,174439,2021-02-08 20:00:27.387007
Rajasthan,1527,313819,2772,1464,313957,2772,318193,318118,2021-02-08 20:00:27.387007
Sikkim,75,5898,135,70,5905,135,6110,6108,2021-02-08 20:00:27.387007
Tamil Nadu,4417,824527,12382,4389,825025,12383,841797,841326,2021-02-08 20:00:27.387007
Telengana,1939,292032,1610,1842,292229,1611,295682,295581,2021-02-08 20:00:27.387007
Tripura,11,32950,391,8,32953,391,33352,33352,2021-02-08 20:00:27.387007
Uttarakhand,937,93877,1664,912,93913,1668,96493,96478,2021-02-08 20:00:27.387007
Uttar Pradesh,4438,588148,8686,3880,588818,8687,601385,601272,2021-02-08 20:00:27.387007
West Bengal,4895,556081,10202,4794,556370,10207,571371,571178,2021-02-08 20:00:27.387007
Andaman and Nicobar Islands,7,4932,62,11,4932,62,5005,5001,2021-02-09 20:01:48.884774
Andhra Pradesh,1003,880261,7159,962,880363,7160,888485,888423,2021-02-09 20:01:48.884774
Arunachal Pradesh,7,16767,56,5,16770,56,16831,16830,2021-02-09 20:01:48.884774
Assam,1679,214447,1084,1671,214473,1085,217229,217210,2021-02-09 20:01:48.884774
Bihar,533,258221,1516,382,258771,1517,260670,260270,2021-02-09 20:01:48.884774
Chandigarh,169,20598,340,169,20623,341,21133,21107,2021-02-09 20:01:48.884774
Chhattisgarh,4290,299494,3741,4190,299856,3744,307790,307525,2021-02-09 20:01:48.884774
Dadra and Nagar Haveli and Daman and Diu,1,3395,2,0,3396,2,3398,3398,2021-02-09 20:01:48.884774
Delhi,1112,624044,10879,1096,624182,10882,636160,636035,2021-02-09 20:01:48.884774
Goa,761,52347,772,733,52432,772,53937,53880,2021-02-09 20:01:48.884774
Gujarat,2379,256670,4395,2160,257120,4396,263676,263444,2021-02-09 20:01:48.884774
Haryana,883,264519,3029,870,264608,3029,268507,268431,2021-02-09 20:01:48.884774
Himachal Pradesh,464,56448,984,458,56483,984,57925,57896,2021-02-09 20:01:48.884774
Jammu and Kashmir,630,122335,1944,593,122415,1944,124952,124909,2021-02-09 20:01:48.884774
Jharkhand,431,117508,1078,438,117539,1078,119055,119017,2021-02-09 20:01:48.884774
Karnataka,5978,924304,12236,5953,924654,12239,942846,942518,2021-02-09 20:01:48.884774
Kerala,67903,896668,3867,65670,902627,3883,972180,968438,2021-02-09 20:01:48.884774
Ladakh,72,9545,130,71,9552,130,9753,9747,2021-02-09 20:01:48.884774
Lakshadweep,88,65,0,78,76,0,154,153,2021-02-09 20:01:48.884774
Madhya Pradesh,2041,250537,3820,2041,250727,3823,256591,256398,2021-02-09 20:01:48.884774
Maharashtra,37213,1955548,51310,35991,1958971,51325,2046287,2044071,2021-02-09 20:01:48.884774
Manipur,99,28654,373,85,28672,373,29130,29126,2021-02-09 20:01:48.884774
Meghalaya,137,13601,147,134,13604,148,13886,13885,2021-02-09 20:01:48.884774
Mizoram,24,4350,9,24,4353,9,4386,4383,2021-02-09 20:01:48.884774
Nagaland,95,11975,88,84,11988,88,12160,12158,2021-02-09 20:01:48.884774
Odisha,763,332948,1909,751,333031,1910,335692,335620,2021-02-09 20:01:48.884774
Puducherry,312,38326,654,309,38354,655,39318,39292,2021-02-09 20:01:48.884774
Punjab,2176,166828,5642,2112,167073,5653,174838,174646,2021-02-09 20:01:48.884774
Rajasthan,1464,313957,2772,1470,314050,2774,318294,318193,2021-02-09 20:01:48.884774
Sikkim,70,5905,135,67,5908,135,6110,6110,2021-02-09 20:01:48.884774
Tamil Nadu,4389,825025,12383,4354,825520,12387,842261,841797,2021-02-09 20:01:48.884774
Telengana,1842,292229,1611,1804,292415,1612,295831,295682,2021-02-09 20:01:48.884774
Tripura,8,32953,391,7,32955,391,33353,33352,2021-02-09 20:01:48.884774
Uttarakhand,912,93913,1668,808,94057,1671,96536,96493,2021-02-09 20:01:48.884774
Uttar Pradesh,3880,588818,8687,3442,589322,8691,601455,601385,2021-02-09 20:01:48.884774
West Bengal,4794,556370,10207,4632,556649,10209,571490,571371,2021-02-09 20:01:48.884774
Andaman and Nicobar Islands,11,4932,62,13,4932,62,5007,5005,2021-02-10 20:06:57.606528
Andhra Pradesh,962,880363,7160,917,880478,7160,888555,888485,2021-02-10 20:06:57.606528
Arunachal Pradesh,5,16770,56,4,16771,56,16831,16831,2021-02-10 20:06:57.606528
Assam,1671,214473,1085,1680,214490,1086,217256,217229,2021-02-10 20:06:57.606528
Bihar,382,258771,1517,500,259074,1518,261092,260670,2021-02-10 20:06:57.606528
Chandigarh,169,20623,341,168,20644,342,21154,21133,2021-02-10 20:06:57.606528
Chhattisgarh,4190,299856,3744,4172,300078,3746,307996,307790,2021-02-10 20:06:57.606528
Dadra and Nagar Haveli and Daman and Diu,0,3396,2,0,3396,2,3398,3398,2021-02-10 20:06:57.606528
Delhi,1096,624182,10882,1052,624326,10882,636260,636160,2021-02-10 20:06:57.606528
Goa,733,52432,772,692,52530,774,53996,53937,2021-02-10 20:06:57.606528
Gujarat,2160,257120,4396,2040,257473,4397,263910,263676,2021-02-10 20:06:57.606528
Haryana,870,264608,3029,854,264713,3033,268600,268507,2021-02-10 20:06:57.606528
Himachal Pradesh,458,56483,984,455,56551,987,57993,57925,2021-02-10 20:06:57.606528
Jammu and Kashmir,593,122415,1944,593,122470,1944,125007,124952,2021-02-10 20:06:57.606528
Jharkhand,438,117539,1078,464,117574,1078,119116,119055,2021-02-10 20:06:57.606528
Karnataka,5953,924654,12239,5804,925167,12241,943212,942846,2021-02-10 20:06:57.606528
Kerala,65670,902627,3883,64390,909102,3902,977394,972180,2021-02-10 20:06:57.606528
Ladakh,71,9552,130,59,9569,130,9758,9753,2021-02-10 20:06:57.606528
Lakshadweep,78,76,0,73,93,0,166,154,2021-02-10 20:06:57.606528
Madhya Pradesh,2041,250727,3823,1987,250946,3825,256758,256591,2021-02-10 20:06:57.606528
Maharashtra,35991,1958971,51325,35917,1961525,51360,2048802,2046287,2021-02-10 20:06:57.606528
Manipur,85,28672,373,77,28687,373,29137,29130,2021-02-10 20:06:57.606528
Meghalaya,134,13604,148,137,13608,148,13893,13886,2021-02-10 20:06:57.606528
Mizoram,24,4353,9,21,4358,9,4388,4386,2021-02-10 20:06:57.606528
Nagaland,84,11988,88,88,11990,88,12166,12160,2021-02-10 20:06:57.606528
Odisha,751,333031,1910,748,333139,1910,335797,335692,2021-02-10 20:06:57.606528
Puducherry,309,38354,655,307,38391,655,39353,39318,2021-02-10 20:06:57.606528
Punjab,2112,167073,5653,2077,167285,5661,175023,174838,2021-02-10 20:06:57.606528
Rajasthan,1470,314050,2774,1435,314175,2774,318384,318294,2021-02-10 20:06:57.606528
Sikkim,67,5908,135,63,5912,135,6110,6110,2021-02-10 20:06:57.606528
Tamil Nadu,4354,825520,12387,4328,826011,12391,842730,842261,2021-02-10 20:06:57.606528
Telengana,1804,292415,1612,1797,292578,1613,295988,295831,2021-02-10 20:06:57.606528
Tripura,7,32955,391,7,32955,391,33353,33353,2021-02-10 20:06:57.606528
Uttarakhand,808,94057,1671,790,94127,1673,96590,96536,2021-02-10 20:06:57.606528
Uttar Pradesh,3442,589322,8691,3306,589565,8691,601562,601455,2021-02-10 20:06:57.606528
West Bengal,4632,556649,10209,4496,556925,10215,571636,571490,2021-02-10 20:06:57.606528
Andaman and Nicobar Islands,13,4932,62,13,4932,62,5007,5007,2021-02-11 20:17:13.509126
Andhra Pradesh,917,880478,7160,845,880599,7161,888605,888555,2021-02-11 20:17:13.509126
Arunachal Pradesh,4,16771,56,4,16771,56,16831,16831,2021-02-11 20:17:13.509126
Assam,1680,214490,1086,1674,214507,1086,217267,217256,2021-02-11 20:17:13.509126
Bihar,500,259074,1518,757,259234,1520,261511,261092,2021-02-11 20:17:13.509126
Chandigarh,168,20644,342,158,20670,343,21171,21154,2021-02-11 20:17:13.509126
Chhattisgarh,4172,300078,3746,4073,300390,3755,308218,307996,2021-02-11 20:17:13.509126
Dadra and Nagar Haveli and Daman and Diu,0,3396,2,0,3396,2,3398,3398,2021-02-11 20:17:13.509126
Delhi,1052,624326,10882,1177,624326,10884,636387,636260,2021-02-11 20:17:13.509126
Goa,692,52530,774,698,52594,776,54068,53996,2021-02-11 20:17:13.509126
Gujarat,2040,257473,4397,1800,257968,4397,264165,263910,2021-02-11 20:17:13.509126
Haryana,854,264713,3033,824,264820,3033,268677,268600,2021-02-11 20:17:13.509126
Himachal Pradesh,455,56551,987,488,56600,988,58076,57993,2021-02-11 20:17:13.509126
Jammu and Kashmir,593,122470,1944,605,122502,1945,125052,125007,2021-02-11 20:17:13.509126
Jharkhand,464,117574,1078,464,117616,1081,119161,119116,2021-02-11 20:17:13.509126
Karnataka,5804,925167,12241,5894,925489,12244,943627,943212,2021-02-11 20:17:13.509126
Kerala,64390,909102,3902,64607,914847,3920,983374,977394,2021-02-11 20:17:13.509126
Ladakh,59,9569,130,60,9572,130,9762,9758,2021-02-11 20:17:13.509126
Lakshadweep,73,93,0,63,118,0,181,166,2021-02-11 20:17:13.509126
Madhya Pradesh,1987,250946,3825,1951,251121,3827,256899,256758,2021-02-11 20:17:13.509126
Maharashtra,35917,1961525,51360,36917,1963946,51390,2052253,2048802,2021-02-11 20:17:13.509126
Manipur,77,28687,373,49,28726,373,29148,29137,2021-02-11 20:17:13.509126
Meghalaya,137,13608,148,164,13612,148,13924,13893,2021-02-11 20:17:13.509126
Mizoram,21,4358,9,22,4359,9,4390,4388,2021-02-11 20:17:13.509126
Nagaland,88,11990,88,87,11993,88,12168,12166,2021-02-11 20:17:13.509126
Odisha,748,333139,1910,759,333220,1910,335889,335797,2021-02-11 20:17:13.509126
Puducherry,307,38391,655,293,38423,656,39372,39353,2021-02-11 20:17:13.509126
Punjab,2077,167285,5661,2112,167465,5675,175252,175023,2021-02-11 20:17:13.509126
Rajasthan,1435,314175,2774,1450,314264,2777,318491,318384,2021-02-11 20:17:13.509126
Sikkim,63,5912,135,60,5916,135,6111,6110,2021-02-11 20:17:13.509126
Tamil Nadu,4328,826011,12391,4309,826504,12396,843209,842730,2021-02-11 20:17:13.509126
Telengana,1797,292578,1613,1825,292696,1613,296134,295988,2021-02-11 20:17:13.509126
Tripura,7,32955,391,5,32957,391,33353,33353,2021-02-11 20:17:13.509126
Uttarakhand,790,94127,1673,712,94240,1673,96625,96590,2021-02-11 20:17:13.509126
Uttar Pradesh,3306,589565,8691,3256,589771,8696,601723,601562,2021-02-11 20:17:13.509126
West Bengal,4496,556925,10215,4387,557208,10220,571815,571636,2021-02-11 20:17:13.509126
Andaman and Nicobar Islands,13,4932,62,13,4932,62,5007,5007,2021-02-12 20:00:19.060194
Andhra Pradesh,845,880599,7161,853,880678,7161,888692,888605,2021-02-12 20:00:19.060194
Arunachal Pradesh,4,16771,56,5,16771,56,16832,16831,2021-02-12 20:00:19.060194
Assam,1674,214507,1086,1661,214530,1086,217277,217267,2021-02-12 20:00:19.060194
Bihar,757,259234,1520,700,259347,1521,261568,261511,2021-02-12 20:00:19.060194
Chandigarh,158,20670,343,140,20700,344,21184,21171,2021-02-12 20:00:19.060194
Chhattisgarh,4073,300390,3755,3475,301238,3759,308472,308218,2021-02-12 20:00:19.060194
Dadra and Nagar Haveli and Daman and Diu,0,3396,2,0,3396,2,3398,3398,2021-02-12 20:00:19.060194
Delhi,1177,624326,10884,1051,624592,10886,636529,636387,2021-02-12 20:00:19.060194
Goa,698,52594,776,684,52653,776,54113,54068,2021-02-12 20:00:19.060194
Gujarat,1800,257968,4397,1781,258270,4399,264450,264165,2021-02-12 20:00:19.060194
Haryana,824,264820,3033,848,264901,3034,268783,268677,2021-02-12 20:00:19.060194
Himachal Pradesh,488,56600,988,493,56630,989,58112,58076,2021-02-12 20:00:19.060194
Jammu and Kashmir,605,122502,1945,628,122542,1947,125117,125052,2021-02-12 20:00:19.060194
Jharkhand,464,117616,1081,456,117669,1081,119206,119161,2021-02-12 20:00:19.060194
Karnataka,5894,925489,12244,5977,925829,12251,944057,943627,2021-02-12 20:00:19.060194
Kerala,64607,914847,3920,64180,920539,3936,988655,983374,2021-02-12 20:00:19.060194
Ladakh,60,9572,130,52,9580,130,9762,9762,2021-02-12 20:00:19.060194
Lakshadweep,63,118,0,68,119,0,187,181,2021-02-12 20:00:19.060194
Madhya Pradesh,1951,251121,3827,1920,251320,3828,257068,256899,2021-02-12 20:00:19.060194
Maharashtra,36917,1963946,51390,31437,1970053,51415,2052905,2052253,2021-02-12 20:00:19.060194
Manipur,49,28726,373,53,28729,373,29155,29148,2021-02-12 20:00:19.060194
Meghalaya,164,13612,148,166,13617,148,13931,13924,2021-02-12 20:00:19.060194
Mizoram,22,4359,9,21,4361,9,4391,4390,2021-02-12 20:00:19.060194
Nagaland,87,11993,88,89,11998,88,12175,12168,2021-02-12 20:00:19.060194
Odisha,759,333220,1910,794,333280,1910,335984,335889,2021-02-12 20:00:19.060194
Puducherry,293,38423,656,296,38445,656,39397,39372,2021-02-12 20:00:19.060194
Punjab,2112,167465,5675,2224,167652,5682,175558,175252,2021-02-12 20:00:19.060194
Rajasthan,1450,314264,2777,1385,314438,2779,318602,318491,2021-02-12 20:00:19.060194
Sikkim,60,5916,135,62,5916,135,6113,6111,2021-02-12 20:00:19.060194
Tamil Nadu,4309,826504,12396,4294,826994,12402,843690,843209,2021-02-12 20:00:19.060194
Telengana,1825,292696,1613,1815,292848,1614,296277,296134,2021-02-12 20:00:19.060194
Tripura,5,32957,391,3,32959,391,33353,33353,2021-02-12 20:00:19.060194
Uttarakhand,712,94240,1673,669,94328,1676,96673,96625,2021-02-12 20:00:19.060194
Uttar Pradesh,3256,589771,8696,3320,589882,8696,601898,601723,2021-02-12 20:00:19.060194
West Bengal,4387,557208,10220,4313,557494,10225,572032,571815,2021-02-12 20:00:19.060194
Andaman and Nicobar Islands,13,4932,62,11,4934,62,5007,5007,2021-02-13 23:18:58.579310
Andhra Pradesh,853,880678,7161,814,880784,7162,888760,888692,2021-02-13 23:18:58.579310
Arunachal Pradesh,5,16771,56,5,16771,56,16832,16832,2021-02-13 23:18:58.579310
Assam,1661,214530,1086,1657,214542,1086,217285,217277,2021-02-13 23:18:58.579310
Bihar,700,259347,1521,691,259433,1522,261646,261568,2021-02-13 23:18:58.579310
Chandigarh,140,20700,344,142,20717,344,21203,21184,2021-02-13 23:18:58.579310
Chhattisgarh,3475,301238,3759,3287,301648,3766,308701,308472,2021-02-13 23:18:58.579310
Dadra and Nagar Haveli and Daman and Diu,0,3396,2,0,3396,2,3398,3398,2021-02-13 23:18:58.579310
Delhi,1051,624592,10886,1053,624728,10889,636670,636529,2021-02-13 23:18:58.579310
Goa,684,52653,776,595,52780,777,54152,54113,2021-02-13 23:18:58.579310
Gujarat,1781,258270,4399,1767,258551,4400,264718,264450,2021-02-13 23:18:58.579310
Haryana,848,264901,3034,837,265015,3035,268887,268783,2021-02-13 23:18:58.579310
Himachal Pradesh,493,56630,989,505,56647,990,58142,58112,2021-02-13 23:18:58.579310
Jammu and Kashmir,628,122542,1947,634,122626,1948,125208,125117,2021-02-13 23:18:58.579310
Jharkhand,456,117669,1081,441,117720,1081,119242,119206,2021-02-13 23:18:58.579310
Karnataka,5977,925829,12251,5944,926234,12259,944437,944057,2021-02-13 23:18:58.579310
Kerala,64180,920539,3936,64227,925871,3954,994052,988655,2021-02-13 23:18:58.579310
Ladakh,52,9580,130,50,9583,130,9763,9762,2021-02-13 23:18:58.579310
Lakshadweep,68,119,0,69,119,0,188,187,2021-02-13 23:18:58.579310
Madhya Pradesh,1920,251320,3828,1862,251538,3829,257229,257068,2021-02-13 23:18:58.579310
Maharashtra,31437,1970053,51415,32649,1972475,51451,2056575,2052905,2021-02-13 23:18:58.579310
Manipur,53,28729,373,56,28737,373,29166,29155,2021-02-13 23:18:58.579310
Meghalaya,166,13617,148,164,13620,148,13932,13931,2021-02-13 23:18:58.579310
Mizoram,21,4361,9,20,4363,9,4392,4391,2021-02-13 23:18:58.579310
Nagaland,89,11998,88,77,12011,88,12176,12175,2021-02-13 23:18:58.579310
Odisha,794,333280,1910,781,333351,1910,336042,335984,2021-02-13 23:18:58.579310
Puducherry,296,38445,656,284,38476,656,39416,39397,2021-02-13 23:18:58.579310
Punjab,2224,167652,5682,2300,167814,5690,175804,175558,2021-02-13 23:18:58.579310
Rajasthan,1385,314438,2779,1407,314523,2780,318710,318602,2021-02-13 23:18:58.579310
Sikkim,62,5916,135,61,5920,135,6116,6113,2021-02-13 23:18:58.579310
Tamil Nadu,4294,826994,12402,4285,827480,12408,844173,843690,2021-02-13 23:18:58.579310
Telengana,1815,292848,1614,1781,293033,1614,296428,296277,2021-02-13 23:18:58.579310
Tripura,3,32959,391,2,32960,391,33353,33353,2021-02-13 23:18:58.579310
Uttarakhand,669,94328,1676,648,94396,1678,96722,96673,2021-02-13 23:18:58.579310
Uttar Pradesh,3320,589882,8696,3232,590071,8698,602001,601898,2021-02-13 23:18:58.579310
West Bengal,4313,557494,10225,4233,557758,10229,572220,572032,2021-02-13 23:18:58.579310
Andaman and Nicobar Islands,11,4934,62,9,4938,62,5009,5007,2021-02-14 21:36:32.243539
Andhra Pradesh,814,880784,7162,797,880855,7162,888814,888760,2021-02-14 21:36:32.243539
Arunachal Pradesh,5,16771,56,4,16772,56,16832,16832,2021-02-14 21:36:32.243539
Assam,1657,214542,1086,1631,214570,1087,217288,217285,2021-02-14 21:36:32.243539
Bihar,691,259433,1522,653,259513,1524,261690,261646,2021-02-14 21:36:32.243539
Chandigarh,142,20717,344,123,20752,345,21220,21203,2021-02-14 21:36:32.243539
Chhattisgarh,3287,301648,3766,3255,301904,3771,308930,308701,2021-02-14 21:36:32.243539
Dadra and Nagar Haveli and Daman and Diu,0,3396,2,2,3396,2,3400,3398,2021-02-14 21:36:32.243539
Delhi,1053,624728,10889,1041,624866,10889,636796,636670,2021-02-14 21:36:32.243539
Goa,595,52780,777,584,52831,778,54193,54152,2021-02-14 21:36:32.243539
Gujarat,1767,258551,4400,1763,258834,4400,264997,264718,2021-02-14 21:36:32.243539
Haryana,837,265015,3035,845,265085,3039,268969,268887,2021-02-14 21:36:32.243539
Himachal Pradesh,505,56647,990,524,56685,992,58201,58142,2021-02-14 21:36:32.243539
Jammu and Kashmir,634,122626,1948,616,122703,1949,125268,125208,2021-02-14 21:36:32.243539
Jharkhand,441,117720,1081,452,117749,1082,119283,119242,2021-02-14 21:36:32.243539
Karnataka,5944,926234,12259,5929,926664,12263,944856,944437,2021-02-14 21:36:32.243539
Kerala,64227,925871,3954,63847,931706,3970,999523,994052,2021-02-14 21:36:32.243539
Ladakh,50,9583,130,49,9586,130,9765,9763,2021-02-14 21:36:32.243539
Lakshadweep,69,119,0,90,134,0,224,188,2021-02-14 21:36:32.243539
Madhya Pradesh,1862,251538,3829,1829,251765,3829,257423,257229,2021-02-14 21:36:32.243539
Maharashtra,32649,1972475,51451,34449,1974248,51489,2060186,2056575,2021-02-14 21:36:32.243539
Manipur,56,28737,373,66,28744,373,29183,29166,2021-02-14 21:36:32.243539
Meghalaya,164,13620,148,166,13623,148,13937,13932,2021-02-14 21:36:32.243539
Mizoram,20,4363,9,20,4363,9,4392,4392,2021-02-14 21:36:32.243539
Nagaland,77,12011,88,76,12019,88,12183,12176,2021-02-14 21:36:32.243539
Odisha,781,333351,1910,740,333451,1910,336101,336042,2021-02-14 21:36:32.243539
Puducherry,284,38476,656,284,38500,656,39440,39416,2021-02-14 21:36:32.243539
Punjab,2300,167814,5690,2335,168035,5694,176064,175804,2021-02-14 21:36:32.243539
Rajasthan,1407,314523,2780,1409,314630,2781,318820,318710,2021-02-14 21:36:32.243539
Sikkim,61,5920,135,59,5922,135,6116,6116,2021-02-14 21:36:32.243539
Tamil Nadu,4285,827480,12408,4275,827962,12413,844650,844173,2021-02-14 21:36:32.243539
Telengana,1781,293033,1614,1748,293210,1616,296574,296428,2021-02-14 21:36:32.243539
Tripura,2,32960,391,2,32960,391,33353,33353,2021-02-14 21:36:32.243539
Uttarakhand,648,94396,1678,637,94449,1680,96766,96722,2021-02-14 21:36:32.243539
Uttar Pradesh,3232,590071,8698,3098,590292,8699,602089,602001,2021-02-14 21:36:32.243539
West Bengal,4233,557758,10229,4160,558015,10230,572405,572220,2021-02-14 21:36:32.243539
Andaman and Nicobar Islands,9,4938,62,9,4938,62,5009,5009,2021-02-15 20:00:23.058329
Andhra Pradesh,797,880855,7162,735,880972,7162,888869,888814,2021-02-15 20:00:23.058329
Arunachal Pradesh,4,16772,56,3,16773,56,16832,16832,2021-02-15 20:00:23.058329
Assam,1631,214570,1087,1621,214585,1087,217293,217288,2021-02-15 20:00:23.058329
Bihar,653,259513,1524,625,259591,1525,261741,261690,2021-02-15 20:00:23.058329
Chandigarh,123,20752,345,127,20765,346,21238,21220,2021-02-15 20:00:23.058329
Chhattisgarh,3255,301904,3771,3258,302069,3772,309099,308930,2021-02-15 20:00:23.058329
Dadra and Nagar Haveli and Daman and Diu,2,3396,2,2,3396,2,3400,3400,2021-02-15 20:00:23.058329
Delhi,1041,624866,10889,1031,625024,10891,636946,636796,2021-02-15 20:00:23.058329
Goa,584,52831,778,546,52910,779,54235,54193,2021-02-15 20:00:23.058329
Gujarat,1763,258834,4400,1739,259104,4401,265244,264997,2021-02-15 20:00:23.058329
Haryana,845,265085,3039,852,265155,3039,269046,268969,2021-02-15 20:00:23.058329
Himachal Pradesh,524,56685,992,411,56817,994,58222,58201,2021-02-15 20:00:23.058329
Jammu and Kashmir,616,122703,1949,622,122768,1951,125341,125268,2021-02-15 20:00:23.058329
Jharkhand,452,117749,1082,461,117773,1082,119316,119283,2021-02-15 20:00:23.058329
Karnataka,5929,926664,12263,5855,927150,12265,945270,944856,2021-02-15 20:00:23.058329
Kerala,63847,931706,3970,63752,936398,3985,1004135,999523,2021-02-15 20:00:23.058329
Ladakh,49,9586,130,45,9592,130,9767,9765,2021-02-15 20:00:23.058329
Lakshadweep,90,134,0,97,136,0,233,224,2021-02-15 20:00:23.058329
Madhya Pradesh,1829,251765,3829,1842,251970,3834,257646,257423,2021-02-15 20:00:23.058329
Maharashtra,34449,1974248,51489,37146,1975603,51529,2064278,2060186,2021-02-15 20:00:23.058329
Manipur,66,28744,373,75,28748,373,29196,29183,2021-02-15 20:00:23.058329
Meghalaya,166,13623,148,149,13645,148,13942,13937,2021-02-15 20:00:23.058329
Mizoram,20,4363,9,17,4366,9,4392,4392,2021-02-15 20:00:23.058329
Nagaland,76,12019,88,73,12028,88,12189,12183,2021-02-15 20:00:23.058329
Odisha,740,333451,1910,710,333554,1910,336174,336101,2021-02-15 20:00:23.058329
Puducherry,284,38500,656,258,38533,657,39448,39440,2021-02-15 20:00:23.058329
Punjab,2335,168035,5694,2360,168239,5697,176296,176064,2021-02-15 20:00:23.058329
Rajasthan,1409,314630,2781,1409,314733,2781,318923,318820,2021-02-15 20:00:23.058329
Sikkim,59,5922,135,56,5927,135,6118,6116,2021-02-15 20:00:23.058329
Tamil Nadu,4275,827962,12413,4260,828441,12419,845120,844650,2021-02-15 20:00:23.058329
Telengana,1748,293210,1616,1676,293379,1618,296673,296574,2021-02-15 20:00:23.058329
Tripura,2,32960,391,2,32960,391,33353,33353,2021-02-15 20:00:23.058329
Uttarakhand,637,94449,1680,687,94453,1680,96820,96766,2021-02-15 20:00:23.058329
Uttar Pradesh,3098,590292,8699,3040,590448,8702,602190,602089,2021-02-15 20:00:23.058329
West Bengal,4160,558015,10230,4086,558277,10232,572595,572405,2021-02-15 20:00:23.058329
Andaman and Nicobar Islands,9,4938,62,9,4938,62,5009,5009,2021-02-16 20:00:20.366709
Andhra Pradesh,735,880972,7162,695,881041,7163,888899,888869,2021-02-16 20:00:20.366709
Arunachal Pradesh,3,16773,56,3,16774,56,16833,16832,2021-02-16 20:00:20.366709
Assam,1621,214585,1087,1614,214601,1089,217304,217293,2021-02-16 20:00:20.366709
Bihar,625,259591,1525,588,259670,1527,261785,261741,2021-02-16 20:00:20.366709
Chandigarh,127,20765,346,129,20789,346,21264,21238,2021-02-16 20:00:20.366709
Chhattisgarh,3258,302069,3772,3039,302557,3777,309373,309099,2021-02-16 20:00:20.366709
Dadra and Nagar Haveli and Daman and Diu,2,3396,2,2,3396,2,3400,3400,2021-02-16 20:00:20.366709
Delhi,1031,625024,10891,1036,625158,10893,637087,636946,2021-02-16 20:00:20.366709
Goa,546,52910,779,525,52969,781,54275,54235,2021-02-16 20:00:20.366709
Gujarat,1739,259104,4401,1708,259384,4401,265493,265244,2021-02-16 20:00:20.366709
Haryana,852,265155,3039,903,265212,3039,269154,269046,2021-02-16 20:00:20.366709
Himachal Pradesh,411,56817,994,398,56851,994,58243,58222,2021-02-16 20:00:20.366709
Jammu and Kashmir,622,122768,1951,617,122837,1951,125405,125341,2021-02-16 20:00:20.366709
Jharkhand,461,117773,1082,464,117806,1084,119354,119316,2021-02-16 20:00:20.366709
Karnataka,5855,927150,12265,5791,927580,12267,945638,945270,2021-02-16 20:00:20.366709
Kerala,63752,936398,3985,61550,941471,3998,1007019,1004135,2021-02-16 20:00:20.366709
Ladakh,45,9592,130,48,9595,130,9773,9767,2021-02-16 20:00:20.366709
Lakshadweep,97,136,0,91,143,0,234,233,2021-02-16 20:00:20.366709
Madhya Pradesh,1842,251970,3834,1847,252164,3838,257849,257646,2021-02-16 20:00:20.366709
Maharashtra,37146,1975603,51529,37383,1978708,51552,2067643,2064278,2021-02-16 20:00:20.366709
Manipur,75,28748,373,76,28755,373,29204,29196,2021-02-16 20:00:20.366709
Meghalaya,149,13645,148,128,13666,148,13942,13942,2021-02-16 20:00:20.366709
Mizoram,17,4366,9,18,4367,10,4395,4392,2021-02-16 20:00:20.366709
Nagaland,73,12028,88,58,12043,88,12189,12189,2021-02-16 20:00:20.366709
Odisha,710,333554,1910,714,333637,1911,336262,336174,2021-02-16 20:00:20.366709
Puducherry,258,38533,657,236,38574,658,39468,39448,2021-02-16 20:00:20.366709
Punjab,2360,168239,5697,2357,168456,5707,176520,176296,2021-02-16 20:00:20.366709
Rajasthan,1409,314733,2781,1365,314859,2781,319005,318923,2021-02-16 20:00:20.366709
Sikkim,56,5927,135,54,5929,135,6118,6118,2021-02-16 20:00:20.366709
Tamil Nadu,4260,828441,12419,4232,828918,12425,845575,845120,2021-02-16 20:00:20.366709
Telengana,1676,293379,1618,1643,293540,1619,296802,296673,2021-02-16 20:00:20.366709
Tripura,2,32960,391,2,32960,391,33353,33353,2021-02-16 20:00:20.366709
Uttarakhand,687,94453,1680,615,94572,1680,96867,96820,2021-02-16 20:00:20.366709
Uttar Pradesh,3040,590448,8702,2974,590570,8704,602248,602190,2021-02-16 20:00:20.366709
West Bengal,4086,558277,10232,3960,558535,10233,572728,572595,2021-02-16 20:00:20.366709
Andaman and Nicobar Islands,9,4938,62,8,4943,62,5013,5009,2021-02-17 20:14:53.858187
Andhra Pradesh,695,881041,7163,615,881181,7163,888959,888899,2021-02-17 20:14:53.858187
Arunachal Pradesh,3,16774,56,3,16774,56,16833,16833,2021-02-17 20:14:53.858187
Assam,1614,214601,1089,1605,214615,1089,217309,217304,2021-02-17 20:14:53.858187
Bihar,588,259670,1527,565,259748,1528,261841,261785,2021-02-17 20:14:53.858187
Chandigarh,129,20789,346,133,20813,347,21293,21264,2021-02-17 20:14:53.858187
Chhattisgarh,3039,302557,3777,2905,302935,3783,309623,309373,2021-02-17 20:14:53.858187
Dadra and Nagar Haveli and Daman and Diu,2,3396,2,2,3396,2,3400,3400,2021-02-17 20:14:53.858187
Delhi,1036,625158,10893,1019,625268,10894,637181,637087,2021-02-17 20:14:53.858187
Goa,525,52969,781,504,53035,784,54323,54275,2021-02-17 20:14:53.858187
Gujarat,1708,259384,4401,1699,259655,4402,265756,265493,2021-02-17 20:14:53.858187
Haryana,903,265212,3039,819,265381,3040,269240,269154,2021-02-17 20:14:53.858187
Himachal Pradesh,398,56851,994,370,56898,994,58262,58243,2021-02-17 20:14:53.858187
Jammu and Kashmir,617,122837,1951,629,122883,1951,125463,125405,2021-02-17 20:14:53.858187
Jharkhand,464,117806,1084,460,117850,1084,119394,119354,2021-02-17 20:14:53.858187
Karnataka,5791,927580,12267,5879,927924,12273,946076,945638,2021-02-17 20:14:53.858187
Kerala,61550,941471,3998,61030,946910,4016,1011956,1007019,2021-02-17 20:14:53.858187
Ladakh,48,9595,130,48,9601,130,9779,9773,2021-02-17 20:14:53.858187
Lakshadweep,91,143,0,93,158,0,251,234,2021-02-17 20:14:53.858187
Madhya Pradesh,1847,252164,3838,1856,252385,3841,258082,257849,2021-02-17 20:14:53.858187
Maharashtra,37383,1978708,51552,38307,1981408,51591,2071306,2067643,2021-02-17 20:14:53.858187
Manipur,76,28755,373,83,28757,373,29213,29204,2021-02-17 20:14:53.858187
Meghalaya,128,13666,148,100,13696,148,13944,13942,2021-02-17 20:14:53.858187
Mizoram,18,4367,10,18,4368,10,4396,4395,2021-02-17 20:14:53.858187
Nagaland,58,12043,88,41,12059,90,12190,12189,2021-02-17 20:14:53.858187
Odisha,714,333637,1911,710,333700,1912,336322,336262,2021-02-17 20:14:53.858187
Puducherry,236,38574,658,213,38617,658,39488,39468,2021-02-17 20:14:53.858187
Punjab,2357,168456,5707,2401,168654,5712,176767,176520,2021-02-17 20:14:53.858187
Rajasthan,1365,314859,2781,1257,315027,2781,319065,319005,2021-02-17 20:14:53.858187
Sikkim,54,5929,135,56,5930,135,6121,6118,2021-02-17 20:14:53.858187
Tamil Nadu,4232,828918,12425,4206,829388,12432,846026,845575,2021-02-17 20:14:53.858187
Telengana,1643,293540,1619,1640,293690,1620,296950,296802,2021-02-17 20:14:53.858187
Tripura,2,32960,391,4,32960,391,33355,33353,2021-02-17 20:14:53.858187
Uttarakhand,615,94572,1680,564,94674,1682,96920,96867,2021-02-17 20:14:53.858187
Uttar Pradesh,2974,590570,8704,2853,590787,8704,602344,602248,2021-02-17 20:14:53.858187
West Bengal,3960,558535,10233,3854,558790,10235,572879,572728,2021-02-17 20:14:53.858187
Andaman and Nicobar Islands,8,4943,62,8,4944,62,5014,5013,2021-02-18 20:06:44.204392
Andhra Pradesh,615,881181,7163,607,881238,7165,889010,888959,2021-02-18 20:06:44.204392
Arunachal Pradesh,3,16774,56,3,16774,56,16833,16833,2021-02-18 20:06:44.204392
Assam,1605,214615,1089,1612,214628,1090,217330,217309,2021-02-18 20:06:44.204392
Bihar,565,259748,1528,520,259830,1529,261879,261841,2021-02-18 20:06:44.204392
Chandigarh,133,20813,347,142,20832,348,21322,21293,2021-02-18 20:06:44.204392
Chhattisgarh,2905,302935,3783,3009,303137,3788,309934,309623,2021-02-18 20:06:44.204392
Dadra and Nagar Haveli and Daman and Diu,2,3396,2,4,3396,2,3402,3400,2021-02-18 20:06:44.204392
Delhi,1019,625268,10894,1078,625343,10894,637315,637181,2021-02-18 20:06:44.204392
Goa,504,53035,784,509,53074,786,54369,54323,2021-02-18 20:06:44.204392
Gujarat,1699,259655,4402,1703,259928,4403,266034,265756,2021-02-18 20:06:44.204392
Haryana,819,265381,3040,826,265455,3041,269322,269240,2021-02-18 20:06:44.204392
Himachal Pradesh,370,56898,994,354,56948,994,58296,58262,2021-02-18 20:06:44.204392
Jammu and Kashmir,629,122883,1951,657,122939,1951,125547,125463,2021-02-18 20:06:44.204392
Jharkhand,460,117850,1084,466,117889,1084,119439,119394,2021-02-18 20:06:44.204392
Karnataka,5879,927924,12273,5717,928461,12276,946454,946076,2021-02-18 20:06:44.204392
Kerala,61030,946910,4016,61074,951742,4032,1016848,1011956,2021-02-18 20:06:44.204392
Ladakh,48,9601,130,48,9604,130,9782,9779,2021-02-18 20:06:44.204392
Lakshadweep,93,158,0,97,164,0,261,251,2021-02-18 20:06:44.204392
Madhya Pradesh,1856,252385,3841,1863,252628,3842,258333,258082,2021-02-18 20:06:44.204392
Maharashtra,38307,1981408,51591,39201,1985261,51631,2076093,2071306,2021-02-18 20:06:44.204392
Manipur,83,28757,373,91,28759,373,29223,29213,2021-02-18 20:06:44.204392
Meghalaya,100,13696,148,78,13719,148,13945,13944,2021-02-18 20:06:44.204392
Mizoram,18,4368,10,20,4369,10,4399,4396,2021-02-18 20:06:44.204392
Nagaland,41,12059,90,36,12064,90,12190,12190,2021-02-18 20:06:44.204392
Odisha,710,333700,1912,697,333788,1912,336397,336322,2021-02-18 20:06:44.204392
Puducherry,213,38617,658,202,38644,660,39506,39488,2021-02-18 20:06:44.204392
Punjab,2401,168654,5712,2546,168833,5722,177101,176767,2021-02-18 20:06:44.204392
Rajasthan,1257,315027,2781,1249,315135,2782,319166,319065,2021-02-18 20:06:44.204392
Sikkim,56,5930,135,54,5932,135,6121,6121,2021-02-18 20:06:44.204392
Tamil Nadu,4206,829388,12432,4192,829850,12438,846480,846026,2021-02-18 20:06:44.204392
Telengana,1640,293690,1620,1700,293791,1622,297113,296950,2021-02-18 20:06:44.204392
Tripura,4,32960,391,5,32961,391,33357,33355,2021-02-18 20:06:44.204392
Uttarakhand,564,94674,1682,548,94733,1683,96964,96920,2021-02-18 20:06:44.204392
Uttar Pradesh,2853,590787,8704,2690,591013,8707,602410,602344,2021-02-18 20:06:44.204392
West Bengal,3854,558790,10235,3736,559039,10237,573012,572879,2021-02-18 20:06:44.204392
Andaman and Nicobar Islands,8,4944,62,8,4944,62,5014,5014,2021-02-19 20:00:22.977073
Andhra Pradesh,607,881238,7165,619,881292,7166,889077,889010,2021-02-19 20:00:22.977073
Arunachal Pradesh,3,16774,56,5,16775,56,16836,16833,2021-02-19 20:00:22.977073
Assam,1612,214628,1090,1614,214639,1091,217344,217330,2021-02-19 20:00:22.977073
Bihar,520,259830,1529,513,259898,1531,261942,261879,2021-02-19 20:00:22.977073
Chandigarh,142,20832,348,150,20854,348,21352,21322,2021-02-19 20:00:22.977073
Chhattisgarh,3009,303137,3788,3005,303415,3790,310210,309934,2021-02-19 20:00:22.977073
Dadra and Nagar Haveli and Daman and Diu,4,3396,2,4,3396,2,3402,3402,2021-02-19 20:00:22.977073
Delhi,1078,625343,10894,1053,625496,10896,637445,637315,2021-02-19 20:00:22.977073
Goa,509,53074,786,510,53125,786,54421,54369,2021-02-19 20:00:22.977073
Gujarat,1703,259928,4403,1696,260198,4403,266297,266034,2021-02-19 20:00:22.977073
Haryana,826,265455,3041,814,265549,3042,269405,269322,2021-02-19 20:00:22.977073
Himachal Pradesh,354,56948,994,301,57017,994,58312,58296,2021-02-19 20:00:22.977073
Jammu and Kashmir,657,122939,1951,688,122992,1954,125634,125547,2021-02-19 20:00:22.977073
Jharkhand,466,117889,1084,467,117926,1084,119477,119439,2021-02-19 20:00:22.977073
Karnataka,5717,928461,12276,5811,928767,12282,946860,946454,2021-02-19 20:00:22.977073
Kerala,61074,951742,4032,60451,956935,4046,1021432,1016848,2021-02-19 20:00:22.977073
Ladakh,48,9604,130,48,9605,130,9783,9782,2021-02-19 20:00:22.977073
Lakshadweep,97,164,0,96,167,0,263,261,2021-02-19 20:00:22.977073
Madhya Pradesh,1863,252628,3842,1909,252821,3844,258574,258333,2021-02-19 20:00:22.977073
Maharashtra,39201,1985261,51631,42047,1987804,51669,2081520,2076093,2021-02-19 20:00:22.977073
Manipur,91,28759,373,83,28769,373,29225,29223,2021-02-19 20:00:22.977073
Meghalaya,78,13719,148,55,13743,148,13946,13945,2021-02-19 20:00:22.977073
Mizoram,20,4369,10,23,4372,10,4405,4399,2021-02-19 20:00:22.977073
Nagaland,36,12064,90,29,12071,91,12191,12190,2021-02-19 20:00:22.977073
Odisha,697,333788,1912,659,333888,1913,336460,336397,2021-02-19 20:00:22.977073
Puducherry,202,38644,660,199,38667,660,39526,39506,2021-02-19 20:00:22.977073
Punjab,2546,168833,5722,2642,169002,5732,177376,177101,2021-02-19 20:00:22.977073
Rajasthan,1249,315135,2782,1275,315212,2783,319270,319166,2021-02-19 20:00:22.977073
Sikkim,54,5932,135,58,5933,135,6126,6121,2021-02-19 20:00:22.977073
Tamil Nadu,4192,829850,12438,4173,830320,12444,846937,846480,2021-02-19 20:00:22.977073
Telengana,1700,293791,1622,1715,293940,1623,297278,297113,2021-02-19 20:00:22.977073
Tripura,5,32961,391,14,32961,391,33366,33357,2021-02-19 20:00:22.977073
Uttarakhand,548,94733,1683,549,94772,1684,97005,96964,2021-02-19 20:00:22.977073
Uttar Pradesh,2690,591013,8707,2587,591194,8709,602490,602410,2021-02-19 20:00:22.977073
West Bengal,3736,559039,10237,3672,559282,10239,573193,573012,2021-02-19 20:00:22.977073
Andaman and Nicobar Islands,8,4944,62,4,4948,62,5014,5014,2021-02-20 20:00:26.132971
Andhra Pradesh,619,881292,7166,620,881369,7167,889156,889077,2021-02-20 20:00:26.132971
Arunachal Pradesh,5,16775,56,5,16775,56,16836,16836,2021-02-20 20:00:26.132971
Assam,1614,214639,1091,1618,214658,1091,217367,217344,2021-02-20 20:00:26.132971
Bihar,513,259898,1531,504,259973,1532,262009,261942,2021-02-20 20:00:26.132971
Chandigarh,150,20854,348,156,20867,348,21371,21352,2021-02-20 20:00:26.132971
Chhattisgarh,3005,303415,3790,3039,303637,3793,310469,310210,2021-02-20 20:00:26.132971
Dadra and Nagar Haveli and Daman and Diu,4,3396,2,4,3396,2,3402,3402,2021-02-20 20:00:26.132971
Delhi,1053,625496,10896,1053,625653,10897,637603,637445,2021-02-20 20:00:26.132971
Goa,510,53125,786,498,53181,787,54466,54421,2021-02-20 20:00:26.132971
Gujarat,1696,260198,4403,1684,260475,4404,266563,266297,2021-02-20 20:00:26.132971
Haryana,814,265549,3042,813,265643,3042,269498,269405,2021-02-20 20:00:26.132971
Himachal Pradesh,301,57017,994,298,57052,994,58344,58312,2021-02-20 20:00:26.132971
Jammu and Kashmir,688,122992,1954,702,123059,1954,125715,125634,2021-02-20 20:00:26.132971
Jharkhand,467,117926,1084,467,117977,1084,119528,119477,2021-02-20 20:00:26.132971
Karnataka,5811,928767,12282,5901,929058,12287,947246,946860,2021-02-20 20:00:26.132971
Kerala,60451,956935,4046,60087,961789,4061,1025937,1021432,2021-02-20 20:00:26.132971
Ladakh,48,9605,130,41,9614,130,9785,9783,2021-02-20 20:00:26.132971
Lakshadweep,96,167,0,91,181,0,272,263,2021-02-20 20:00:26.132971
Madhya Pradesh,1909,252821,3844,1954,253071,3846,258871,258574,2021-02-20 20:00:26.132971
Maharashtra,42047,1987804,51669,45956,1989963,51713,2087632,2081520,2021-02-20 20:00:26.132971
Manipur,83,28769,373,85,28772,373,29230,29225,2021-02-20 20:00:26.132971
Meghalaya,55,13743,148,38,13765,148,13951,13946,2021-02-20 20:00:26.132971
Mizoram,23,4372,10,24,4373,10,4407,4405,2021-02-20 20:00:26.132971
Nagaland,29,12071,91,20,12080,91,12191,12191,2021-02-20 20:00:26.132971
Odisha,659,333888,1913,619,333980,1914,336513,336460,2021-02-20 20:00:26.132971
Puducherry,199,38667,660,177,38701,662,39540,39526,2021-02-20 20:00:26.132971
Punjab,2642,169002,5732,2803,169216,5740,177759,177376,2021-02-20 20:00:26.132971
Rajasthan,1275,315212,2783,1269,315310,2784,319363,319270,2021-02-20 20:00:26.132971
Sikkim,58,5933,135,54,5938,135,6127,6126,2021-02-20 20:00:26.132971
Tamil Nadu,4173,830320,12444,4147,830787,12451,847385,846937,2021-02-20 20:00:26.132971
Telengana,1715,293940,1623,1715,294097,1623,297435,297278,2021-02-20 20:00:26.132971
Tripura,14,32961,391,40,32961,391,33392,33366,2021-02-20 20:00:26.132971
Uttarakhand,549,94772,1684,495,94850,1686,97031,97005,2021-02-20 20:00:26.132971
Uttar Pradesh,2587,591194,8709,2521,591359,8712,602592,602490,2021-02-20 20:00:26.132971
West Bengal,3672,559282,10239,3625,559520,10242,573387,573193,2021-02-20 20:00:26.132971
Andaman and Nicobar Islands,4,4948,62,3,4949,62,5014,5014,2021-02-21 20:00:27.889097
Andhra Pradesh,620,881369,7167,604,881439,7167,889210,889156,2021-02-21 20:00:27.889097
Arunachal Pradesh,5,16775,56,5,16775,56,16836,16836,2021-02-21 20:00:27.889097
Assam,1618,214658,1091,1616,214676,1091,217383,217367,2021-02-21 20:00:27.889097
Bihar,504,259973,1532,502,260030,1534,262066,262009,2021-02-21 20:00:27.889097
Chandigarh,156,20867,348,169,20879,349,21397,21371,2021-02-21 20:00:27.889097
Chhattisgarh,3039,303637,3793,3102,303835,3795,310732,310469,2021-02-21 20:00:27.889097
Dadra and Nagar Haveli and Daman and Diu,4,3396,2,4,3396,2,3402,3402,2021-02-21 20:00:27.889097
Delhi,1053,625653,10897,1025,625832,10898,637755,637603,2021-02-21 20:00:27.889097
Goa,498,53181,787,493,53243,787,54523,54466,2021-02-21 20:00:27.889097
Gujarat,1684,260475,4404,1672,260745,4404,266821,266563,2021-02-21 20:00:27.889097
Haryana,813,265643,3042,816,265751,3042,269609,269498,2021-02-21 20:00:27.889097
Himachal Pradesh,298,57052,994,252,57120,994,58366,58344,2021-02-21 20:00:27.889097
Jammu and Kashmir,702,123059,1954,700,123129,1954,125783,125715,2021-02-21 20:00:27.889097
Jharkhand,467,117977,1084,459,118022,1084,119565,119528,2021-02-21 20:00:27.889097
Karnataka,5901,929058,12287,5997,929447,12292,947736,947246,2021-02-21 20:00:27.889097
Kerala,60087,961789,4061,58883,967630,4074,1030587,1025937,2021-02-21 20:00:27.889097
Ladakh,41,9614,130,40,9616,130,9786,9785,2021-02-21 20:00:27.889097
Lakshadweep,91,181,0,85,192,0,277,272,2021-02-21 20:00:27.889097
Madhya Pradesh,1954,253071,3846,1994,253284,3850,259128,258871,2021-02-21 20:00:27.889097
Maharashtra,45956,1989963,51713,49630,1992530,51753,2093913,2087632,2021-02-21 20:00:27.889097
Manipur,85,28772,373,84,28776,373,29233,29230,2021-02-21 20:00:27.889097
Meghalaya,38,13765,148,26,13778,148,13952,13951,2021-02-21 20:00:27.889097
Mizoram,24,4373,10,22,4377,10,4409,4407,2021-02-21 20:00:27.889097
Nagaland,20,12080,91,18,12082,91,12191,12191,2021-02-21 20:00:27.889097
Odisha,619,333980,1914,611,334053,1914,336578,336513,2021-02-21 20:00:27.889097
Puducherry,177,38701,662,188,38719,662,39569,39540,2021-02-21 20:00:27.889097
Punjab,2803,169216,5740,2883,169480,5748,178111,177759,2021-02-21 20:00:27.889097
Rajasthan,1269,315310,2784,1300,315376,2785,319461,319363,2021-02-21 20:00:27.889097
Sikkim,54,5938,135,53,5940,135,6128,6127,2021-02-21 20:00:27.889097
Tamil Nadu,4147,830787,12451,4120,831246,12457,847823,847385,2021-02-21 20:00:27.889097
Telengana,1715,294097,1623,1731,294243,1624,297598,297435,2021-02-21 20:00:27.889097
Tripura,40,32961,391,41,32961,391,33393,33392,2021-02-21 20:00:27.889097
Uttarakhand***,495,94850,1686,495,94850,1686,97031,97031,2021-02-21 20:00:27.889097
Uttar Pradesh,2521,591359,8712,2432,591559,8714,602705,602592,2021-02-21 20:00:27.889097
West Bengal,3625,559520,10242,3579,559755,10246,573580,573387,2021-02-21 20:00:27.889097
Andaman and Nicobar Islands,3,4949,62,3,4949,62,5014,5014,2021-02-22 20:00:23.439427
Andhra Pradesh,604,881439,7167,620,881511,7167,889298,889210,2021-02-22 20:00:23.439427
Arunachal Pradesh,5,16775,56,5,16775,56,16836,16836,2021-02-22 20:00:23.439427
Assam,1616,214676,1091,1607,214694,1091,217392,217383,2021-02-22 20:00:23.439427
Bihar,502,260030,1534,537,260088,1535,262160,262066,2021-02-22 20:00:23.439427
Chandigarh,169,20879,349,186,20890,349,21425,21397,2021-02-22 20:00:23.439427
Chhattisgarh,3102,303835,3795,3112,303973,3800,310885,310732,2021-02-22 20:00:23.439427
Dadra and Nagar Haveli and Daman and Diu,4,3396,2,4,3396,2,3402,3402,2021-02-22 20:00:23.439427
Delhi,1025,625832,10898,1071,625929,10900,637900,637755,2021-02-22 20:00:23.439427
Goa,493,53243,787,488,53287,787,54562,54523,2021-02-22 20:00:23.439427
Gujarat,1672,260745,4404,1690,261009,4405,267104,266821,2021-02-22 20:00:23.439427
Haryana,816,265751,3042,861,265827,3042,269730,269609,2021-02-22 20:00:23.439427
Himachal Pradesh,252,57120,994,234,57156,995,58385,58366,2021-02-22 20:00:23.439427
Jammu and Kashmir,700,123129,1954,721,123192,1954,125867,125783,2021-02-22 20:00:23.439427
Jharkhand,459,118022,1084,453,118058,1085,119596,119565,2021-02-22 20:00:23.439427
Karnataka,5997,929447,12292,6055,929800,12294,948149,947736,2021-02-22 20:00:23.439427
Kerala,58883,967630,4074,58593,971975,4089,1034657,1030587,2021-02-22 20:00:23.439427
Ladakh,40,9616,130,39,9617,130,9786,9786,2021-02-22 20:00:23.439427
Lakshadweep,85,192,0,76,204,0,280,277,2021-02-22 20:00:23.439427
Madhya Pradesh,1994,253284,3850,2051,253522,3854,259427,259128,2021-02-22 20:00:23.439427
Maharashtra,49630,1992530,51753,54149,1994947,51788,2100884,2093913,2021-02-22 20:00:23.439427
Manipur,84,28776,373,80,28784,373,29237,29233,2021-02-22 20:00:23.439427
Meghalaya,26,13778,148,22,13782,148,13952,13952,2021-02-22 20:00:23.439427
Mizoram,22,4377,10,22,4377,10,4409,4409,2021-02-22 20:00:23.439427
Nagaland,18,12082,91,13,12088,91,12192,12191,2021-02-22 20:00:23.439427
Odisha,611,334053,1914,615,334107,1914,336636,336578,2021-02-22 20:00:23.439427
Puducherry,188,38719,662,192,38737,663,39592,39569,2021-02-22 20:00:23.439427
Punjab,2883,169480,5748,3019,169686,5754,178459,178111,2021-02-22 20:00:23.439427
Rajasthan,1300,315376,2785,1245,315513,2785,319543,319461,2021-02-22 20:00:23.439427
Sikkim,53,5940,135,52,5945,135,6132,6128,2021-02-22 20:00:23.439427
Tamil Nadu,4120,831246,12457,4109,831706,12460,848275,847823,2021-02-22 20:00:23.439427
Telengana,1731,294243,1624,1701,294386,1625,297712,297598,2021-02-22 20:00:23.439427
Tripura,41,32961,391,41,32962,391,33394,33393,2021-02-22 20:00:23.439427
Uttarakhand,495,94850,1686,494,94850,1687,97031,97031,2021-02-22 20:00:23.439427
Uttar Pradesh,2432,591559,8714,2370,591700,8715,602785,602705,2021-02-22 20:00:23.439427
West Bengal,3579,559755,10246,3525,559988,10249,573762,573580,2021-02-22 20:00:23.439427
Andaman and Nicobar Islands,147,4949,62,152,3469,52,3673,5014,2021-02-23 17:39:44
Andhra Pradesh,78836,881511,7167,74518,551821,5410,631749,889298,2021-02-23 17:39:44
Arunachal Pradesh,1964,16775,56,1939,5643,13,7595,16836,2021-02-23 17:39:44
Assam,28780,214694,1091,29609,129133,578,159320,217392,2021-02-23 17:39:44
Bihar,13005,260088,1535,12539,156242,870,169651,262160,2021-02-23 17:39:44
Chandigarh,2821,20890,349,2761,7411,126,10298,21425,2021-02-23 17:39:44
Chhattisgarh,37853,303973,3800,37927,49564,690,88181,310885,2021-02-23 17:39:44
Dadra and Nagar Haveli and Daman and Diu,229,3396,2,220,2711,2,2933,3402,2021-02-23 17:39:44
Delhi,32097,625929,10900,30941,213304,5014,249259,637900,2021-02-23 17:39:44
Goa,5781,53287,787,5667,22726,360,28753,54562,2021-02-23 17:39:44
Gujarat,16208,261009,4405,16305,104964,3336,124605,267104,2021-02-23 17:39:44
Haryana,21411,265827,3042,21014,90884,1177,113075,269730,2021-02-23 17:39:44
Himachal Pradesh,4444,57156,995,4458,7853,127,12438,58385,2021-02-23 17:39:44
Jammu and Kashmir,22032,123192,1954,21887,42115,1024,65026,125867,2021-02-23 17:39:44
Jharkhand,13791,118058,1085,13504,58543,626,72673,119596,2021-02-23 17:39:44
Karnataka,98062,929800,12294,95354,423377,8145,526876,948149,2021-02-23 17:39:44
Kerala,39484,971975,4089,39354,98724,553,138631,1034657,2021-02-23 17:39:44
Ladakh,1013,9617,130,1047,2735,50,3832,9786,2021-02-23 17:39:44
Lakshadweep,0,204,0,0,0,0,0,280,2021-02-23 17:39:44
Madhya Pradesh,22300,253522,3854,22542,83618,2007,108167,259427,2021-02-23 17:39:44
Maharashtra,291630,1994947,51788,275017,916348,33015,1224380,2100884,2021-02-23 17:39:44
Manipur,2070,28784,373,2113,6838,59,9010,29237,2021-02-23 17:39:44
Meghalaya,2111,13782,148,2169,2527,37,4733,13952,2021-02-23 17:39:44
Mizoram,583,4377,10,680,1012,0,1692,4409,2021-02-23 17:39:44
Nagaland,1184,12088,91,1052,4477,15,5544,12192,2021-02-23 17:39:44
Odisha,33504,334107,1914,34033,149379,710,184122,336636,2021-02-23 17:39:44
Puducherry,4908,38737,663,4659,18065,467,23191,39592,2021-02-23 17:39:44
Punjab,22278,169686,5754,21661,75409,2860,99930,178459,2021-02-23 17:39:44
Rajasthan,18184,315513,2785,18245,97284,1352,116881,319543,2021-02-23 17:39:44
Sikkim,469,5945,135,513,1986,29,2528,6132,2021-02-23 17:39:44
Tamil Nadu,46703,831706,12460,46495,491971,8871,547337,848275,2021-02-23 17:39:44
Telengana,29636,294386,1625,29649,144073,1052,174774,297712,2021-02-23 17:39:44
Tripura,6566,32962,391,6700,15883,251,22834,33394,2021-02-23 17:39:44
Uttarakhand,12455,591700,8715,12075,29201,501,41777,602785,2021-02-23 17:39:44
Uttar Pradesh,65954,94850,1687,64164,289594,5135,358893,97031,2021-02-23 17:39:44
West Bengal,24806,559988,10249,24898,198983,4421,228302,573762,2021-02-23 17:39:44
Andaman and Nicobar Islands,4,4949,62,5,4949,62,5016,5015,2021-02-24 20:01:55.686711
Andhra Pradesh,590,881582,7167,575,881666,7168,889409,889339,2021-02-24 20:01:55.686711
Arunachal Pradesh,5,16775,56,4,16776,56,16836,16836,2021-02-24 20:01:55.686711
Assam,1603,214712,1091,1604,214732,1091,217427,217406,2021-02-24 20:01:55.686711
Bihar,561,260147,1536,548,260218,1537,262303,262244,2021-02-24 20:01:55.686711
Chandigarh,205,20908,350,227,20923,350,21500,21463,2021-02-24 20:01:55.686711
Chhattisgarh,2998,304355,3806,2977,304647,3809,311433,311159,2021-02-24 20:01:55.686711
Dadra and Nagar Haveli and Daman and Diu,4,3396,2,2,3398,2,3402,3402,2021-02-24 20:01:55.686711
Delhi,1041,626086,10901,1009,626261,10903,638173,638028,2021-02-24 20:01:55.686711
Goa,464,53340,787,479,53381,788,54648,54591,2021-02-24 20:01:55.686711
Gujarat,1732,261281,4406,1786,261575,4406,267767,267419,2021-02-24 20:01:55.686711
Haryana,874,265920,3042,908,266017,3042,269967,269836,2021-02-24 20:01:55.686711
Himachal Pradesh,227,57181,995,218,57210,995,58423,58403,2021-02-24 20:01:55.686711
Jammu and Kashmir,735,123236,1954,766,123298,1955,126019,125925,2021-02-24 20:01:55.686711
Jharkhand,448,118103,1086,447,118154,1086,119687,119637,2021-02-24 20:01:55.686711
Karnataka,6080,930087,12299,6081,930465,12303,948849,948466,2021-02-24 20:01:55.686711
Kerala,55752,977012,4105,54949,981835,4119,1040903,1036869,2021-02-24 20:01:55.686711
Ladakh,37,9620,130,45,9621,130,9796,9787,2021-02-24 20:01:55.686711
Lakshadweep,80,215,0,80,236,0,316,295,2021-02-24 20:01:55.686711
Madhya Pradesh,2104,253763,3854,2151,253963,3855,259969,259721,2021-02-24 20:01:55.686711
Maharashtra,54306,1999982,51806,54604,2005851,51857,2112312,2106094,2021-02-24 20:01:55.686711
Manipur,49,28818,373,36,28834,373,29243,29240,2021-02-24 20:01:55.686711
Meghalaya,22,13784,148,20,13787,148,13955,13954,2021-02-24 20:01:55.686711
Mizoram,21,4379,10,24,4379,10,4413,4410,2021-02-24 20:01:55.686711
Nagaland,12,12089,91,12,12089,91,12192,12192,2021-02-24 20:01:55.686711
Odisha,625,334166,1914,610,334243,1914,336767,336705,2021-02-24 20:01:55.686711
Puducherry,174,38763,663,179,38784,665,39628,39600,2021-02-24 20:01:55.686711
Punjab,3167,169911,5769,3295,170187,5779,179261,178847,2021-02-24 20:01:55.686711
Rajasthan,1206,315635,2785,1195,315722,2785,319702,319626,2021-02-24 20:01:55.686711
Sikkim,49,5948,135,47,5950,135,6132,6132,2021-02-24 20:01:55.686711
Tamil Nadu,4091,832167,12466,4074,832620,12472,849166,848724,2021-02-24 20:01:55.686711
Telengana,1697,294537,1627,1745,294683,1629,298057,297861,2021-02-24 20:01:55.686711
Tripura,45,32962,391,47,32962,391,33400,33398,2021-02-24 20:01:55.686711
Uttarakhand,492,94850,1689,491,94850,1690,97031,97031,2021-02-24 20:01:55.686711
Uttar Pradesh,2366,591787,8716,2268,591989,8718,602975,602869,2021-02-24 20:01:55.686711
West Bengal,3440,560219,10251,3399,560447,10253,574099,573910,2021-02-24 20:01:55.686711
Andaman and Nicobar Islands,5,4949,62,4,4950,62,5016,5016,2021-02-25 20:36:00.478025
Andhra Pradesh,575,881666,7168,603,881732,7168,889503,889409,2021-02-25 20:36:00.478025
Arunachal Pradesh,4,16776,56,4,16776,56,16836,16836,2021-02-25 20:36:00.478025
Assam,1604,214732,1091,1606,214757,1091,217454,217427,2021-02-25 20:36:00.478025
Bihar,548,260218,1537,509,260310,1538,262357,262303,2021-02-25 20:36:00.478025
Chandigarh,227,20923,350,250,20940,351,21541,21500,2021-02-25 20:36:00.478025
Chhattisgarh,2977,304647,3809,2911,304956,3813,311680,311433,2021-02-25 20:36:00.478025
Dadra and Nagar Haveli and Daman and Diu,2,3398,2,4,3398,2,3404,3402,2021-02-25 20:36:00.478025
Delhi,1009,626261,10903,1137,626331,10905,638373,638173,2021-02-25 20:36:00.478025
Goa,479,53381,788,495,53416,789,54700,54648,2021-02-25 20:36:00.478025
Gujarat,1786,261575,4406,1869,261871,4407,268147,267767,2021-02-25 20:36:00.478025
Haryana,908,266017,3042,955,266099,3043,270097,269967,2021-02-25 20:36:00.478025
Himachal Pradesh,218,57210,995,229,57233,995,58457,58423,2021-02-25 20:36:00.478025
Jammu and Kashmir,766,123298,1955,771,123367,1955,126093,126019,2021-02-25 20:36:00.478025
Jharkhand,447,118154,1086,431,118201,1087,119719,119687,2021-02-25 20:36:00.478025
Karnataka,6081,930465,12303,6096,930778,12309,949183,948849,2021-02-25 20:36:00.478025
Kerala,54949,981835,4119,53153,987720,4136,1045009,1040903,2021-02-25 20:36:00.478025
Ladakh,45,9621,130,53,9624,130,9807,9796,2021-02-25 20:36:00.478025
Lakshadweep,80,236,0,86,236,0,322,316,2021-02-25 20:36:00.478025
Madhya Pradesh,2151,253963,3855,2270,254186,3857,260313,259969,2021-02-25 20:36:00.478025
Maharashtra,54604,2005851,51857,60559,2008623,51937,2121119,2112312,2021-02-25 20:36:00.478025
Manipur,36,28834,373,41,28836,373,29250,29243,2021-02-25 20:36:00.478025
Meghalaya,20,13787,148,18,13792,148,13958,13955,2021-02-25 20:36:00.478025
Mizoram,24,4379,10,23,4380,10,4413,4413,2021-02-25 20:36:00.478025
Nagaland,12,12089,91,8,12093,91,12192,12192,2021-02-25 20:36:00.478025
Odisha,610,334243,1914,588,334333,1914,336835,336767,2021-02-25 20:36:00.478025
Puducherry,179,38784,665,189,38801,666,39656,39628,2021-02-25 20:36:00.478025
Punjab,3295,170187,5779,3598,170435,5786,179819,179261,2021-02-25 20:36:00.478025
Rajasthan,1195,315722,2785,1204,315812,2785,319801,319702,2021-02-25 20:36:00.478025
Sikkim,47,5950,135,47,5950,135,6132,6132,2021-02-25 20:36:00.478025
Tamil Nadu,4074,832620,12472,4062,833089,12478,849629,849166,2021-02-25 20:36:00.478025
Telengana,1745,294683,1629,1852,294782,1630,298264,298057,2021-02-25 20:36:00.478025
Tripura,47,32962,391,25,32984,391,33400,33400,2021-02-25 20:36:00.478025
Uttarakhand,491,94850,1690,491,94850,1690,97031,97031,2021-02-25 20:36:00.478025
Uttar Pradesh,2268,591989,8718,2190,592192,8721,603103,602975,2021-02-25 20:36:00.478025
West Bengal,3399,560447,10253,3377,560668,10256,574301,574099,2021-02-25 20:36:00.478025
Andaman and Nicobar Islands,4,4950,62,2,4952,62,5016,5016,2021-02-26 20:10:02.001061
Andhra Pradesh,603,881732,7168,611,881806,7168,889585,889503,2021-02-26 20:10:02.001061
Arunachal Pradesh,4,16776,56,3,16777,56,16836,16836,2021-02-26 20:10:02.001061
Assam,1606,214757,1091,1623,214770,1091,217484,217454,2021-02-26 20:10:02.001061
Bihar,509,260310,1538,478,260401,1539,262418,262357,2021-02-26 20:10:02.001061
Chandigarh,250,20940,351,279,20960,351,21590,21541,2021-02-26 20:10:02.001061
Chhattisgarh,2911,304956,3813,2865,305214,3821,311900,311680,2021-02-26 20:10:02.001061
Dadra and Nagar Haveli and Daman and Diu,4,3398,2,5,3398,2,3405,3404,2021-02-26 20:10:02.001061
Delhi,1137,626331,10905,1169,626519,10905,638593,638373,2021-02-26 20:10:02.001061
Goa,495,53416,789,531,53449,791,54771,54700,2021-02-26 20:10:02.001061
Gujarat,1869,261871,4407,1991,262172,4408,268571,268147,2021-02-26 20:10:02.001061
Haryana,955,266099,3043,1054,266166,3043,270263,270097,2021-02-26 20:10:02.001061
Himachal Pradesh,229,57233,995,244,57260,995,58499,58457,2021-02-26 20:10:02.001061
Jammu and Kashmir,771,123367,1955,820,123426,1955,126201,126093,2021-02-26 20:10:02.001061
Jharkhand,431,118201,1087,467,118241,1087,119795,119719,2021-02-26 20:10:02.001061
Karnataka,6096,930778,12309,5595,931725,12316,949636,949183,2021-02-26 20:10:02.001061
Kerala,53153,987720,4136,52164,992372,4150,1048686,1045009,2021-02-26 20:10:02.001061
Ladakh,53,9624,130,56,9628,130,9814,9807,2021-02-26 20:10:02.001061
Lakshadweep,86,236,0,86,244,1,331,322,2021-02-26 20:10:02.001061
Madhya Pradesh,2270,254186,3857,2435,254387,3859,260681,260313,2021-02-26 20:10:02.001061
Maharashtra,60559,2008623,51937,65461,2012367,51993,2129821,2121119,2021-02-26 20:10:02.001061
Manipur,41,28836,373,40,28840,373,29253,29250,2021-02-26 20:10:02.001061
Meghalaya,18,13792,148,20,13793,148,13961,13958,2021-02-26 20:10:02.001061
Mizoram,23,4380,10,27,4382,10,4419,4413,2021-02-26 20:10:02.001061
Nagaland,8,12093,91,13,12094,91,12198,12192,2021-02-26 20:10:02.001061
Odisha,588,334333,1914,609,334400,1915,336924,336835,2021-02-26 20:10:02.001061
Puducherry,189,38801,666,196,38814,667,39677,39656,2021-02-26 20:10:02.001061
Punjab,3598,170435,5786,3870,170713,5799,180382,179819,2021-02-26 20:10:02.001061
Rajasthan,1204,315812,2785,1208,315936,2785,319929,319801,2021-02-26 20:10:02.001061
Sikkim,47,5950,135,43,5955,135,6133,6132,2021-02-26 20:10:02.001061
Tamil Nadu,4062,833089,12478,4053,833560,12483,850096,849629,2021-02-26 20:10:02.001061
Telengana,1852,294782,1630,1910,294911,1632,298453,298264,2021-02-26 20:10:02.001061
Tripura,25,32984,391,32,32984,391,33407,33400,2021-02-26 20:10:02.001061
Uttarakhand,491,94850,1690,491,94850,1690,97031,97031,2021-02-26 20:10:02.001061
Uttar Pradesh,2190,592192,8721,2182,592327,8723,603232,603103,2021-02-26 20:10:02.001061
West Bengal,3377,560668,10256,3353,560887,10260,574500,574301,2021-02-26 20:10:02.001061
Andaman and Nicobar Islands,2,4952,62,3,4952,62,5017,5016,2021-02-27 20:05:42.468315
Andhra Pradesh,611,881806,7168,635,881877,7169,889681,889585,2021-02-27 20:05:42.468315
Arunachal Pradesh,3,16777,56,3,16777,56,16836,16836,2021-02-27 20:05:42.468315
Assam,1623,214770,1091,1634,214792,1092,217518,217484,2021-02-27 20:05:42.468315
Bihar,478,260401,1539,431,260493,1540,262464,262418,2021-02-27 20:05:42.468315
Chandigarh,279,20960,351,322,20986,351,21659,21590,2021-02-27 20:05:42.468315
Chhattisgarh,2865,305214,3821,2827,305524,3828,312179,311900,2021-02-27 20:05:42.468315
Dadra and Nagar Haveli and Daman and Diu,5,3398,2,4,3400,2,3406,3405,2021-02-27 20:05:42.468315
Delhi,1169,626519,10905,1231,626712,10906,638849,638593,2021-02-27 20:05:42.468315
Goa,531,53449,791,587,53490,794,54871,54771,2021-02-27 20:05:42.468315
Gujarat,1991,262172,4408,2136,262487,4408,269031,268571,2021-02-27 20:05:42.468315
Haryana,1054,266166,3043,1103,266264,3044,270411,270263,2021-02-27 20:05:42.468315
Himachal Pradesh,244,57260,995,261,57287,995,58543,58499,2021-02-27 20:05:42.468315
Jammu and Kashmir,820,123426,1955,803,123527,1956,126286,126201,2021-02-27 20:05:42.468315
Jharkhand,467,118241,1087,492,118284,1087,119863,119795,2021-02-27 20:05:42.468315
Karnataka,5595,931725,12316,5520,932367,12320,950207,949636,2021-02-27 20:05:42.468315
Kerala,52164,992372,4150,51679,996514,4164,1052357,1048686,2021-02-27 20:05:42.468315
Ladakh,56,9628,130,54,9632,130,9816,9814,2021-02-27 20:05:42.468315
Lakshadweep,86,244,1,80,252,1,333,331,2021-02-27 20:05:42.468315
Madhya Pradesh,2435,254387,3859,2518,254633,3862,261013,260681,2021-02-27 20:05:42.468315
Maharashtra,65461,2012367,51993,68810,2017303,52041,2138154,2129821,2021-02-27 20:05:42.468315
Manipur,40,28840,373,37,28850,373,29260,29253,2021-02-27 20:05:42.468315
Meghalaya,20,13793,148,19,13794,148,13961,13961,2021-02-27 20:05:42.468315
Mizoram,27,4382,10,26,4386,10,4422,4419,2021-02-27 20:05:42.468315
Nagaland,13,12094,91,9,12098,91,12198,12198,2021-02-27 20:05:42.468315
Odisha,609,334400,1915,640,334463,1915,337018,336924,2021-02-27 20:05:42.468315
Puducherry,196,38814,667,194,38836,667,39697,39677,2021-02-27 20:05:42.468315
Punjab,3870,170713,5799,4222,170968,5814,181004,180382,2021-02-27 20:05:42.468315
Rajasthan,1208,315936,2785,1231,316061,2786,320078,319929,2021-02-27 20:05:42.468315
Sikkim,43,5955,135,45,5955,135,6135,6133,2021-02-27 20:05:42.468315
Tamil Nadu,4053,833560,12483,4046,834043,12488,850577,850096,2021-02-27 20:05:42.468315
Telengana,1910,294911,1632,1939,295059,1633,298631,298453,2021-02-27 20:05:42.468315
Tripura,32,32984,391,32,32984,391,33407,33407,2021-02-27 20:05:42.468315
Uttarakhand,491,94850,1690,490,94850,1691,97031,97031,2021-02-27 20:05:42.468315
Uttar Pradesh,2182,592327,8723,2184,592441,8725,603350,603232,2021-02-27 20:05:42.468315
West Bengal,3353,560887,10260,3343,561110,10263,574716,574500,2021-02-27 20:05:42.468315
Andaman and Nicobar Islands,3,4952,62,4,4952,62,5018,5017,2021-02-28 20:32:36.579479
Andhra Pradesh,635,881877,7169,667,881963,7169,889799,889681,2021-02-28 20:32:36.579479
Arunachal Pradesh,3,16777,56,3,16777,56,16836,16836,2021-02-28 20:32:36.579479
Assam,1634,214792,1092,1620,214815,1092,217527,217518,2021-02-28 20:32:36.579479
Bihar,431,260493,1540,404,260564,1541,262509,262464,2021-02-28 20:32:36.579479
Chandigarh,322,20986,351,357,21011,351,21719,21659,2021-02-28 20:32:36.579479
Chhattisgarh,2827,305524,3828,2767,305819,3833,312419,312179,2021-02-28 20:32:36.579479
Dadra and Nagar Haveli and Daman and Diu,4,3400,2,4,3400,2,3406,3406,2021-02-28 20:32:36.579479
Delhi,1231,626712,10906,1307,626876,10909,639092,638849,2021-02-28 20:32:36.579479
Goa,587,53490,794,598,53540,794,54932,54871,2021-02-28 20:32:36.579479
Gujarat,2136,262487,4408,2258,262815,4409,269482,269031,2021-02-28 20:32:36.579479
Haryana,1103,266264,3044,1205,266358,3047,270610,270411,2021-02-28 20:32:36.579479
Himachal Pradesh,261,57287,995,292,57311,995,58598,58543,2021-02-28 20:32:36.579479
Jammu and Kashmir,803,123527,1956,828,123599,1956,126383,126286,2021-02-28 20:32:36.579479
Jharkhand,492,118284,1087,492,118325,1088,119905,119863,2021-02-28 20:32:36.579479
Karnataka,5520,932367,12320,5657,932747,12326,950730,950207,2021-02-28 20:32:36.579479
Kerala,51679,996514,4164,50803,1001164,4182,1056149,1052357,2021-02-28 20:32:36.579479
Ladakh,54,9632,130,54,9634,130,9818,9816,2021-02-28 20:32:36.579479
Lakshadweep,80,252,1,98,260,1,359,333,2021-02-28 20:32:36.579479
Madhya Pradesh,2518,254633,3862,2666,254874,3863,261403,261013,2021-02-28 20:32:36.579479
Maharashtra,68810,2017303,52041,73734,2020951,52092,2146777,2138154,2021-02-28 20:32:36.579479
Manipur,37,28850,373,44,28854,373,29271,29260,2021-02-28 20:32:36.579479
Meghalaya,19,13794,148,17,13796,148,13961,13961,2021-02-28 20:32:36.579479
Mizoram,26,4386,10,25,4388,10,4423,4422,2021-02-28 20:32:36.579479
Nagaland,9,12098,91,10,12098,91,12199,12198,2021-02-28 20:32:36.579479
Odisha,640,334463,1915,670,334519,1915,337104,337018,2021-02-28 20:32:36.579479
Puducherry,194,38836,667,197,38852,668,39717,39697,2021-02-28 20:32:36.579479
Punjab,4222,170968,5814,4436,171336,5825,181597,181004,2021-02-28 20:32:36.579479
Rajasthan,1231,316061,2786,1254,316139,2787,320180,320078,2021-02-28 20:32:36.579479
Sikkim,45,5955,135,44,5958,135,6137,6135,2021-02-28 20:32:36.579479
Tamil Nadu,4046,834043,12488,4036,834534,12493,851063,850577,2021-02-28 20:32:36.579479
Telengana,1939,295059,1633,1951,295222,1634,298807,298631,2021-02-28 20:32:36.579479
Tripura,32,32984,391,41,32985,391,33417,33407,2021-02-28 20:32:36.579479
Uttarakhand,490,94850,1691,489,94850,1692,97031,97031,2021-02-28 20:32:36.579479
Uttar Pradesh,2184,592441,8725,2146,592556,8725,603427,603350,2021-02-28 20:32:36.579479
West Bengal,3343,561110,10263,3333,561327,10266,574926,574716,2021-02-28 20:32:36.579479
Andaman and Nicobar Islands,6,4952,62,6,4952,62,5020,5020,2021-03-02 20:00:23.632362
Andhra Pradesh,718,882029,7169,725,882080,7169,889974,889916,2021-03-02 20:00:23.632362
Arunachal Pradesh,0,16780,56,1,16780,56,16837,16836,2021-03-02 20:00:23.632362
Assam,1615,214830,1092,1631,214846,1093,217570,217537,2021-03-02 20:00:23.632362
Bihar,399,260594,1541,370,260645,1541,262556,262534,2021-03-02 20:00:23.632362
Chandigarh,381,21037,352,430,21056,353,21839,21770,2021-03-02 20:00:23.632362
Chhattisgarh,2774,305951,3835,2880,306094,3842,312816,312560,2021-03-02 20:00:23.632362
Dadra and Nagar Haveli and Daman and Diu,4,3400,2,4,3400,2,3406,3406,2021-03-02 20:00:23.632362
Delhi,1335,627044,10910,1404,627149,10911,639464,639289,2021-03-02 20:00:23.632362
Goa,606,53585,795,583,53647,796,55026,54986,2021-03-02 20:00:23.632362
Gujarat,2363,263116,4410,2431,263475,4410,270316,269889,2021-03-02 20:00:23.632362
Haryana,1275,266461,3048,1288,266612,3050,270950,270784,2021-03-02 20:00:23.632362
Himachal Pradesh,318,57332,995,434,57347,996,58777,58645,2021-03-02 20:00:23.632362
Jammu and Kashmir,823,123661,1957,829,123717,1958,126504,126441,2021-03-02 20:00:23.632362
Jharkhand,494,118365,1090,485,118411,1090,119986,119949,2021-03-02 20:00:23.632362
Karnataka,5823,933097,12331,5843,933421,12336,951600,951251,2021-03-02 20:00:23.632362
Kerala,49709,1005497,4197,48159,1008972,4210,1061341,1059403,2021-03-02 20:00:23.632362
Ladakh,53,9635,130,46,9643,130,9819,9818,2021-03-02 20:00:23.632362
Lakshadweep,120,261,1,128,268,1,397,382,2021-03-02 20:00:23.632362
Madhya Pradesh,2785,255117,3864,2901,255336,3865,262102,261766,2021-03-02 20:00:23.632362
Maharashtra,78212,2024704,52154,78825,2030458,52184,2161467,2155070,2021-03-02 20:00:23.632362
Manipur,33,28867,373,30,28871,373,29274,29273,2021-03-02 20:00:23.632362
Meghalaya,17,13797,148,17,13798,148,13963,13962,2021-03-02 20:00:23.632362
Mizoram,20,4393,10,20,4396,10,4426,4423,2021-03-02 20:00:23.632362
Nagaland,7,12102,91,7,12102,91,12200,12200,2021-03-02 20:00:23.632362
Odisha,704,334571,1916,714,334647,1916,337277,337191,2021-03-02 20:00:23.632362
Puducherry,185,38872,668,177,38888,669,39734,39725,2021-03-02 20:00:23.632362
Punjab,4632,171712,5832,4853,172106,5850,182809,182176,2021-03-02 20:00:23.632362
Rajasthan,1308,316241,2787,1304,316364,2787,320455,320336,2021-03-02 20:00:23.632362
Sikkim,46,5964,135,45,5965,135,6145,6145,2021-03-02 20:00:23.632362
Tamil Nadu,4022,835024,12496,4009,835506,12501,852016,851542,2021-03-02 20:00:23.632362
Telengana,1902,295387,1634,1907,295544,1635,299086,298923,2021-03-02 20:00:23.632362
Tripura,39,32987,391,42,32987,391,33420,33417,2021-03-02 20:00:23.632362
Uttarakhand,489,94850,1692,459,94880,1692,97031,97031,2021-03-02 20:00:23.632362
Uttar Pradesh,2103,592699,8725,2078,592803,8727,603608,603527,2021-03-02 20:00:23.632362
West Bengal,3307,561543,10268,3293,561755,10268,575316,575118,2021-03-02 20:00:23.632362
Andaman and Nicobar Islands,6,4952,62,6,4952,62,5020,5020,2021-03-03 20:39:02.944113
Andhra Pradesh,725,882080,7169,774,882137,7169,890080,889974,2021-03-03 20:39:02.944113
Arunachal Pradesh,1,16780,56,2,16780,56,16838,16837,2021-03-03 20:39:02.944113
Assam,1631,214846,1093,1632,214860,1093,217585,217570,2021-03-03 20:39:02.944113
Bihar,370,260645,1541,369,260687,1541,262597,262556,2021-03-03 20:39:02.944113
Chandigarh,430,21056,353,472,21080,354,21906,21839,2021-03-03 20:39:02.944113
Chhattisgarh,2880,306094,3842,2836,306352,3844,313032,312816,2021-03-03 20:39:02.944113
Dadra and Nagar Haveli and Daman and Diu,4,3400,2,6,3400,2,3408,3406,2021-03-03 20:39:02.944113
Delhi,1404,627149,10911,1543,627227,10911,639681,639464,2021-03-03 20:39:02.944113
Goa,583,53647,796,582,53695,796,55073,55026,2021-03-03 20:39:02.944113
Gujarat,2431,263475,4410,2522,263837,4411,270770,270316,2021-03-03 20:39:02.944113
Haryana,1288,266612,3050,1348,266725,3052,271125,270950,2021-03-03 20:39:02.944113
Himachal Pradesh,434,57347,996,437,57367,996,58800,58777,2021-03-03 20:39:02.944113
Jammu and Kashmir,829,123717,1958,820,123811,1958,126589,126504,2021-03-03 20:39:02.944113
Jharkhand,485,118411,1090,498,118449,1090,120037,119986,2021-03-03 20:39:02.944113
Karnataka,5843,933421,12336,5964,933730,12343,952037,951600,2021-03-03 20:39:02.944113
Kerala,48159,1008972,4210,47569,1012484,4226,1064279,1061341,2021-03-03 20:39:02.944113
Ladakh,46,9643,130,44,9645,130,9819,9819,2021-03-03 20:39:02.944113
Lakshadweep,128,268,1,137,269,1,407,397,2021-03-03 20:39:02.944113
Madhya Pradesh,2901,255336,3865,2973,255595,3865,262433,262102,2021-03-03 20:39:02.944113
Maharashtra,78825,2030458,52184,80302,2036790,52238,2169330,2161467,2021-03-03 20:39:02.944113
Manipur,30,28871,373,33,28876,373,29282,29274,2021-03-03 20:39:02.944113
Meghalaya,17,13798,148,15,13803,148,13966,13963,2021-03-03 20:39:02.944113
Mizoram,20,4396,10,20,4397,10,4427,4426,2021-03-03 20:39:02.944113
Nagaland,7,12102,91,7,12102,91,12200,12200,2021-03-03 20:39:02.944113
Odisha,714,334647,1916,731,334703,1917,337351,337277,2021-03-03 20:39:02.944113
Puducherry,177,38888,669,174,38920,669,39763,39734,2021-03-03 20:39:02.944113
Punjab,4853,172106,5850,5198,172480,5860,183538,182809,2021-03-03 20:39:02.944113
Rajasthan,1304,316364,2787,1340,316430,2787,320557,320455,2021-03-03 20:39:02.944113
Sikkim,45,5965,135,37,5975,135,6147,6145,2021-03-03 20:39:02.944113
Tamil Nadu,4009,835506,12501,3997,835979,12502,852478,852016,2021-03-03 20:39:02.944113
Telengana,1907,295544,1635,1912,295707,1635,299254,299086,2021-03-03 20:39:02.944113
Tripura,42,32987,391,40,32989,391,33420,33420,2021-03-03 20:39:02.944113
Uttarakhand,459,94880,1692,451,94946,1692,97089,97031,2021-03-03 20:39:02.944113
Uttar Pradesh,2078,592803,8727,2082,592901,8728,603711,603608,2021-03-03 20:39:02.944113
West Bengal,3293,561755,10268,3253,561964,10270,575487,575316,2021-03-03 20:39:02.944113
Andaman and Nicobar Islands,6,4952,62,8,4952,62,5022,5020,2021-03-04 20:00:28.606498
Andhra Pradesh,774,882137,7169,826,882219,7170,890215,890080,2021-03-04 20:00:28.606498
Arunachal Pradesh,2,16780,56,2,16780,56,16838,16838,2021-03-04 20:00:28.606498
Assam,1632,214860,1093,1621,214879,1093,217593,217585,2021-03-04 20:00:28.606498
Bihar,369,260687,1541,349,260737,1542,262628,262597,2021-03-04 20:00:28.606498
Chandigarh,472,21080,354,503,21104,355,21962,21906,2021-03-04 20:00:28.606498
Chhattisgarh,2836,306352,3844,2961,306490,3848,313299,313032,2021-03-04 20:00:28.606498
Dadra and Nagar Haveli and Daman and Diu,6,3400,2,6,3400,2,3408,3408,2021-03-04 20:00:28.606498
Delhi,1543,627227,10911,1584,627423,10914,639921,639681,2021-03-04 20:00:28.606498
Goa,582,53695,796,610,53737,796,55143,55073,2021-03-04 20:00:28.606498
Gujarat,2522,263837,4411,2638,264195,4412,271245,270770,2021-03-04 20:00:28.606498
Haryana,1348,266725,3052,1470,266843,3052,271365,271125,2021-03-04 20:00:28.606498
Himachal Pradesh,437,57367,996,495,57386,996,58877,58800,2021-03-04 20:00:28.606498
Jammu and Kashmir,820,123811,1958,875,123860,1958,126693,126589,2021-03-04 20:00:28.606498
Jharkhand,498,118449,1090,473,118505,1090,120068,120037,2021-03-04 20:00:28.606498
Karnataka,5964,933730,12343,6076,934143,12346,952565,952037,2021-03-04 20:00:28.606498
Kerala,47569,1012484,4226,46288,1016515,4241,1067044,1064279,2021-03-04 20:00:28.606498
Ladakh,44,9645,130,42,9649,130,9821,9819,2021-03-04 20:00:28.606498
Lakshadweep,137,269,1,128,285,1,414,407,2021-03-04 20:00:28.606498
Madhya Pradesh,2973,255595,3865,3097,255888,3865,262850,262433,2021-03-04 20:00:28.606498
Maharashtra,80302,2036790,52238,83556,2043349,52280,2179185,2169330,2021-03-04 20:00:28.606498
Manipur,33,28876,373,32,28878,373,29283,29282,2021-03-04 20:00:28.606498
Meghalaya,15,13803,148,14,13804,148,13966,13966,2021-03-04 20:00:28.606498
Mizoram,20,4397,10,19,4398,10,4427,4427,2021-03-04 20:00:28.606498
Nagaland,7,12102,91,12,12102,91,12205,12200,2021-03-04 20:00:28.606498
Odisha,731,334703,1917,764,334767,1917,337448,337351,2021-03-04 20:00:28.606498
Puducherry,174,38920,669,168,38940,669,39777,39763,2021-03-04 20:00:28.606498
Punjab,5198,172480,5860,5593,172845,5872,184310,183538,2021-03-04 20:00:28.606498
Rajasthan,1340,316430,2787,1470,316515,2787,320772,320557,2021-03-04 20:00:28.606498
Sikkim,37,5975,135,29,5986,135,6150,6147,2021-03-04 20:00:28.606498
Tamil Nadu,3997,835979,12502,3990,836473,12504,852967,852478,2021-03-04 20:00:28.606498
Telengana,1912,295707,1635,1948,295821,1637,299406,299254,2021-03-04 20:00:28.606498
Tripura,40,32989,391,33,32998,391,33422,33420,2021-03-04 20:00:28.606498
Uttarakhand,451,94946,1692,463,94979,1692,97134,97089,2021-03-04 20:00:28.606498
Uttar Pradesh,2082,592901,8728,2025,593035,8728,603788,603711,2021-03-04 20:00:28.606498
West Bengal,3253,561964,10270,3245,562195,10272,575712,575487,2021-03-04 20:00:28.606498
Andaman and Nicobar Islands,8,4952,62,9,4953,62,5024,5022,2021-03-05 20:36:55.213783
Andhra Pradesh,826,882219,7170,871,882275,7171,890317,890215,2021-03-05 20:36:55.213783
Arunachal Pradesh,2,16780,56,2,16780,56,16838,16838,2021-03-05 20:36:55.213783
Assam,1621,214879,1093,1626,214894,1093,217613,217593,2021-03-05 20:36:55.213783
Bihar,349,260737,1542,348,260777,1543,262668,262628,2021-03-05 20:36:55.213783
Chandigarh,503,21104,355,545,21140,355,22040,21962,2021-03-05 20:36:55.213783
Chhattisgarh,2961,306490,3848,2990,306693,3851,313534,313299,2021-03-05 20:36:55.213783
Dadra and Nagar Haveli and Daman and Diu,6,3400,2,6,3400,2,3408,3408,2021-03-05 20:36:55.213783
Delhi,1584,627423,10914,1701,627566,10915,640182,639921,2021-03-05 20:36:55.213783
Goa,610,53737,796,639,53775,798,55212,55143,2021-03-05 20:36:55.213783
Gujarat,2638,264195,4412,2749,264564,4412,271725,271245,2021-03-05 20:36:55.213783
Haryana,1470,266843,3052,1615,266992,3052,271659,271365,2021-03-05 20:36:55.213783
Himachal Pradesh,495,57386,996,540,57406,996,58942,58877,2021-03-05 20:36:55.213783
Jammu and Kashmir,875,123860,1958,883,123930,1959,126772,126693,2021-03-05 20:36:55.213783
Jharkhand,473,118505,1090,486,118552,1091,120129,120068,2021-03-05 20:36:55.213783
Karnataka,6076,934143,12346,6147,934639,12350,953136,952565,2021-03-05 20:36:55.213783
Kerala,46288,1016515,4241,44734,1020671,4255,1069660,1067044,2021-03-05 20:36:55.213783
Ladakh,42,9649,130,43,9651,130,9824,9821,2021-03-05 20:36:55.213783
Lakshadweep,128,285,1,115,309,1,425,414,2021-03-05 20:36:55.213783
Madhya Pradesh,3097,255888,3865,3308,256116,3866,263290,262850,2021-03-05 20:36:55.213783
Maharashtra,83556,2043349,52280,86359,2049484,52340,2188183,2179185,2021-03-05 20:36:55.213783
Manipur,32,28878,373,32,28878,373,29283,29283,2021-03-05 20:36:55.213783
Meghalaya,14,13804,148,13,13805,148,13966,13966,2021-03-05 20:36:55.213783
Mizoram,19,4398,10,18,4400,10,4428,4427,2021-03-05 20:36:55.213783
Nagaland,12,12102,91,15,12104,91,12210,12205,2021-03-05 20:36:55.213783
Odisha,764,334767,1917,774,334838,1917,337529,337448,2021-03-05 20:36:55.213783
Puducherry,168,38940,669,166,38959,669,39794,39777,2021-03-05 20:36:55.213783
Punjab,5593,172845,5872,6264,173230,5887,185381,184310,2021-03-05 20:36:55.213783
Rajasthan,1470,316515,2787,1509,316631,2788,320928,320772,2021-03-05 20:36:55.213783
Sikkim,29,5986,135,32,5987,135,6154,6150,2021-03-05 20:36:55.213783
Tamil Nadu,3990,836473,12504,3978,836963,12508,853449,852967,2021-03-05 20:36:55.213783
Telengana,1948,295821,1637,1963,295970,1639,299572,299406,2021-03-05 20:36:55.213783
Tripura,33,32998,391,32,33001,391,33424,33422,2021-03-05 20:36:55.213783
Uttarakhand,463,94979,1692,542,95000,1692,97234,97134,2021-03-05 20:36:55.213783
Uttar Pradesh,2025,593035,8728,2029,593149,8729,603907,603788,2021-03-05 20:36:55.213783
West Bengal,3245,562195,10272,3236,562412,10273,575921,575712,2021-03-05 20:36:55.213783
Andaman and Nicobar Islands,9,4953,62,8,4954,62,5024,5024,2021-03-06 20:18:26.278546
Andhra Pradesh,871,882275,7171,900,882369,7172,890441,890317,2021-03-06 20:18:26.278546
Arunachal Pradesh,2,16780,56,3,16780,56,16839,16838,2021-03-06 20:18:26.278546
Assam,1626,214894,1093,1635,214914,1093,217642,217613,2021-03-06 20:18:26.278546
Bihar,348,260777,1543,341,260821,1544,262706,262668,2021-03-06 20:18:26.278546
Chandigarh,545,21140,355,587,21174,355,22116,22040,2021-03-06 20:18:26.278546
Chhattisgarh,2990,306693,3851,2816,307138,3854,313808,313534,2021-03-06 20:18:26.278546
Dadra and Nagar Haveli and Daman and Diu,6,3400,2,6,3400,2,3408,3408,2021-03-06 20:18:26.278546
Delhi,1701,627566,10915,1779,627797,10918,640494,640182,2021-03-06 20:18:26.278546
Goa,639,53775,798,675,53817,799,55291,55212,2021-03-06 20:18:26.278546
Gujarat,2749,264564,4412,2858,264969,4413,272240,271725,2021-03-06 20:18:26.278546
Haryana,1615,266992,3052,1723,267116,3053,271892,271659,2021-03-06 20:18:26.278546
Himachal Pradesh,540,57406,996,589,57428,997,59014,58942,2021-03-06 20:18:26.278546
Jammu and Kashmir,883,123930,1959,891,124002,1960,126853,126772,2021-03-06 20:18:26.278546
Jharkhand,486,118552,1091,481,118601,1091,120173,120129,2021-03-06 20:18:26.278546
Karnataka,6147,934639,12350,6393,935066,12354,953813,953136,2021-03-06 20:18:26.278546
Kerala,44734,1020671,4255,43856,1024309,4271,1072436,1069660,2021-03-06 20:18:26.278546
Ladakh,43,9651,130,42,9654,130,9826,9824,2021-03-06 20:18:26.278546
Lakshadweep,115,309,1,156,311,1,468,425,2021-03-06 20:18:26.278546
Madhya Pradesh,3308,256116,3866,3457,256424,3866,263747,263290,2021-03-06 20:18:26.278546
Maharashtra,86359,2049484,52340,90055,2055951,52393,2198399,2188183,2021-03-06 20:18:26.278546
Manipur,32,28878,373,33,28880,373,29286,29283,2021-03-06 20:18:26.278546
Meghalaya,13,13805,148,14,13806,148,13968,13966,2021-03-06 20:18:26.278546
Mizoram,18,4400,10,14,4404,10,4428,4428,2021-03-06 20:18:26.278546
Nagaland,15,12104,91,15,12104,91,12210,12210,2021-03-06 20:18:26.278546
Odisha,774,334838,1917,801,334902,1917,337620,337529,2021-03-06 20:18:26.278546
Puducherry,166,38959,669,176,38979,669,39824,39794,2021-03-06 20:18:26.278546
Punjab,6264,173230,5887,6661,173630,5898,186189,185381,2021-03-06 20:18:26.278546
Rajasthan,1509,316631,2788,1584,316750,2789,321123,320928,2021-03-06 20:18:26.278546
Sikkim,32,5987,135,35,5987,135,6157,6154,2021-03-06 20:18:26.278546
Tamil Nadu,3978,836963,12508,3954,837525,12513,853992,853449,2021-03-06 20:18:26.278546
Telengana,1963,295970,1639,1936,296166,1640,299742,299572,2021-03-06 20:18:26.278546
Tripura,32,33001,391,31,33002,391,33424,33424,2021-03-06 20:18:26.278546
Uttarakhand,542,95000,1692,556,95035,1694,97285,97234,2021-03-06 20:18:26.278546
Uttar Pradesh,2029,593149,8729,2017,593288,8729,604034,603907,2021-03-06 20:18:26.278546
West Bengal,3236,562412,10273,3226,562675,10275,576176,575921,2021-03-06 20:18:26.278546
Andaman and Nicobar Islands,8,4954,62,7,4955,62,5024,5024,2021-03-07 20:00:23.814145
Andhra Pradesh,900,882369,7172,921,882462,7173,890556,890441,2021-03-07 20:00:23.814145
Arunachal Pradesh,3,16780,56,3,16780,56,16839,16839,2021-03-07 20:00:23.814145
Assam,1635,214914,1093,1625,214930,1094,217649,217642,2021-03-07 20:00:23.814145
Bihar,341,260821,1544,334,260849,1545,262728,262706,2021-03-07 20:00:23.814145
Chandigarh,587,21174,355,675,21208,355,22238,22116,2021-03-07 20:00:23.814145
Chhattisgarh,2816,307138,3854,2721,307522,3855,314098,313808,2021-03-07 20:00:23.814145
Dadra and Nagar Haveli and Daman and Diu,6,3400,2,5,3402,2,3409,3408,2021-03-07 20:00:23.814145
Delhi,1779,627797,10918,1779,628117,10919,640815,640494,2021-03-07 20:00:23.814145
Goa,675,53817,799,700,53862,799,55361,55291,2021-03-07 20:00:23.814145
Gujarat,2858,264969,4413,3025,265372,4414,272811,272240,2021-03-07 20:00:23.814145
Haryana,1723,267116,3053,1898,267261,3056,272215,271892,2021-03-07 20:00:23.814145
Himachal Pradesh,589,57428,997,589,57473,997,59059,59014,2021-03-07 20:00:23.814145
Jammu and Kashmir,891,124002,1960,882,124089,1961,126932,126853,2021-03-07 20:00:23.814145
Jharkhand,481,118601,1091,461,118665,1091,120217,120173,2021-03-07 20:00:23.814145
Karnataka,6393,935066,12354,6613,935421,12359,954393,953813,2021-03-07 20:00:23.814145
Kerala,43856,1024309,4271,43114,1027826,4287,1075227,1072436,2021-03-07 20:00:23.814145
Ladakh,42,9654,130,44,9656,130,9830,9826,2021-03-07 20:00:23.814145
Lakshadweep,156,311,1,159,313,1,473,468,2021-03-07 20:00:23.814145
Madhya Pradesh,3457,256424,3866,3527,256819,3868,264214,263747,2021-03-07 20:00:23.814145
Maharashtra,90055,2055951,52393,94115,2062031,52440,2208586,2198399,2021-03-07 20:00:23.814145
Manipur,33,28880,373,31,28884,373,29288,29286,2021-03-07 20:00:23.814145
Meghalaya,14,13806,148,12,13810,148,13970,13968,2021-03-07 20:00:23.814145
Mizoram,14,4404,10,9,4409,10,4428,4428,2021-03-07 20:00:23.814145
Nagaland,15,12104,91,15,12105,91,12211,12210,2021-03-07 20:00:23.814145
Odisha,801,334902,1917,767,334990,1917,337674,337620,2021-03-07 20:00:23.814145
Puducherry,176,38979,669,173,39000,670,39843,39824,2021-03-07 20:00:23.814145
Punjab,6661,173630,5898,7164,174274,5910,187348,186189,2021-03-07 20:00:23.814145
Rajasthan,1584,316750,2789,1703,316864,2789,321356,321123,2021-03-07 20:00:23.814145
Sikkim,35,5987,135,44,5988,135,6167,6157,2021-03-07 20:00:23.814145
Tamil Nadu,3954,837525,12513,3952,838085,12517,854554,853992,2021-03-07 20:00:23.814145
Telengana,1936,296166,1640,1886,296373,1641,299900,299742,2021-03-07 20:00:23.814145
Tripura,31,33002,391,30,33003,391,33424,33424,2021-03-07 20:00:23.814145
Uttarakhand,556,95035,1694,596,95073,1694,97363,97285,2021-03-07 20:00:23.814145
Uttar Pradesh,2017,593288,8729,1731,593704,8729,604164,604034,2021-03-07 20:00:23.814145
West Bengal,3226,562675,10275,3213,562945,10277,576435,576176,2021-03-07 20:00:23.814145
Andaman and Nicobar Islands,7,4955,62,7,4955,62,5024,5024,2021-03-08 20:00:17.914735
Andhra Pradesh,921,882462,7173,998,882520,7174,890692,890556,2021-03-08 20:00:17.914735
Arunachal Pradesh,3,16780,56,3,16780,56,16839,16839,2021-03-08 20:00:17.914735
Assam,1625,214930,1094,1627,214947,1094,217668,217649,2021-03-08 20:00:17.914735
Bihar,334,260849,1545,313,260899,1546,262758,262728,2021-03-08 20:00:17.914735
Chandigarh,675,21208,355,710,21253,355,22318,22238,2021-03-08 20:00:17.914735
Chhattisgarh,2721,307522,3855,2820,307642,3858,314320,314098,2021-03-08 20:00:17.914735
Dadra and Nagar Haveli and Daman and Diu,5,3402,2,12,3402,2,3416,3409,2021-03-08 20:00:17.914735
Delhi,1779,628117,10919,1803,628377,10921,641101,640815,2021-03-08 20:00:17.914735
Goa,700,53862,799,688,53922,799,55409,55361,2021-03-08 20:00:17.914735
Gujarat,3025,265372,4414,3140,265831,4415,273386,272811,2021-03-08 20:00:17.914735
Haryana,1898,267261,3056,2031,267433,3056,272520,272215,2021-03-08 20:00:17.914735
Himachal Pradesh,589,57473,997,614,57507,997,59118,59059,2021-03-08 20:00:17.914735
Jammu and Kashmir,882,124089,1961,892,124190,1962,127044,126932,2021-03-08 20:00:17.914735
Jharkhand,461,118665,1091,463,118703,1093,120259,120217,2021-03-08 20:00:17.914735
Karnataka,6613,935421,12359,6881,935772,12362,955015,954393,2021-03-08 20:00:17.914735
Kerala,43114,1027826,4287,41162,1031865,4300,1077327,1075227,2021-03-08 20:00:17.914735
Ladakh,44,9656,130,44,9657,130,9831,9830,2021-03-08 20:00:17.914735
Lakshadweep,159,313,1,158,327,1,486,473,2021-03-08 20:00:17.914735
Madhya Pradesh,3527,256819,3868,3606,257166,3871,264643,264214,2021-03-08 20:00:17.914735
Maharashtra,94115,2062031,52440,99205,2068044,52478,2219727,2208586,2021-03-08 20:00:17.914735
Manipur,31,28884,373,28,28890,373,29291,29288,2021-03-08 20:00:17.914735
Meghalaya,12,13810,148,13,13811,148,13972,13970,2021-03-08 20:00:17.914735
Mizoram,9,4409,10,8,4410,10,4428,4428,2021-03-08 20:00:17.914735
Nagaland,15,12105,91,20,12106,91,12217,12211,2021-03-08 20:00:17.914735
Odisha,767,334990,1917,747,335080,1917,337744,337674,2021-03-08 20:00:17.914735
Puducherry,173,39000,670,176,39022,670,39868,39843,2021-03-08 20:00:17.914735
Punjab,7164,174274,5910,7497,174967,5927,188391,187348,2021-03-08 20:00:17.914735
Rajasthan,1703,316864,2789,1755,316988,2789,321532,321356,2021-03-08 20:00:17.914735
Sikkim,44,5988,135,50,5989,135,6174,6167,2021-03-08 20:00:17.914735
Tamil Nadu,3952,838085,12517,3997,838606,12518,855121,854554,2021-03-08 20:00:17.914735
Telengana,1886,296373,1641,1807,296562,1642,300011,299900,2021-03-08 20:00:17.914735
Tripura,30,33003,391,30,33003,391,33424,33424,2021-03-08 20:00:17.914735
Uttarakhand,596,95073,1694,632,95095,1695,97422,97363,2021-03-08 20:00:17.914735
Uttar Pradesh,1731,593704,8729,1647,593895,8737,604279,604164,2021-03-08 20:00:17.914735
West Bengal,3213,562945,10277,3163,563182,10278,576623,576435,2021-03-08 20:00:17.914735
Andaman and Nicobar Islands,7,4955,62,7,4957,62,5026,5024,2021-03-09 20:55:03.324630
Andhra Pradesh,998,882520,7174,1009,882581,7176,890766,890692,2021-03-09 20:55:03.324630
Arunachal Pradesh,3,16780,56,3,16780,56,16839,16839,2021-03-09 20:55:03.324630
Assam,1627,214947,1094,1624,214964,1094,217682,217668,2021-03-09 20:55:03.324630
Bihar,313,260899,1546,290,260942,1547,262779,262758,2021-03-09 20:55:03.324630
Chandigarh,710,21253,355,725,21316,356,22397,22318,2021-03-09 20:55:03.324630
Chhattisgarh,2820,307642,3858,2919,307862,3859,314640,314320,2021-03-09 20:55:03.324630
Dadra and Nagar Haveli and Daman and Diu,12,3402,2,17,3402,2,3421,3416,2021-03-09 20:55:03.324630
Delhi,1803,628377,10921,1730,628686,10924,641340,641101,2021-03-09 20:55:03.324630
Goa,688,53922,799,632,54032,799,55463,55409,2021-03-09 20:55:03.324630
Gujarat,3140,265831,4415,3212,266313,4416,273941,273386,2021-03-09 20:55:03.324630
Haryana,2031,267433,3056,2083,267610,3058,272751,272520,2021-03-09 20:55:03.324630
Himachal Pradesh,614,57507,997,617,57580,1000,59197,59118,2021-03-09 20:55:03.324630
Jammu and Kashmir,892,124190,1962,871,124280,1963,127114,127044,2021-03-09 20:55:03.324630
Jharkhand,463,118703,1093,472,118747,1093,120312,120259,2021-03-09 20:55:03.324630
Karnataka,6881,935772,12362,6834,936250,12367,955451,955015,2021-03-09 20:55:03.324630
Kerala,41162,1031865,4300,39532,1034895,4312,1078739,1077327,2021-03-09 20:55:03.324630
Ladakh,44,9657,130,44,9659,130,9833,9831,2021-03-09 20:55:03.324630
Lakshadweep,158,327,1,164,329,1,494,486,2021-03-09 20:55:03.324630
Madhya Pradesh,3606,257166,3871,3638,257560,3872,265070,264643,2021-03-09 20:55:03.324630
Maharashtra,99205,2068044,52478,98859,2077112,52500,2228471,2219727,2021-03-09 20:55:03.324630
Manipur,28,28890,373,29,28894,373,29296,29291,2021-03-09 20:55:03.324630
Meghalaya,13,13811,148,12,13813,148,13973,13972,2021-03-09 20:55:03.324630
Mizoram,8,4410,10,10,4412,10,4432,4428,2021-03-09 20:55:03.324630
Nagaland,20,12106,91,19,12107,91,12217,12217,2021-03-09 20:55:03.324630
Odisha,747,335080,1917,718,335168,1917,337803,337744,2021-03-09 20:55:03.324630
Puducherry,176,39022,670,171,39041,670,39882,39868,2021-03-09 20:55:03.324630
Punjab,7497,174967,5927,8020,175659,5941,189620,188391,2021-03-09 20:55:03.324630
Rajasthan,1755,316988,2789,1883,317039,2789,321711,321532,2021-03-09 20:55:03.324630
Sikkim,50,5989,135,50,5989,135,6174,6174,2021-03-09 20:55:03.324630
Tamil Nadu,3997,838606,12518,4018,839138,12521,855677,855121,2021-03-09 20:55:03.324630
Telengana,1807,296562,1642,1769,296740,1644,300153,300011,2021-03-09 20:55:03.324630
Tripura,30,33003,391,30,33003,391,33424,33424,2021-03-09 20:55:03.324630
Uttarakhand,632,95095,1695,662,95123,1695,97480,97422,2021-03-09 20:55:03.324630
Uttar Pradesh,1647,593895,8737,1634,594008,8738,604380,604279,2021-03-09 20:55:03.324630
West Bengal,3163,563182,10278,3155,563403,10280,576838,576623,2021-03-09 20:55:03.324630
Andaman and Nicobar Islands,7,4957,62,8,4958,62,5028,5026,2021-03-10 20:20:02.127477
Andhra Pradesh,1009,882581,7176,1038,882670,7176,890884,890766,2021-03-10 20:20:02.127477
Arunachal Pradesh,3,16780,56,3,16780,56,16839,16839,2021-03-10 20:20:02.127477
Assam,1624,214964,1094,1629,214979,1096,217704,217682,2021-03-10 20:20:02.127477
Bihar,290,260942,1547,298,260975,1547,262820,262779,2021-03-10 20:20:02.127477
Chandigarh,725,21316,356,778,21368,356,22502,22397,2021-03-10 20:20:02.127477
Chhattisgarh,2919,307862,3859,3023,308143,3864,315030,314640,2021-03-10 20:20:02.127477
Dadra and Nagar Haveli and Daman and Diu,17,3402,2,17,3404,2,3423,3421,2021-03-10 20:20:02.127477
Delhi,1730,628686,10924,1812,628920,10928,641660,641340,2021-03-10 20:20:02.127477
Goa,632,54032,799,663,54073,802,55538,55463,2021-03-10 20:20:02.127477
Gujarat,3212,266313,4416,3338,266766,4418,274522,273941,2021-03-10 20:20:02.127477
Haryana,2083,267610,3058,2263,267762,3062,273087,272751,2021-03-10 20:20:02.127477
Himachal Pradesh,617,57580,1000,621,57616,1002,59239,59197,2021-03-10 20:20:02.127477
Jammu and Kashmir,871,124280,1963,859,124367,1965,127191,127114,2021-03-10 20:20:02.127477
Jharkhand,472,118747,1093,494,118787,1093,120374,120312,2021-03-10 20:20:02.127477
Karnataka,6834,936250,12367,7052,936616,12373,956041,955451,2021-03-10 20:20:02.127477
Kerala,39532,1034895,4312,37446,1039281,4328,1081055,1078739,2021-03-10 20:20:02.127477
Ladakh,44,9659,130,43,9662,130,9835,9833,2021-03-10 20:20:02.127477
Lakshadweep,164,329,1,167,341,1,509,494,2021-03-10 20:20:02.127477
Madhya Pradesh,3638,257560,3872,3711,257942,3874,265527,265070,2021-03-10 20:20:02.127477
Maharashtra,98859,2077112,52500,96548,2089294,52556,2238398,2228471,2021-03-10 20:20:02.127477
Manipur,29,28894,373,30,28895,373,29298,29296,2021-03-10 20:20:02.127477
Meghalaya,12,13813,148,14,13815,148,13977,13973,2021-03-10 20:20:02.127477
Mizoram,10,4412,10,9,4415,10,4434,4432,2021-03-10 20:20:02.127477
Nagaland,19,12107,91,18,12108,91,12217,12217,2021-03-10 20:20:02.127477
Odisha,718,335168,1917,693,335250,1917,337860,337803,2021-03-10 20:20:02.127477
Puducherry,171,39041,670,178,39060,670,39908,39882,2021-03-10 20:20:02.127477
Punjab,8020,175659,5941,8522,176164,5961,190647,189620,2021-03-10 20:20:02.127477
Rajasthan,1883,317039,2789,1963,317138,2789,321890,321711,2021-03-10 20:20:02.127477
Sikkim,50,5989,135,50,5990,135,6175,6174,2021-03-10 20:20:02.127477
Tamil Nadu,4018,839138,12521,4073,839648,12525,856246,855677,2021-03-10 20:20:02.127477
Telengana,1769,296740,1644,1780,296916,1646,300342,300153,2021-03-10 20:20:02.127477
Tripura,30,33003,391,24,33010,391,33425,33424,2021-03-10 20:20:02.127477
Uttarakhand,662,95123,1695,611,95223,1695,97529,97480,2021-03-10 20:20:02.127477
Uttar Pradesh,1634,594008,8738,1678,594109,8740,604527,604380,2021-03-10 20:20:02.127477
West Bengal,3155,563403,10280,3144,563601,10281,577026,576838,2021-03-10 20:20:02.127477
Andaman and Nicobar Islands,8,4958,62,6,4960,62,5028,5028,2021-03-11 20:00:19.698342
Andhra Pradesh,1038,882670,7176,1064,882763,7177,891004,890884,2021-03-11 20:00:19.698342
Arunachal Pradesh,3,16780,56,4,16780,56,16840,16839,2021-03-11 20:00:19.698342
Assam,1629,214979,1096,1633,214997,1096,217726,217704,2021-03-11 20:00:19.698342
Bihar,298,260975,1547,303,261013,1548,262864,262820,2021-03-11 20:00:19.698342
Chandigarh,778,21368,356,816,21416,357,22589,22502,2021-03-11 20:00:19.698342
Chhattisgarh,3023,308143,3864,3345,308269,3872,315486,315030,2021-03-11 20:00:19.698342
Dadra and Nagar Haveli and Daman and Diu,17,3404,2,20,3404,2,3426,3423,2021-03-11 20:00:19.698342
Delhi,1812,628920,10928,1900,629199,10931,642030,641660,2021-03-11 20:00:19.698342
Goa,663,54073,802,675,54130,802,55607,55538,2021-03-11 20:00:19.698342
Gujarat,3338,266766,4418,3529,267250,4418,275197,274522,2021-03-11 20:00:19.698342
Haryana,2263,267762,3062,2440,267942,3064,273446,273087,2021-03-11 20:00:19.698342
Himachal Pradesh,621,57616,1002,599,57745,1003,59347,59239,2021-03-11 20:00:19.698342
Jammu and Kashmir,859,124367,1965,899,124421,1968,127288,127191,2021-03-11 20:00:19.698342
Jharkhand,494,118787,1093,520,118823,1093,120436,120374,2021-03-11 20:00:19.698342
Karnataka,7052,936616,12373,7475,936947,12379,956801,956041,2021-03-11 20:00:19.698342
Kerala,37446,1039281,4328,35715,1043473,4342,1083530,1081055,2021-03-11 20:00:19.698342
Ladakh,43,9662,130,39,9669,130,9838,9835,2021-03-11 20:00:19.698342
Lakshadweep,167,341,1,168,355,1,524,509,2021-03-11 20:00:19.698342
Madhya Pradesh,3711,257942,3874,3915,258251,3877,266043,265527,2021-03-11 20:00:19.698342
Maharashtra,96548,2089294,52556,100240,2099207,52610,2252057,2238398,2021-03-11 20:00:19.698342
Manipur,30,28895,373,35,28897,373,29305,29298,2021-03-11 20:00:19.698342
Meghalaya,14,13815,148,19,13816,148,13983,13977,2021-03-11 20:00:19.698342
Mizoram,9,4415,10,9,4415,10,4434,4434,2021-03-11 20:00:19.698342
Nagaland,18,12108,91,10,12116,91,12217,12217,2021-03-11 20:00:19.698342
Odisha,693,335250,1917,690,335322,1917,337929,337860,2021-03-11 20:00:19.698342
Puducherry,178,39060,670,179,39083,670,39932,39908,2021-03-11 20:00:19.698342
Punjab,8522,176164,5961,9402,176660,5978,192040,190647,2021-03-11 20:00:19.698342
Rajasthan,1963,317138,2789,2032,317257,2789,322078,321890,2021-03-11 20:00:19.698342
Sikkim,50,5990,135,49,5994,135,6178,6175,2021-03-11 20:00:19.698342
Tamil Nadu,4073,839648,12525,4207,840180,12530,856917,856246,2021-03-11 20:00:19.698342
Telengana,1780,296916,1646,1855,297032,1649,300536,300342,2021-03-11 20:00:19.698342
Tripura,24,33010,391,18,33016,391,33425,33425,2021-03-11 20:00:19.698342
Uttarakhand,611,95223,1695,600,95268,1697,97565,97529,2021-03-11 20:00:19.698342
Uttar Pradesh,1678,594109,8740,1689,594219,8740,604648,604527,2021-03-11 20:00:19.698342
West Bengal,3144,563601,10281,3127,563857,10283,577267,577026,2021-03-11 20:00:19.698342
Andaman and Nicobar Islands,6,4960,62,6,4960,62,5028,5028,2021-03-12 20:01:15.518209
Andhra Pradesh,1064,882763,7177,1158,882841,7179,891178,891004,2021-03-12 20:01:15.518209
Arunachal Pradesh,4,16780,56,4,16780,56,16840,16840,2021-03-12 20:01:15.518209
Assam,1633,214997,1096,1625,215023,1097,217745,217726,2021-03-12 20:01:15.518209
Bihar,303,261013,1548,324,261037,1548,262909,262864,2021-03-12 20:01:15.518209
Chandigarh,816,21416,357,859,21481,357,22697,22589,2021-03-12 20:01:15.518209
Chhattisgarh,3345,308269,3872,3537,308452,3875,315864,315486,2021-03-12 20:01:15.518209
Dadra and Nagar Haveli and Daman and Diu,20,3404,2,20,3404,2,3426,3426,2021-03-12 20:01:15.518209
Delhi,1900,629199,10931,2020,629485,10934,642439,642030,2021-03-12 20:01:15.518209
Goa,675,54130,802,704,54169,803,55676,55607,2021-03-12 20:01:15.518209
Gujarat,3529,267250,4418,3788,267701,4418,275907,275197,2021-03-12 20:01:15.518209
Haryana,2440,267942,3064,2679,268144,3065,273888,273446,2021-03-12 20:01:15.518209
Himachal Pradesh,599,57745,1003,662,57774,1003,59439,59347,2021-03-12 20:01:15.518209
Jammu and Kashmir,899,124421,1968,896,124498,1969,127363,127288,2021-03-12 20:01:15.518209
Jharkhand,520,118823,1093,511,118863,1093,120467,120436,2021-03-12 20:01:15.518209
Karnataka,7475,936947,12379,7820,937383,12381,957584,956801,2021-03-12 20:01:15.518209
Kerala,35715,1043473,4342,34082,1047226,4355,1085663,1083530,2021-03-12 20:01:15.518209
Ladakh,39,9669,130,41,9669,130,9840,9838,2021-03-12 20:01:15.518209
Lakshadweep,168,355,1,194,374,1,569,524,2021-03-12 20:01:15.518209
Madhya Pradesh,3915,258251,3877,4094,258598,3881,266573,266043,2021-03-12 20:01:15.518209
Maharashtra,100240,2099207,52610,107307,2106400,52667,2266374,2252057,2021-03-12 20:01:15.518209
Manipur,35,28897,373,36,28900,373,29309,29305,2021-03-12 20:01:15.518209
Meghalaya,19,13816,148,20,13817,148,13985,13983,2021-03-12 20:01:15.518209
Mizoram,9,4415,10,9,4416,10,4435,4434,2021-03-12 20:01:15.518209
Nagaland,10,12116,91,10,12116,91,12217,12217,2021-03-12 20:01:15.518209
Odisha,690,335322,1917,667,335408,1917,337992,337929,2021-03-12 20:01:15.518209
Puducherry,179,39083,670,176,39108,670,39954,39932,2021-03-12 20:01:15.518209
Punjab,9402,176660,5978,10069,177280,5996,193345,192040,2021-03-12 20:01:15.518209
Rajasthan,2032,317257,2789,2142,317350,2789,322281,322078,2021-03-12 20:01:15.518209
Sikkim,49,5994,135,50,5994,135,6179,6178,2021-03-12 20:01:15.518209
Tamil Nadu,4207,840180,12530,4344,840723,12535,857602,856917,2021-03-12 20:01:15.518209
Telengana,1855,297032,1649,1872,297195,1650,300717,300536,2021-03-12 20:01:15.518209
Tripura,18,33016,391,17,33017,391,33425,33425,2021-03-12 20:01:15.518209
Uttarakhand,600,95268,1697,642,95294,1698,97634,97565,2021-03-12 20:01:15.518209
Uttar Pradesh,1689,594219,8740,1742,594308,8741,604791,604648,2021-03-12 20:01:15.518209
West Bengal,3127,563857,10283,3110,564115,10286,577511,577267,2021-03-12 20:01:15.518209
Andaman and Nicobar Islands,6,4960,62,6,4961,62,5029,5028,2021-03-13 20:00:23.192295
Andhra Pradesh,1158,882841,7179,1227,882981,7180,891388,891178,2021-03-13 20:00:23.192295
Arunachal Pradesh,4,16780,56,4,16780,56,16840,16840,2021-03-13 20:00:23.192295
Assam,1625,215023,1097,1628,215041,1097,217766,217745,2021-03-13 20:00:23.192295
Bihar,324,261037,1548,324,261064,1549,262937,262909,2021-03-13 20:00:23.192295
Chandigarh,859,21481,357,936,21539,357,22832,22697,2021-03-13 20:00:23.192295
Chhattisgarh,3537,308452,3875,3577,308854,3880,316311,315864,2021-03-13 20:00:23.192295
Dadra and Nagar Haveli and Daman and Diu,20,3404,2,24,3405,2,3431,3426,2021-03-13 20:00:23.192295
Delhi,2020,629485,10934,2093,629841,10936,642870,642439,2021-03-13 20:00:23.192295
Goa,704,54169,803,745,54209,804,55758,55676,2021-03-13 20:00:23.192295
Gujarat,3788,267701,4418,4006,268196,4420,276622,275907,2021-03-13 20:00:23.192295
Haryana,2679,268144,3065,2807,268397,3069,274273,273888,2021-03-13 20:00:23.192295
Himachal Pradesh,662,57774,1003,706,57818,1003,59527,59439,2021-03-13 20:00:23.192295
Jammu and Kashmir,896,124498,1969,887,124578,1971,127436,127363,2021-03-13 20:00:23.192295
Jharkhand,511,118863,1093,509,118922,1093,120524,120467,2021-03-13 20:00:23.192295
Karnataka,7820,937383,12381,8133,937898,12386,958417,957584,2021-03-13 20:00:23.192295
Kerala,34082,1047226,4355,32471,1050603,4369,1087443,1085663,2021-03-13 20:00:23.192295
Ladakh,41,9669,130,30,9686,130,9846,9840,2021-03-13 20:00:23.192295
Lakshadweep,194,374,1,206,380,1,587,569,2021-03-13 20:00:23.192295
Madhya Pradesh,4094,258598,3881,4335,258958,3883,267176,266573,2021-03-13 20:00:23.192295
Maharashtra,107307,2106400,52667,111724,2117744,52723,2282191,2266374,2021-03-13 20:00:23.192295
Manipur,36,28900,373,30,28907,373,29310,29309,2021-03-13 20:00:23.192295
Meghalaya,20,13817,148,20,13818,148,13986,13985,2021-03-13 20:00:23.192295
Mizoram,9,4416,10,9,4416,10,4435,4435,2021-03-13 20:00:23.192295
Nagaland,10,12116,91,10,12120,91,12221,12217,2021-03-13 20:00:23.192295
Odisha,667,335408,1917,640,335499,1917,338056,337992,2021-03-13 20:00:23.192295
Puducherry,176,39108,670,186,39128,670,39984,39954,2021-03-13 20:00:23.192295
Punjab,10069,177280,5996,10452,178271,6030,194753,193345,2021-03-13 20:00:23.192295
Rajasthan,2142,317350,2789,2242,317487,2789,322518,322281,2021-03-13 20:00:23.192295
Sikkim,50,5994,135,54,5994,135,6183,6179,2021-03-13 20:00:23.192295
Tamil Nadu,4344,840723,12535,4483,841250,12539,858272,857602,2021-03-13 20:00:23.192295
Telengana,1872,297195,1650,1918,297363,1652,300933,300717,2021-03-13 20:00:23.192295
Tripura,17,33017,391,10,33026,391,33427,33425,2021-03-13 20:00:23.192295
Uttarakhand,642,95294,1698,638,95362,1700,97700,97634,2021-03-13 20:00:23.192295
Uttar Pradesh,1742,594308,8741,1819,594396,8743,604958,604791,2021-03-13 20:00:23.192295
West Bengal,3110,564115,10286,3133,564368,10287,577788,577511,2021-03-13 20:00:23.192295
Andaman and Nicobar Islands,6,4961,62,4,4964,62,5030,5029,2021-03-14 20:00:18.942626
Andhra Pradesh,1227,882981,7180,1268,883113,7182,891563,891388,2021-03-14 20:00:18.942626
Arunachal Pradesh,4,16780,56,3,16781,56,16840,16840,2021-03-14 20:00:18.942626
Assam,1628,215041,1097,1619,215063,1098,217780,217766,2021-03-14 20:00:18.942626
Bihar,324,261064,1549,332,261092,1550,262974,262937,2021-03-14 20:00:18.942626
Chandigarh,936,21539,357,1032,21586,358,22976,22832,2021-03-14 20:00:18.942626
Chhattisgarh,3577,308854,3880,3770,309198,3886,316854,316311,2021-03-14 20:00:18.942626
Dadra and Nagar Haveli and Daman and Diu,24,3405,2,28,3405,2,3435,3431,2021-03-14 20:00:18.942626
Delhi,2093,629841,10936,2207,630143,10939,643289,642870,2021-03-14 20:00:18.942626
Goa,745,54209,804,767,54279,805,55851,55758,2021-03-14 20:00:18.942626
Gujarat,4006,268196,4420,4200,268775,4422,277397,276622,2021-03-14 20:00:18.942626
Haryana,2807,268397,3069,2952,268672,3073,274697,274273,2021-03-14 20:00:18.942626
Himachal Pradesh,706,57818,1003,745,57848,1004,59597,59527,2021-03-14 20:00:18.942626
Jammu and Kashmir,887,124578,1971,881,124680,1974,127535,127436,2021-03-14 20:00:18.942626
Jharkhand,509,118922,1093,515,118959,1093,120567,120524,2021-03-14 20:00:18.942626
Karnataka,8133,937898,12386,8061,938890,12387,959338,958417,2021-03-14 20:00:18.942626
Kerala,32471,1050603,4369,31238,1053859,4381,1089478,1087443,2021-03-14 20:00:18.942626
Ladakh,30,9686,130,31,9686,130,9847,9846,2021-03-14 20:00:18.942626
Lakshadweep,206,380,1,208,394,1,603,587,2021-03-14 20:00:18.942626
Madhya Pradesh,4335,258958,3883,4512,259454,3885,267851,267176,2021-03-14 20:00:18.942626
Maharashtra,111724,2117744,52723,119771,2125211,52811,2297793,2282191,2021-03-14 20:00:18.942626
Manipur,30,28907,373,27,28911,373,29311,29310,2021-03-14 20:00:18.942626
Meghalaya,20,13818,148,26,13818,148,13992,13986,2021-03-14 20:00:18.942626
Mizoram,9,4416,10,10,4416,10,4436,4435,2021-03-14 20:00:18.942626
Nagaland,10,12120,91,14,12120,91,12225,12221,2021-03-14 20:00:18.942626
Odisha,640,335499,1917,634,335569,1918,338121,338056,2021-03-14 20:00:18.942626
Puducherry,186,39128,670,191,39154,670,40015,39984,2021-03-14 20:00:18.942626
Punjab,10452,178271,6030,10916,179295,6052,196263,194753,2021-03-14 20:00:18.942626
Rajasthan,2242,317487,2789,2329,317601,2789,322719,322518,2021-03-14 20:00:18.942626
Sikkim,54,5994,135,47,6002,135,6184,6183,2021-03-14 20:00:18.942626
Tamil Nadu,4483,841250,12539,4662,841762,12543,858967,858272,2021-03-14 20:00:18.942626
Telengana,1918,297363,1652,1993,297515,1653,301161,300933,2021-03-14 20:00:18.942626
Tripura,10,33026,391,12,33026,391,33429,33427,2021-03-14 20:00:18.942626
Uttarakhand,638,95362,1700,583,95469,1702,97754,97700,2021-03-14 20:00:18.942626
Uttar Pradesh,1819,594396,8743,1817,594550,8745,605112,604958,2021-03-14 20:00:18.942626
West Bengal,3133,564368,10287,3139,564637,10288,578064,577788,2021-03-14 20:00:18.942626
Andaman and Nicobar Islands,4,4964,62,5,4964,62,5031,5030,2021-03-15 20:00:20.231437
Andhra Pradesh,1268,883113,7182,1400,883277,7184,891861,891563,2021-03-15 20:00:20.231437
Arunachal Pradesh,3,16781,56,3,16781,56,16840,16840,2021-03-15 20:00:20.231437
Assam,1619,215063,1098,1619,215080,1098,217797,217780,2021-03-15 20:00:20.231437
Bihar,332,261092,1550,338,261136,1551,263025,262974,2021-03-15 20:00:20.231437
Chandigarh,1032,21586,358,1088,21650,358,23096,22976,2021-03-15 20:00:20.231437
Chhattisgarh,3770,309198,3886,4006,309433,3890,317329,316854,2021-03-15 20:00:20.231437
Dadra and Nagar Haveli and Daman and Diu,28,3405,2,31,3405,2,3438,3435,2021-03-15 20:00:20.231437
Delhi,2207,630143,10939,2262,630493,10941,643696,643289,2021-03-15 20:00:20.231437
Goa,767,54279,805,749,54362,806,55917,55851,2021-03-15 20:00:20.231437
Gujarat,4200,268775,4422,4422,269361,4424,278207,277397,2021-03-15 20:00:20.231437
Haryana,2952,268672,3073,3095,268968,3074,275137,274697,2021-03-15 20:00:20.231437
Himachal Pradesh,745,57848,1004,760,57909,1006,59675,59597,2021-03-15 20:00:20.231437
Jammu and Kashmir,881,124680,1974,920,124746,1974,127640,127535,2021-03-15 20:00:20.231437
Jharkhand,515,118959,1093,548,118987,1093,120628,120567,2021-03-15 20:00:20.231437
Karnataka,8061,938890,12387,8383,939499,12390,960272,959338,2021-03-15 20:00:20.231437
Kerala,31238,1053859,4381,29777,1057097,4396,1091270,1089478,2021-03-15 20:00:20.231437
Ladakh,31,9686,130,31,9686,130,9847,9847,2021-03-15 20:00:20.231437
Lakshadweep,208,394,1,203,400,1,604,603,2021-03-15 20:00:20.231437
Madhya Pradesh,4512,259454,3885,4740,259967,3887,268594,267851,2021-03-15 20:00:20.231437
Maharashtra,119771,2125211,52811,127480,2134072,52861,2314413,2297793,2021-03-15 20:00:20.231437
Manipur,27,28911,373,26,28914,373,29313,29311,2021-03-15 20:00:20.231437
Meghalaya,26,13818,148,29,13820,148,13997,13992,2021-03-15 20:00:20.231437
Mizoram,10,4416,10,11,4416,10,4437,4436,2021-03-15 20:00:20.231437
Nagaland,14,12120,91,14,12120,91,12225,12225,2021-03-15 20:00:20.231437
Odisha,634,335569,1918,614,335660,1918,338192,338121,2021-03-15 20:00:20.231437
Puducherry,191,39154,670,190,39169,671,40030,40015,2021-03-15 20:00:20.231437
Punjab,10916,179295,6052,11550,180133,6072,197755,196263,2021-03-15 20:00:20.231437
Rajasthan,2329,317601,2789,2453,317726,2790,322969,322719,2021-03-15 20:00:20.231437
Sikkim,47,6002,135,46,6003,135,6184,6184,2021-03-15 20:00:20.231437
Tamil Nadu,4662,841762,12543,4870,842309,12547,859726,858967,2021-03-15 20:00:20.231437
Telengana,1993,297515,1653,1983,297681,1654,301318,301161,2021-03-15 20:00:20.231437
Tripura,12,33026,391,13,33029,391,33433,33429,2021-03-15 20:00:20.231437
Uttarakhand,583,95469,1702,609,95494,1703,97806,97754,2021-03-15 20:00:20.231437
Uttar Pradesh,1817,594550,8745,1851,594693,8746,605290,605112,2021-03-15 20:00:20.231437
West Bengal,3139,564637,10288,3143,564912,10292,578347,578064,2021-03-15 20:00:20.231437
Andaman and Nicobar Islands,5,4964,62,3,4966,62,5031,5031,2021-03-16 20:34:39.841264
Andhra Pradesh,1400,883277,7184,1443,883380,7185,892008,891861,2021-03-16 20:34:39.841264
Arunachal Pradesh,3,16781,56,1,16783,56,16840,16840,2021-03-16 20:34:39.841264
Assam,1619,215080,1098,1612,215106,1099,217817,217797,2021-03-16 20:34:39.841264
Bihar,338,261136,1551,328,261171,1552,263051,263025,2021-03-16 20:34:39.841264
Chandigarh,1088,21650,358,1166,21720,358,23244,23096,2021-03-16 20:34:39.841264
Chhattisgarh,4006,309433,3890,4098,309979,3897,317974,317329,2021-03-16 20:34:39.841264
Dadra and Nagar Haveli and Daman and Diu,31,3405,2,31,3407,2,3440,3438,2021-03-16 20:34:39.841264
Delhi,2262,630493,10941,2321,630799,10944,644064,643696,2021-03-16 20:34:39.841264
Goa,749,54362,806,775,54424,807,56006,55917,2021-03-16 20:34:39.841264
Gujarat,4422,269361,4424,4717,269955,4425,279097,278207,2021-03-16 20:34:39.841264
Haryana,3095,268968,3074,3212,269268,3077,275557,275137,2021-03-16 20:34:39.841264
Himachal Pradesh,760,57909,1006,757,57983,1010,59750,59675,2021-03-16 20:34:39.841264
Jammu and Kashmir,920,124746,1974,937,124823,1974,127734,127640,2021-03-16 20:34:39.841264
Jharkhand,548,118987,1093,556,119046,1093,120695,120628,2021-03-16 20:34:39.841264
Karnataka,8383,939499,12390,8879,939928,12397,961204,960272,2021-03-16 20:34:39.841264
Kerala,29777,1057097,4396,27357,1060560,4407,1092324,1091270,2021-03-16 20:34:39.841264
Ladakh,31,9686,130,34,9688,130,9852,9847,2021-03-16 20:34:39.841264
Lakshadweep,203,400,1,189,416,1,606,604,2021-03-16 20:34:39.841264
Madhya Pradesh,4740,259967,3887,5024,260477,3890,269391,268594,2021-03-16 20:34:39.841264
Maharashtra,127480,2134072,52861,131812,2144743,52909,2329464,2314413,2021-03-16 20:34:39.841264
Manipur,26,28914,373,24,28916,373,29313,29313,2021-03-16 20:34:39.841264
Meghalaya,29,13820,148,29,13820,148,13997,13997,2021-03-16 20:34:39.841264
Mizoram,11,4416,10,12,4417,10,4439,4437,2021-03-16 20:34:39.841264
Nagaland,14,12120,91,14,12120,91,12225,12225,2021-03-16 20:34:39.841264
Odisha,614,335660,1918,610,335730,1918,338258,338192,2021-03-16 20:34:39.841264
Puducherry,190,39169,671,186,39186,672,40044,40030,2021-03-16 20:34:39.841264
Punjab,11550,180133,6072,11942,181532,6099,199573,197755,2021-03-16 20:34:39.841264
Rajasthan,2453,317726,2790,2572,317858,2790,323220,322969,2021-03-16 20:34:39.841264
Sikkim,46,6003,135,41,6008,135,6184,6184,2021-03-16 20:34:39.841264
Tamil Nadu,4870,842309,12547,5149,842862,12551,860562,859726,2021-03-16 20:34:39.841264
Telengana,1983,297681,1654,2015,297851,1656,301522,301318,2021-03-16 20:34:39.841264
Tripura,13,33029,391,20,33029,391,33440,33433,2021-03-16 20:34:39.841264
Uttarakhand,609,95494,1703,581,95581,1704,97866,97806,2021-03-16 20:34:39.841264
Uttar Pradesh,1851,594693,8746,1838,594855,8748,605441,605290,2021-03-16 20:34:39.841264
West Bengal,3143,564912,10292,3147,565156,10295,578598,578347,2021-03-16 20:34:39.841264
Andaman and Nicobar Islands,147,4966,62,152,3469,52,3673,5031,2021-03-17 17:39:44
Andhra Pradesh,78836,883380,7185,74518,551821,5410,631749,892008,2021-03-17 17:39:44
Arunachal Pradesh,1964,16783,56,1939,5643,13,7595,16840,2021-03-17 17:39:44
Assam,28780,215106,1099,29609,129133,578,159320,217817,2021-03-17 17:39:44
Bihar,13005,261171,1552,12539,156242,870,169651,263051,2021-03-17 17:39:44
Chandigarh,2821,21720,358,2761,7411,126,10298,23244,2021-03-17 17:39:44
Chhattisgarh,37853,309979,3897,37927,49564,690,88181,317974,2021-03-17 17:39:44
Dadra and Nagar Haveli and Daman and Diu,229,3407,2,220,2711,2,2933,3440,2021-03-17 17:39:44
Delhi,32097,630799,10944,30941,213304,5014,249259,644064,2021-03-17 17:39:44
Goa,5781,54424,807,5667,22726,360,28753,56006,2021-03-17 17:39:44
Gujarat,16208,269955,4425,16305,104964,3336,124605,279097,2021-03-17 17:39:44
Haryana,21411,269268,3077,21014,90884,1177,113075,275557,2021-03-17 17:39:44
Himachal Pradesh,4444,57983,1010,4458,7853,127,12438,59750,2021-03-17 17:39:44
Jammu and Kashmir,22032,124823,1974,21887,42115,1024,65026,127734,2021-03-17 17:39:44
Jharkhand,13791,119046,1093,13504,58543,626,72673,120695,2021-03-17 17:39:44
Karnataka,98062,939928,12397,95354,423377,8145,526876,961204,2021-03-17 17:39:44
Kerala,39484,1060560,4407,39354,98724,553,138631,1092324,2021-03-17 17:39:44
Ladakh,1013,9688,130,1047,2735,50,3832,9852,2021-03-17 17:39:44
Lakshadweep,0,416,1,0,0,0,0,606,2021-03-17 17:39:44
Madhya Pradesh,22300,260477,3890,22542,83618,2007,108167,269391,2021-03-17 17:39:44
Maharashtra,291630,2144743,52909,275017,916348,33015,1224380,2329464,2021-03-17 17:39:44
Manipur,2070,28916,373,2113,6838,59,9010,29313,2021-03-17 17:39:44
Meghalaya,2111,13820,148,2169,2527,37,4733,13997,2021-03-17 17:39:44
Mizoram,583,4417,10,680,1012,0,1692,4439,2021-03-17 17:39:44
Nagaland,1184,12120,91,1052,4477,15,5544,12225,2021-03-17 17:39:44
Odisha,33504,335730,1918,34033,149379,710,184122,338258,2021-03-17 17:39:44
Puducherry,4908,39186,672,4659,18065,467,23191,40044,2021-03-17 17:39:44
Punjab,22278,181532,6099,21661,75409,2860,99930,199573,2021-03-17 17:39:44
Rajasthan,18184,317858,2790,18245,97284,1352,116881,323220,2021-03-17 17:39:44
Sikkim,469,6008,135,513,1986,29,2528,6184,2021-03-17 17:39:44
Tamil Nadu,46703,842862,12551,46495,491971,8871,547337,860562,2021-03-17 17:39:44
Telengana,29636,297851,1656,29649,144073,1052,174774,301522,2021-03-17 17:39:44
Tripura,6566,33029,391,6700,15883,251,22834,33440,2021-03-17 17:39:44
Uttarakhand,12455,594855,8748,12075,29201,501,41777,605441,2021-03-17 17:39:44
Uttar Pradesh,65954,95581,1704,64164,289594,5135,358893,97866,2021-03-17 17:39:44
West Bengal,24806,565156,10295,24898,198983,4421,228302,578598,2021-03-17 17:39:44
Andaman and Nicobar Islands,147,4967,62,152,3469,52,3673,5032,2021-03-18 17:39:44
Andhra Pradesh,78836,883505,7185,74518,551821,5410,631749,892269,2021-03-18 17:39:44
Arunachal Pradesh,1964,16783,56,1939,5643,13,7595,16841,2021-03-18 17:39:44
Assam,28780,215127,1099,29609,129133,578,159320,217839,2021-03-18 17:39:44
Bihar,13005,261200,1553,12539,156242,870,169651,263100,2021-03-18 17:39:44
Chandigarh,2821,21833,359,2761,7411,126,10298,23391,2021-03-18 17:39:44
Chhattisgarh,37853,310260,3909,37927,49564,690,88181,318830,2021-03-18 17:39:44
Dadra and Nagar Haveli and Daman and Diu,229,3416,2,220,2711,2,2933,3445,2021-03-18 17:39:44
Delhi,32097,631056,10945,30941,213304,5014,249259,644489,2021-03-18 17:39:44
Goa,5781,54497,811,5667,22726,360,28753,56100,2021-03-18 17:39:44
Gujarat,16208,270658,4427,16305,104964,3336,124605,280051,2021-03-18 17:39:44
Haryana,21411,269517,3079,21014,90884,1177,113075,276080,2021-03-18 17:39:44
Himachal Pradesh,4444,58038,1011,4458,7853,127,12438,59869,2021-03-18 17:39:44
Jammu and Kashmir,22032,124882,1976,21887,42115,1024,65026,127831,2021-03-18 17:39:44
Jharkhand,13791,119100,1094,13504,58543,626,72673,120771,2021-03-18 17:39:44
Karnataka,98062,940489,12403,95354,423377,8145,526876,962339,2021-03-18 17:39:44
Kerala,39484,1063444,4422,39354,98724,553,138631,1094294,2021-03-18 17:39:44
Ladakh,1013,9690,130,1047,2735,50,3832,9863,2021-03-18 17:39:44
Lakshadweep,0,457,1,0,0,0,0,625,2021-03-18 17:39:44
Madhya Pradesh,22300,261031,3891,22542,83618,2007,108167,270208,2021-03-18 17:39:44
Maharashtra,291630,2154253,52996,275017,916348,33015,1224380,2347328,2021-03-18 17:39:44
Manipur,2070,28918,373,2113,6838,59,9010,29315,2021-03-18 17:39:44
Meghalaya,2111,13821,148,2169,2527,37,4733,14000,2021-03-18 17:39:44
Mizoram,583,4417,10,680,1012,0,1692,4442,2021-03-18 17:39:44
Nagaland,1184,12120,91,1052,4477,15,5544,12225,2021-03-18 17:39:44
Odisha,33504,335796,1918,34033,149379,710,184122,338323,2021-03-18 17:39:44
Puducherry,4908,39215,673,4659,18065,467,23191,40068,2021-03-18 17:39:44
Punjab,22278,182283,6137,21661,75409,2860,99930,201036,2021-03-18 17:39:44
Rajasthan,18184,318009,2791,18245,97284,1352,116881,323461,2021-03-18 17:39:44
Sikkim,469,6012,135,513,1986,29,2528,6191,2021-03-18 17:39:44
Tamil Nadu,46703,843423,12556,46495,491971,8871,547337,861429,2021-03-18 17:39:44
Telengana,29636,298009,1659,29649,144073,1052,174774,301769,2021-03-18 17:39:44
Tripura,6566,33039,391,6700,15883,251,22834,33441,2021-03-18 17:39:44
Uttarakhand,12455,594993,8750,12075,29201,501,41777,605655,2021-03-18 17:39:44
Uttar Pradesh,65954,95628,1704,64164,289594,5135,358893,97931,2021-03-18 17:39:44
West Bengal,24806,565398,10297,24898,198983,4421,228302,578853,2021-03-18 17:39:44
Andaman and Nicobar Islands,147,4967,62,152,3469,52,3673,5035,2021-03-19 17:39:44
Andhra Pradesh,78836,883642,7186,74518,551821,5410,631749,892522,2021-03-19 17:39:44
Arunachal Pradesh,1964,16783,56,1939,5643,13,7595,16841,2021-03-19 17:39:44
Assam,28780,215146,1099,29609,129133,578,159320,217872,2021-03-19 17:39:44
Bihar,13005,261240,1554,12539,156242,870,169651,263158,2021-03-19 17:39:44
Chandigarh,2821,21903,359,2761,7411,126,10298,23592,2021-03-19 17:39:44
Chhattisgarh,37853,310503,3915,37927,49564,690,88181,319717,2021-03-19 17:39:44
Dadra and Nagar Haveli and Daman and Diu,229,3417,2,220,2711,2,2933,3445,2021-03-19 17:39:44
Delhi,32097,631375,10948,30941,213304,5014,249259,645025,2021-03-19 17:39:44
Goa,5781,54556,812,5667,22726,360,28753,56173,2021-03-19 17:39:44
Gujarat,16208,271433,4430,16305,104964,3336,124605,281173,2021-03-19 17:39:44
Haryana,21411,269812,3083,21014,90884,1177,113075,276635,2021-03-19 17:39:44
Himachal Pradesh,4444,58090,1011,4458,7853,127,12438,60036,2021-03-19 17:39:44
Jammu and Kashmir,22032,124972,1977,21887,42115,1024,65026,127957,2021-03-19 17:39:44
Jharkhand,13791,119160,1094,13504,58543,626,72673,120853,2021-03-19 17:39:44
Karnataka,98062,940968,12407,95354,423377,8145,526876,963614,2021-03-19 17:39:44
Kerala,39484,1066259,4435,39354,98724,553,138631,1096392,2021-03-19 17:39:44
Ladakh,1013,9691,130,1047,2735,50,3832,9865,2021-03-19 17:39:44
Lakshadweep,0,459,1,0,0,0,0,639,2021-03-19 17:39:44
Madhya Pradesh,22300,261531,3893,22542,83618,2007,108167,271040,2021-03-19 17:39:44
Maharashtra,291630,2163391,53080,275017,916348,33015,1224380,2370507,2021-03-19 17:39:44
Manipur,2070,28922,373,2113,6838,59,9010,29323,2021-03-19 17:39:44
Meghalaya,2111,13824,148,2169,2527,37,4733,14002,2021-03-19 17:39:44
Mizoram,583,4417,11,680,1012,0,1692,4445,2021-03-19 17:39:44
Nagaland,1184,12127,91,1052,4477,15,5544,12225,2021-03-19 17:39:44
Odisha,33504,335857,1918,34033,149379,710,184122,338405,2021-03-19 17:39:44
Puducherry,4908,39233,673,4659,18065,467,23191,40120,2021-03-19 17:39:44
Punjab,22278,183557,6172,21661,75409,2860,99930,203049,2021-03-19 17:39:44
Rajasthan,18184,318132,2791,18245,97284,1352,116881,323774,2021-03-19 17:39:44
Sikkim,469,6013,135,513,1986,29,2528,6194,2021-03-19 17:39:44
Tamil Nadu,46703,843999,12564,46495,491971,8871,547337,862374,2021-03-19 17:39:44
Telengana,29636,298120,1662,29649,144073,1052,174774,302047,2021-03-19 17:39:44
Tripura,6566,33041,391,6700,15883,251,22834,33444,2021-03-19 17:39:44
Uttarakhand,12455,595150,8751,12075,29201,501,41777,605915,2021-03-19 17:39:44
Uttar Pradesh,65954,95665,1704,64164,289594,5135,358893,98041,2021-03-19 17:39:44
West Bengal,24806,565670,10298,24898,198983,4421,228302,579156,2021-03-19 17:39:44
Andaman and Nicobar Islands,5,4969,62,7,4969,62,5038,5036,2021-03-20 20:25:42.784976
Andhra Pradesh,1795,883759,7186,1909,883890,7187,892986,892740,2021-03-20 20:25:42.784976
Arunachal Pradesh,3,16783,56,3,16783,56,16842,16842,2021-03-20 20:25:42.784976
Assam,1645,215160,1100,1641,215183,1100,217924,217905,2021-03-20 20:25:42.784976
Bihar,406,261304,1555,437,261362,1556,263355,263265,2021-03-20 20:25:42.784976
Chandigarh,1466,21978,359,1597,22060,360,24017,23803,2021-03-20 20:25:42.784976
Chhattisgarh,6025,310838,3920,6753,311198,3929,321880,320783,2021-03-20 20:25:42.784976
Dadra and Nagar Haveli and Daman and Diu,30,3422,2,38,3424,2,3464,3454,2021-03-20 20:25:42.784976
Delhi,2927,631756,10949,3165,632230,10953,646348,645632,2021-03-20 20:25:42.784976
Goa,861,54597,813,899,54657,815,56371,56271,2021-03-20 20:25:42.784976
Gujarat,5684,272332,4433,6147,273280,4437,283864,282449,2021-03-20 20:25:42.784976
Haryana,3957,270222,3089,4380,270670,3090,278140,277268,2021-03-20 20:25:42.784976
Himachal Pradesh,1043,58151,1013,1124,58249,1016,60389,60207,2021-03-20 20:25:42.784976
Jammu and Kashmir,1073,125046,1978,1152,125118,1979,128249,128097,2021-03-20 20:25:42.784976
Jharkhand,624,119232,1094,653,119307,1095,121055,120950,2021-03-20 20:25:42.784976
Karnataka,11378,941309,12415,12086,942178,12425,966689,965102,2021-03-20 20:25:42.784976
Kerala,25463,1068378,4450,25465,1070343,4467,1100275,1098291,2021-03-20 20:25:42.784976
Ladakh,51,9695,130,53,9698,130,9881,9876,2021-03-20 20:25:42.784976
Lakshadweep,173,470,1,157,489,1,647,644,2021-03-20 20:25:42.784976
Madhya Pradesh,6032,262031,3894,6609,262587,3901,273097,271957,2021-03-20 20:25:42.784976
Maharashtra,167637,2175565,53138,178848,2189965,53208,2422021,2396340,2021-03-20 20:25:42.784976
Manipur,28,28924,373,24,28929,373,29326,29325,2021-03-20 20:25:42.784976
Meghalaya,32,13825,148,31,13829,148,14008,14005,2021-03-20 20:25:42.784976
Mizoram,13,4421,11,14,4421,11,4446,4445,2021-03-20 20:25:42.784976
Nagaland,7,12127,91,2,12132,91,12225,12225,2021-03-20 20:25:42.784976
Odisha,648,335923,1918,687,335994,1918,338599,338489,2021-03-20 20:25:42.784976
Puducherry,6,39521,674,67,39521,674,40262,40201,2021-03-20 20:25:42.784976
Punjab,14366,184848,6204,15459,186187,6242,207888,205418,2021-03-20 20:25:42.784976
Rajasthan,3023,318284,2794,3121,318586,2796,324503,324101,2021-03-20 20:25:42.784976
Sikkim,48,6013,135,49,6015,135,6199,6196,2021-03-20 20:25:42.784976
Tamil Nadu,6222,844568,12573,6690,845178,12582,864450,863363,2021-03-20 20:25:42.784976
Telengana,2434,298262,1664,2607,298451,1666,302724,302360,2021-03-20 20:25:42.784976
Tripura,21,33042,391,25,33043,391,33459,33454,2021-03-20 20:25:42.784976
Uttarakhand,698,95727,1704,728,95796,1704,98228,98129,2021-03-20 20:25:42.784976
Uttar Pradesh,2217,595259,8753,2470,595382,8757,606609,606229,2021-03-20 20:25:42.784976
West Bengal,3241,565938,10300,3297,566228,10301,579826,579479,2021-03-20 20:25:42.784976
Andaman and Nicobar Islands,7,4969,62,7,4969,62,5038,5038,2021-03-21 20:32:36.334867
Andhra Pradesh,1909,883890,7187,2083,884094,7189,893366,892986,2021-03-21 20:32:36.334867
Arunachal Pradesh,3,16783,56,3,16783,56,16842,16842,2021-03-21 20:32:36.334867
Assam,1641,215183,1100,1650,215201,1100,217951,217924,2021-03-21 20:32:36.334867
Bihar,437,261362,1556,473,261413,1557,263443,263355,2021-03-21 20:32:36.334867
Chandigarh,1597,22060,360,1717,22142,361,24220,24017,2021-03-21 20:32:36.334867
Chhattisgarh,6753,311198,3929,7693,311520,3940,323153,321880,2021-03-21 20:32:36.334867
Dadra and Nagar Haveli and Daman and Diu,38,3424,2,44,3425,2,3471,3464,2021-03-21 20:32:36.334867
Delhi,3165,632230,10953,3409,632797,10955,647161,646348,2021-03-21 20:32:36.334867
Goa,899,54657,815,997,54713,815,56525,56371,2021-03-21 20:32:36.334867
Gujarat,6147,273280,4437,6737,274249,4443,285429,283864,2021-03-21 20:32:36.334867
Haryana,4380,270670,3090,4830,271038,3093,278961,278140,2021-03-21 20:32:36.334867
Himachal Pradesh,1124,58249,1016,1199,58321,1017,60537,60389,2021-03-21 20:32:36.334867
Jammu and Kashmir,1152,125118,1979,1191,125218,1980,128389,128249,2021-03-21 20:32:36.334867
Jharkhand,653,119307,1095,722,119361,1095,121178,121055,2021-03-21 20:32:36.334867
Karnataka,12086,942178,12425,12847,943208,12432,968487,966689,2021-03-21 20:32:36.334867
Kerala,25465,1070343,4467,25317,1072554,4482,1102353,1100275,2021-03-21 20:32:36.334867
Ladakh,53,9698,130,73,9703,130,9906,9881,2021-03-21 20:32:36.334867
Lakshadweep,157,489,1,136,511,1,648,647,2021-03-21 20:32:36.334867
Madhya Pradesh,6609,262587,3901,7344,263158,3903,274405,273097,2021-03-21 20:32:36.334867
Maharashtra,178848,2189965,53208,192294,2203553,53300,2449147,2422021,2021-03-21 20:32:36.334867
Manipur,24,28929,373,28,28931,373,29332,29326,2021-03-21 20:32:36.334867
Meghalaya,31,13829,148,28,13835,149,14012,14008,2021-03-21 20:32:36.334867
Mizoram,14,4421,11,15,4421,11,4447,4446,2021-03-21 20:32:36.334867
Nagaland,2,12132,91,2,12132,91,12225,12225,2021-03-21 20:32:36.334867
Odisha,687,335994,1918,735,336066,1918,338719,338599,2021-03-21 20:32:36.334867
Puducherry,67,39521,674,127,39521,674,40322,40262,2021-03-21 20:32:36.334867
Punjab,15459,186187,6242,16988,187198,6280,210466,207888,2021-03-21 20:32:36.334867
Rajasthan,3121,318586,2796,3310,318842,2796,324948,324503,2021-03-21 20:32:36.334867
Sikkim,49,6015,135,53,6016,135,6204,6199,2021-03-21 20:32:36.334867
Tamil Nadu,6690,845178,12582,7291,845812,12590,865693,864450,2021-03-21 20:32:36.334867
Telengana,2607,298451,1666,2804,298645,1669,303118,302724,2021-03-21 20:32:36.334867
Tripura,25,33043,391,30,33043,391,33464,33459,2021-03-21 20:32:36.334867
Uttarakhand,728,95796,1704,756,95851,1704,98311,98228,2021-03-21 20:32:36.334867
Uttar Pradesh,2470,595382,8757,2774,595518,8758,607050,606609,2021-03-21 20:32:36.334867
West Bengal,3297,566228,10301,3380,566526,10303,580209,579826,2021-03-21 20:32:36.334867
Andaman and Nicobar Islands,7,4969,62,8,4969,62,5039,5038,2021-03-22 21:58:23.994232
Andhra Pradesh,2083,884094,7189,2188,884357,7189,893734,893366,2021-03-22 21:58:23.994232
Arunachal Pradesh,3,16783,56,3,16783,56,16842,16842,2021-03-22 21:58:23.994232
Assam,1650,215201,1100,1663,215213,1100,217976,217951,2021-03-22 21:58:23.994232
Bihar,473,261413,1557,523,261487,1559,263569,263443,2021-03-22 21:58:23.994232
Chandigarh,1717,22142,361,1872,22225,362,24459,24220,2021-03-22 21:58:23.994232
Chhattisgarh,7693,311520,3940,8442,311761,3950,324153,323153,2021-03-22 21:58:23.994232
Dadra and Nagar Haveli and Daman and Diu,44,3425,2,52,3427,2,3481,3471,2021-03-22 21:58:23.994232
Delhi,3409,632797,10955,3618,633410,10956,647984,647161,2021-03-22 21:58:23.994232
Goa,997,54713,815,1013,54792,818,56623,56525,2021-03-22 21:58:23.994232
Gujarat,6737,274249,4443,7321,275238,4450,287009,285429,2021-03-22 21:58:23.994232
Haryana,4830,271038,3093,5355,271375,3098,279828,278961,2021-03-22 21:58:23.994232
Himachal Pradesh,1199,58321,1017,1256,58404,1018,60678,60537,2021-03-22 21:58:23.994232
Jammu and Kashmir,1191,125218,1980,1290,125276,1981,128547,128389,2021-03-22 21:58:23.994232
Jharkhand,722,119361,1095,756,119409,1096,121261,121178,2021-03-22 21:58:23.994232
Karnataka,12847,943208,12432,13512,944256,12434,970202,968487,2021-03-22 21:58:23.994232
Kerala,25317,1072554,4482,24928,1074805,4495,1104228,1102353,2021-03-22 21:58:23.994232
Ladakh,73,9703,130,74,9704,130,9908,9906,2021-03-22 21:58:23.994232
Lakshadweep,136,511,1,129,536,1,666,648,2021-03-22 21:58:23.994232
Madhya Pradesh,7344,263158,3903,8000,263821,3906,275727,274405,2021-03-22 21:58:23.994232
Maharashtra,192294,2203553,53300,211416,2214867,53399,2479682,2449147,2021-03-22 21:58:23.994232
Manipur,28,28931,373,29,28933,373,29335,29332,2021-03-22 21:58:23.994232
Meghalaya,28,13835,149,30,13837,149,14016,14012,2021-03-22 21:58:23.994232
Mizoram,15,4421,11,14,4423,11,4448,4447,2021-03-22 21:58:23.994232
Nagaland,2,12132,91,2,12132,91,12225,12225,2021-03-22 21:58:23.994232
Odisha,735,336066,1918,774,336124,1919,338817,338719,2021-03-22 21:58:23.994232
Puducherry,127,39521,674,190,39521,675,40386,40322,2021-03-22 21:58:23.994232
Punjab,16988,187198,6280,18257,188529,6324,213110,210466,2021-03-22 21:58:23.994232
Rajasthan,3310,318842,2796,3585,319041,2798,325424,324948,2021-03-22 21:58:23.994232
Sikkim,53,6016,135,54,6017,135,6206,6204,2021-03-22 21:58:23.994232
Tamil Nadu,7291,845812,12590,7903,846480,12599,866982,865693,2021-03-22 21:58:23.994232
Telengana,2804,298645,1669,2958,298826,1671,303455,303118,2021-03-22 21:58:23.994232
Tripura,30,33043,391,30,33043,391,33464,33464,2021-03-22 21:58:23.994232
Uttarakhand,756,95851,1704,861,95883,1704,98448,98311,2021-03-22 21:58:23.994232
Uttar Pradesh,2774,595518,8758,3036,595743,8759,607538,607050,2021-03-22 21:58:23.994232
West Bengal,3380,566526,10303,3504,566821,10306,580631,580209,2021-03-22 21:58:23.994232
Andaman and Nicobar Islands,8,4969,62,8,4969,62,5039,5039,2021-03-23 20:43:39.730262
Andhra Pradesh,2188,884357,7189,2382,884471,7191,894044,893734,2021-03-23 20:43:39.730262
Arunachal Pradesh,3,16783,56,2,16784,56,16842,16842,2021-03-23 20:43:39.730262
Assam,1663,215213,1100,1670,215235,1101,218006,217976,2021-03-23 20:43:39.730262
Bihar,523,261487,1559,561,261537,1561,263659,263569,2021-03-23 20:43:39.730262
Chandigarh,1872,22225,362,1979,22325,363,24667,24459,2021-03-23 20:43:39.730262
Chhattisgarh,8442,311761,3950,9205,312511,3962,325678,324153,2021-03-23 20:43:39.730262
Dadra and Nagar Haveli and Daman and Diu,52,3427,2,52,3431,2,3485,3481,2021-03-23 20:43:39.730262
Delhi,3618,633410,10956,3934,633975,10963,648872,647984,2021-03-23 20:43:39.730262
Goa,1013,54792,818,1017,54873,818,56708,56623,2021-03-23 20:43:39.730262
Gujarat,7321,275238,4450,7847,276348,4454,288649,287009,2021-03-23 20:43:39.730262
Haryana,5355,271375,3098,5698,271894,3101,280693,279828,2021-03-23 20:43:39.730262
Himachal Pradesh,1256,58404,1018,1385,58472,1021,60878,60678,2021-03-23 20:43:39.730262
Jammu and Kashmir,1290,125276,1981,1336,125362,1981,128679,128547,2021-03-23 20:43:39.730262
Jharkhand,756,119409,1096,796,119478,1097,121371,121261,2021-03-23 20:43:39.730262
Karnataka,13512,944256,12434,14286,944917,12444,971647,970202,2021-03-23 20:43:39.730262
Kerala,24928,1074805,4495,24389,1076571,4507,1105467,1104228,2021-03-23 20:43:39.730262
Ladakh,74,9704,130,83,9707,130,9920,9908,2021-03-23 20:43:39.730262
Lakshadweep,129,536,1,109,581,1,691,666,2021-03-23 20:43:39.730262
Madhya Pradesh,8000,263821,3906,8592,264575,3908,277075,275727,2021-03-23 20:43:39.730262
Maharashtra,211416,2214867,53399,216540,2234330,53457,2504327,2479682,2021-03-23 20:43:39.730262
Manipur,29,28933,373,33,28933,373,29339,29335,2021-03-23 20:43:39.730262
Meghalaya,30,13837,149,29,13838,149,14016,14016,2021-03-23 20:43:39.730262
Mizoram,14,4423,11,17,4423,11,4451,4448,2021-03-23 20:43:39.730262
Nagaland,2,12132,91,2,12132,91,12225,12225,2021-03-23 20:43:39.730262
Odisha,774,336124,1919,838,336206,1919,338963,338817,2021-03-23 20:43:39.730262
Puducherry,190,39521,675,236,39521,676,40433,40386,2021-03-23 20:43:39.730262
Punjab,18257,188529,6324,18628,190399,6382,215409,213110,2021-03-23 20:43:39.730262
Rajasthan,3585,319041,2798,4006,319217,2803,326026,325424,2021-03-23 20:43:39.730262
Sikkim,54,6017,135,49,6022,135,6206,6206,2021-03-23 20:43:39.730262
Tamil Nadu,7903,846480,12599,8619,847139,12609,868367,866982,2021-03-23 20:43:39.730262
Telengana,2958,298826,1671,3151,299042,1674,303867,303455,2021-03-23 20:43:39.730262
Tripura,30,33043,391,34,33044,392,33470,33464,2021-03-23 20:43:39.730262
Uttarakhand,861,95883,1704,894,95954,1704,98552,98448,2021-03-23 20:43:39.730262
Uttar Pradesh,3036,595743,8759,3396,595920,8760,608076,607538,2021-03-23 20:43:39.730262
West Bengal,3504,566821,10306,3574,567117,10308,580999,580631,2021-03-23 20:43:39.730262
Andaman and Nicobar Islands,8,4969,62,5,4972,62,5039,5039,2021-03-24 20:13:09.477737
Andhra Pradesh,2382,884471,7191,2616,884727,7193,894536,894044,2021-03-24 20:13:09.477737
Arunachal Pradesh,2,16784,56,2,16784,56,16842,16842,2021-03-24 20:13:09.477737
Assam,1670,215235,1101,1694,215262,1102,218058,218006,2021-03-24 20:13:09.477737
Bihar,561,261537,1561,624,261583,1563,263770,263659,2021-03-24 20:13:09.477737
Chandigarh,1979,22325,363,2066,22451,364,24881,24667,2021-03-24 20:13:09.477737
Chhattisgarh,9205,312511,3962,10491,313115,3982,327588,325678,2021-03-24 20:13:09.477737
Dadra and Nagar Haveli and Daman and Diu,52,3431,2,60,3433,2,3495,3485,2021-03-24 20:13:09.477737
Delhi,3934,633975,10963,4411,634595,10967,649973,648872,2021-03-24 20:13:09.477737
Goa,1017,54873,818,1089,54931,821,56841,56708,2021-03-24 20:13:09.477737
Gujarat,7847,276348,4454,8318,277603,4458,290379,288649,2021-03-24 20:13:09.477737
Haryana,5698,271894,3101,6149,272335,3104,281588,280693,2021-03-24 20:13:09.477737
Himachal Pradesh,1385,58472,1021,1455,58555,1025,61035,60878,2021-03-24 20:13:09.477737
Jammu and Kashmir,1336,125362,1981,1410,125443,1983,128836,128679,2021-03-24 20:13:09.477737
Jharkhand,796,119478,1097,854,119549,1098,121501,121371,2021-03-24 20:13:09.477737
Karnataka,14286,944917,12444,15614,945594,12449,973657,971647,2021-03-24 20:13:09.477737
Kerala,24389,1076571,4507,24192,1078743,4517,1107452,1105467,2021-03-24 20:13:09.477737
Ladakh,83,9707,130,90,9709,130,9929,9920,2021-03-24 20:13:09.477737
Lakshadweep,109,581,1,104,592,1,697,691,2021-03-24 20:13:09.477737
Madhya Pradesh,8592,264575,3908,9292,265373,3912,278577,277075,2021-03-24 20:13:09.477737
Maharashtra,216540,2234330,53457,231942,2247495,53589,2533026,2504327,2021-03-24 20:13:09.477737
Manipur,33,28933,373,44,28935,373,29352,29339,2021-03-24 20:13:09.477737
Meghalaya,29,13838,149,25,13843,149,14017,14016,2021-03-24 20:13:09.477737
Mizoram,17,4423,11,18,4423,11,4452,4451,2021-03-24 20:13:09.477737
Nagaland,2,12132,91,2,12132,91,12225,12225,2021-03-24 20:13:09.477737
Odisha,838,336206,1919,891,336266,1919,339076,338963,2021-03-24 20:13:09.477737
Puducherry,236,39521,676,322,39521,677,40520,40433,2021-03-24 20:13:09.477737
Punjab,18628,190399,6382,19403,191825,6435,217663,215409,2021-03-24 20:13:09.477737
Rajasthan,4006,319217,2803,4262,319437,2807,326506,326026,2021-03-24 20:13:09.477737
Sikkim,49,6022,135,42,6031,135,6208,6206,2021-03-24 20:13:09.477737
Tamil Nadu,8619,847139,12609,9145,848041,12618,869804,868367,2021-03-24 20:13:09.477737
Telengana,3151,299042,1674,3352,299270,1676,304298,303867,2021-03-24 20:13:09.477737
Tripura,34,33044,392,43,33044,392,33479,33470,2021-03-24 20:13:09.477737
Uttarakhand,894,95954,1704,930,96010,1706,98646,98552,2021-03-24 20:13:09.477737
Uttar Pradesh,3396,595920,8760,3844,596101,8764,608709,608076,2021-03-24 20:13:09.477737
West Bengal,3574,567117,10308,3656,567437,10310,581403,580999,2021-03-24 20:13:09.477737
Andaman and Nicobar Islands,5,4972,62,6,4973,62,5041,5039,2021-03-25 21:00:08.377920
Andhra Pradesh,2616,884727,7193,2946,884978,7197,895121,894536,2021-03-25 21:00:08.377920
Arunachal Pradesh,2,16784,56,1,16785,56,16842,16842,2021-03-25 21:00:08.377920
Assam,1694,215262,1102,1719,215277,1103,218099,218058,2021-03-25 21:00:08.377920
Bihar,624,261583,1563,727,261648,1565,263940,263770,2021-03-25 21:00:08.377920
Chandigarh,2066,22451,364,2178,22587,365,25130,24881,2021-03-25 21:00:08.377920
Chhattisgarh,10491,313115,3982,11934,313749,4011,329694,327588,2021-03-25 21:00:08.377920
Dadra and Nagar Haveli and Daman and Diu,60,3433,2,70,3438,2,3510,3495,2021-03-25 21:00:08.377920
Delhi,4411,634595,10967,4890,635364,10973,651227,649973,2021-03-25 21:00:08.377920
Goa,1089,54931,821,1156,55004,821,56981,56841,2021-03-25 21:00:08.377920
Gujarat,8318,277603,4458,8823,278880,4466,292169,290379,2021-03-25 21:00:08.377920
Haryana,6149,272335,3104,6745,272714,3110,282569,281588,2021-03-25 21:00:08.377920
Himachal Pradesh,1455,58555,1025,1654,58620,1027,61301,61035,2021-03-25 21:00:08.377920
Jammu and Kashmir,1410,125443,1983,1513,125535,1983,129031,128836,2021-03-25 21:00:08.377920
Jharkhand,854,119549,1098,969,119626,1100,121695,121501,2021-03-25 21:00:08.377920
Karnataka,15614,945594,12449,16905,946589,12461,975955,973657,2021-03-25 21:00:08.377920
Kerala,24192,1078743,4517,24578,1080803,4527,1109908,1107452,2021-03-25 21:00:08.377920
Ladakh,90,9709,130,101,9711,130,9942,9929,2021-03-25 21:00:08.377920
Lakshadweep,104,592,1,104,592,1,697,697,2021-03-25 21:00:08.377920
Madhya Pradesh,9292,265373,3912,10047,266323,3919,280289,278577,2021-03-25 21:00:08.377920
Maharashtra,231942,2247495,53589,248604,2262593,53684,2564881,2533026,2021-03-25 21:00:08.377920
Manipur,44,28935,373,53,28935,374,29362,29352,2021-03-25 21:00:08.377920
Meghalaya,25,13843,149,22,13848,149,14019,14017,2021-03-25 21:00:08.377920
Mizoram,18,4423,11,18,4425,11,4454,4452,2021-03-25 21:00:08.377920
Nagaland,2,12132,91,2,12133,91,12226,12225,2021-03-25 21:00:08.377920
Odisha,891,336266,1919,990,336337,1919,339246,339076,2021-03-25 21:00:08.377920
Puducherry,322,39521,677,445,39521,679,40645,40520,2021-03-25 21:00:08.377920
Punjab,19403,191825,6435,20522,193280,6474,220276,217663,2021-03-25 21:00:08.377920
Rajasthan,4262,319437,2807,4672,319695,2808,327175,326506,2021-03-25 21:00:08.377920
Sikkim,42,6031,135,43,6032,135,6210,6208,2021-03-25 21:00:08.377920
Tamil Nadu,9145,848041,12618,9746,849064,12630,871440,869804,2021-03-25 21:00:08.377920
Telengana,3352,299270,1676,3684,299427,1680,304791,304298,2021-03-25 21:00:08.377920
Tripura,43,33044,392,43,33045,392,33480,33479,2021-03-25 21:00:08.377920
Uttarakhand,930,96010,1706,1112,96062,1706,98880,98646,2021-03-25 21:00:08.377920
Uttar Pradesh,3844,596101,8764,4388,596286,8769,609443,608709,2021-03-25 21:00:08.377920
West Bengal,3656,567437,10310,3782,567771,10312,581865,581403,2021-03-25 21:00:08.377920
Andaman and Nicobar Islands,6,4973,62,6,4974,62,5042,5041,2021-03-26 20:00:24.682073
Andhra Pradesh,2946,884978,7197,3469,885209,7201,895879,895121,2021-03-26 20:00:24.682073
Arunachal Pradesh,1,16785,56,1,16785,56,16842,16842,2021-03-26 20:00:24.682073
Assam,1719,215277,1103,1736,215299,1104,218139,218099,2021-03-26 20:00:24.682073
Bihar,727,261648,1565,925,261706,1567,264198,263940,2021-03-26 20:00:24.682073
Chandigarh,2178,22587,365,2286,22702,368,25356,25130,2021-03-26 20:00:24.682073
Chhattisgarh,11934,313749,4011,13318,314769,4026,332113,329694,2021-03-26 20:00:24.682073
Dadra and Nagar Haveli and Daman and Diu,70,3438,2,92,3442,2,3536,3510,2021-03-26 20:00:24.682073
Delhi,4890,635364,10973,5497,636267,10978,652742,651227,2021-03-26 20:00:24.682073
Goa,1156,55004,821,1278,55070,822,57170,56981,2021-03-26 20:00:24.682073
Gujarat,8823,278880,4466,9372,280285,4473,294130,292169,2021-03-26 20:00:24.682073
Haryana,6745,272714,3110,7229,273276,3117,283622,282569,2021-03-26 20:00:24.682073
Himachal Pradesh,1654,58620,1027,1903,58684,1029,61616,61301,2021-03-26 20:00:24.682073
Jammu and Kashmir,1513,125535,1983,1593,125627,1983,129203,129031,2021-03-26 20:00:24.682073
Jharkhand,969,119626,1100,1175,119698,1100,121973,121695,2021-03-26 20:00:24.682073
Karnataka,16905,946589,12461,18226,947781,12471,978478,975955,2021-03-26 20:00:24.682073
Kerala,24578,1080803,4527,24690,1082668,4539,1111897,1109908,2021-03-26 20:00:24.682073
Ladakh,101,9711,130,105,9713,130,9948,9942,2021-03-26 20:00:24.682073
Lakshadweep,104,592,1,111,596,1,708,697,2021-03-26 20:00:24.682073
Madhya Pradesh,10047,266323,3919,11004,267242,3928,282174,280289,2021-03-26 20:00:24.682073
Maharashtra,248604,2262593,53684,264001,2283037,53795,2600833,2564881,2021-03-26 20:00:24.682073
Manipur,53,28935,374,57,28936,374,29367,29362,2021-03-26 20:00:24.682073
Meghalaya,22,13848,149,23,13849,150,14022,14019,2021-03-26 20:00:24.682073
Mizoram,18,4425,11,24,4425,11,4460,4454,2021-03-26 20:00:24.682073
Nagaland,2,12133,91,4,12133,92,12229,12226,2021-03-26 20:00:24.682073
Odisha,990,336337,1919,1132,336409,1919,339460,339246,2021-03-26 20:00:24.682073
Puducherry,445,39521,679,540,39521,679,40740,40645,2021-03-26 20:00:24.682073
Punjab,20522,193280,6474,21405,195015,6517,222937,220276,2021-03-26 20:00:24.682073
Rajasthan,4672,319695,2808,5149,319933,2808,327890,327175,2021-03-26 20:00:24.682073
Sikkim,43,6032,135,40,6037,135,6212,6210,2021-03-26 20:00:24.682073
Tamil Nadu,9746,849064,12630,10487,850091,12641,873219,871440,2021-03-26 20:00:24.682073
Telengana,3684,299427,1680,3995,299631,1683,305309,304791,2021-03-26 20:00:24.682073
Tripura,43,33045,392,44,33046,392,33482,33480,2021-03-26 20:00:24.682073
Uttarakhand,1112,96062,1706,1150,96215,1707,99072,98880,2021-03-26 20:00:24.682073
Uttar Pradesh,4388,596286,8769,5049,596451,8773,610273,609443,2021-03-26 20:00:24.682073
West Bengal,3782,567771,10312,3950,568115,10316,582381,581865,2021-03-26 20:00:24.682073
Andaman and Nicobar Islands,6,4974,62,7,4974,62,5043,5042,2021-03-27 20:00:20.902111
Andhra Pradesh,3469,885209,7201,4145,885515,7203,896863,895879,2021-03-27 20:00:20.902111
Arunachal Pradesh,1,16785,56,2,16785,56,16843,16842,2021-03-27 20:00:20.902111
Assam,1736,215299,1104,1747,215325,1104,218176,218139,2021-03-27 20:00:20.902111
Bihar,925,261706,1567,1001,261839,1569,264409,264198,2021-03-27 20:00:20.902111
Chandigarh,2286,22702,368,2392,22840,372,25604,25356,2021-03-27 20:00:20.902111
Chhattisgarh,13318,314769,4026,15307,315423,4048,334778,332113,2021-03-27 20:00:20.902111
Dadra and Nagar Haveli and Daman and Diu,92,3442,2,109,3443,2,3554,3536,2021-03-27 20:00:20.902111
Delhi,5497,636267,10978,6051,637238,10987,654276,652742,2021-03-27 20:00:20.902111
Goa,1278,55070,822,1279,55181,823,57283,57170,2021-03-27 20:00:20.902111
Gujarat,9372,280285,4473,10134,281707,4479,296320,294130,2021-03-27 20:00:20.902111
Haryana,7229,273276,3117,7795,274024,3125,284944,283622,2021-03-27 20:00:20.902111
Himachal Pradesh,1903,58684,1029,2124,58813,1030,61967,61616,2021-03-27 20:00:20.902111
Jammu and Kashmir,1593,125627,1983,1681,125748,1984,129413,129203,2021-03-27 20:00:20.902111
Jharkhand,1175,119698,1100,1399,119779,1103,122281,121973,2021-03-27 20:00:20.902111
Karnataka,18226,947781,12471,19572,948988,12484,981044,978478,2021-03-27 20:00:20.902111
Kerala,24690,1082668,4539,24584,1084585,4553,1113722,1111897,2021-03-27 20:00:20.902111
Ladakh,105,9713,130,111,9724,130,9965,9948,2021-03-27 20:00:20.902111
Lakshadweep,111,596,1,99,614,1,714,708,2021-03-27 20:00:20.902111
Madhya Pradesh,11004,267242,3928,12038,268290,3937,284265,282174,2021-03-27 20:00:20.902111
Maharashtra,264001,2283037,53795,283772,2300056,53907,2637735,2600833,2021-03-27 20:00:20.902111
Manipur,57,28936,374,60,28939,374,29373,29367,2021-03-27 20:00:20.902111
Meghalaya,23,13849,150,26,13853,150,14029,14022,2021-03-27 20:00:20.902111
Mizoram,24,4425,11,26,4426,11,4463,4460,2021-03-27 20:00:20.902111
Nagaland,4,12133,92,4,12133,92,12229,12229,2021-03-27 20:00:20.902111
Odisha,1132,336409,1919,1293,336482,1919,339694,339460,2021-03-27 20:00:20.902111
Puducherry,540,39521,679,636,39521,679,40836,40740,2021-03-27 20:00:20.902111
Punjab,21405,195015,6517,22652,196831,6576,226059,222937,2021-03-27 20:00:20.902111
Rajasthan,5149,319933,2808,5733,320199,2811,328743,327890,2021-03-27 20:00:20.902111
Sikkim,40,6037,135,41,6039,135,6215,6212,2021-03-27 20:00:20.902111
Tamil Nadu,10487,850091,12641,11318,851222,12650,875190,873219,2021-03-27 20:00:20.902111
Telengana,3995,299631,1683,4241,299878,1685,305804,305309,2021-03-27 20:00:20.902111
Tripura,44,33046,392,51,33047,392,33490,33482,2021-03-27 20:00:20.902111
Uttarakhand,1150,96215,1707,1162,96388,1708,99258,99072,2021-03-27 20:00:20.902111
Uttar Pradesh,5049,596451,8773,5824,596698,8779,611301,610273,2021-03-27 20:00:20.902111
West Bengal,3950,568115,10316,4231,568476,10320,583027,582381,2021-03-27 20:00:20.902111
Andaman and Nicobar Islands,7,4974,62,7,4975,62,5044,5043,2021-03-28 20:55:53.748182
Andhra Pradesh,4145,885515,7203,4715,885892,7203,897810,896863,2021-03-28 20:55:53.748182
Arunachal Pradesh,2,16785,56,4,16785,56,16845,16843,2021-03-28 20:55:53.748182
Assam,1747,215325,1104,1770,215348,1104,218222,218176,2021-03-28 20:55:53.748182
Bihar,1001,261839,1569,1116,261917,1571,264604,264409,2021-03-28 20:55:53.748182
Chandigarh,2392,22840,372,2532,22992,374,25898,25604,2021-03-28 20:55:53.748182
Chhattisgarh,15307,315423,4048,17836,316043,4061,337940,334778,2021-03-28 20:55:53.748182
Dadra and Nagar Haveli and Daman and Diu,109,3443,2,130,3448,2,3580,3554,2021-03-28 20:55:53.748182
Delhi,6051,637238,10987,6625,638212,10997,655834,654276,2021-03-28 20:55:53.748182
Goa,1279,55181,823,1379,55250,824,57453,57283,2021-03-28 20:55:53.748182
Gujarat,10134,281707,4479,10871,283241,4484,298596,296320,2021-03-28 20:55:53.748182
Haryana,7795,274024,3125,8410,274785,3132,286327,284944,2021-03-28 20:55:53.748182
Himachal Pradesh,2124,58813,1030,2361,58989,1033,62383,61967,2021-03-28 20:55:53.748182
Jammu and Kashmir,1681,125748,1984,1813,125886,1985,129684,129413,2021-03-28 20:55:53.748182
Jharkhand,1399,119779,1103,1636,119878,1107,122621,122281,2021-03-28 20:55:53.748182
Karnataka,19572,948988,12484,21271,950167,12492,983930,981044,2021-03-28 20:55:53.748182
Kerala,24584,1084585,4553,24541,1086669,4567,1115777,1113722,2021-03-28 20:55:53.748182
Ladakh,111,9724,130,117,9727,130,9974,9965,2021-03-28 20:55:53.748182
Lakshadweep,99,614,1,88,625,1,714,714,2021-03-28 20:55:53.748182
Madhya Pradesh,12038,268290,3937,12995,269465,3947,286407,284265,2021-03-28 20:55:53.748182
Maharashtra,283772,2300056,53907,304809,2314579,54073,2673461,2637735,2021-03-28 20:55:53.748182
Manipur,60,28939,374,58,28944,374,29376,29373,2021-03-28 20:55:53.748182
Meghalaya,26,13853,150,26,13855,150,14031,14029,2021-03-28 20:55:53.748182
Mizoram,26,4426,11,26,4428,11,4465,4463,2021-03-28 20:55:53.748182
Nagaland,4,12133,92,4,12133,92,12229,12229,2021-03-28 20:55:53.748182
Odisha,1293,336482,1919,1413,336571,1920,339904,339694,2021-03-28 20:55:53.748182
Puducherry,636,39521,679,763,39521,680,40964,40836,2021-03-28 20:55:53.748182
Punjab,22652,196831,6576,23271,198972,6621,228864,226059,2021-03-28 20:55:53.748182
Rajasthan,5733,320199,2811,6358,320426,2811,329595,328743,2021-03-28 20:55:53.748182
Sikkim,41,6039,135,50,6041,135,6226,6215,2021-03-28 20:55:53.748182
Tamil Nadu,11318,851222,12650,12157,852463,12659,877279,875190,2021-03-28 20:55:53.748182
Telengana,4241,299878,1685,4495,300156,1688,306339,305804,2021-03-28 20:55:53.748182
Tripura,51,33047,392,49,33050,392,33491,33490,2021-03-28 20:55:53.748182
Uttarakhand,1162,96388,1708,1339,96467,1709,99515,99258,2021-03-28 20:55:53.748182
Uttar Pradesh,5824,596698,8779,6667,596953,8783,612403,611301,2021-03-28 20:55:53.748182
West Bengal,4231,568476,10320,4608,568909,10322,583839,583027,2021-03-28 20:55:53.748182
Andaman and Nicobar Islands,7,4975,62,8,4976,62,5046,5044,2021-03-29 20:00:30.086117
Andhra Pradesh,4715,885892,7203,5394,886216,7205,898815,897810,2021-03-29 20:00:30.086117
Arunachal Pradesh,4,16785,56,4,16785,56,16845,16845,2021-03-29 20:00:30.086117
Assam,1770,215348,1104,1800,215366,1104,218270,218222,2021-03-29 20:00:30.086117
Bihar,1116,261917,1571,1347,262036,1572,264955,264604,2021-03-29 20:00:30.086117
Chandigarh,2532,22992,374,2633,23184,377,26194,25898,2021-03-29 20:00:30.086117
Chhattisgarh,17836,316043,4061,19239,316778,4076,340093,337940,2021-03-29 20:00:30.086117
Dadra and Nagar Haveli and Daman and Diu,130,3448,2,147,3458,2,3607,3580,2021-03-29 20:00:30.086117
Delhi,6625,638212,10997,7545,639164,11006,657715,655834,2021-03-29 20:00:30.086117
Goa,1379,55250,824,1404,55354,826,57584,57453,2021-03-29 20:00:30.086117
Gujarat,10871,283241,4484,11528,284846,4492,300866,298596,2021-03-29 20:00:30.086117
Haryana,8410,274785,3132,9120,275458,3141,287719,286327,2021-03-29 20:00:30.086117
Himachal Pradesh,2361,58989,1033,2478,59146,1036,62660,62383,2021-03-29 20:00:30.086117
Jammu and Kashmir,1813,125886,1985,2001,126003,1989,129993,129684,2021-03-29 20:00:30.086117
Jharkhand,1636,119878,1107,1871,119954,1110,122935,122621,2021-03-29 20:00:30.086117
Karnataka,21271,950167,12492,23056,951452,12504,987012,983930,2021-03-29 20:00:30.086117
Kerala,24541,1086669,4567,24892,1088522,4579,1117993,1115777,2021-03-29 20:00:30.086117
Ladakh,117,9727,130,108,9736,130,9974,9974,2021-03-29 20:00:30.086117
Lakshadweep,88,625,1,57,657,1,715,714,2021-03-29 20:00:30.086117
Madhya Pradesh,12995,269465,3947,14185,270540,3958,288683,286407,2021-03-29 20:00:30.086117
Maharashtra,304809,2314579,54073,327241,2332453,54181,2713875,2673461,2021-03-29 20:00:30.086117
Manipur,58,28944,374,63,28948,374,29385,29376,2021-03-29 20:00:30.086117
Meghalaya,26,13855,150,26,13856,150,14032,14031,2021-03-29 20:00:30.086117
Mizoram,26,4428,11,26,4428,11,4465,4465,2021-03-29 20:00:30.086117
Nagaland,4,12133,92,4,12134,92,12230,12229,2021-03-29 20:00:30.086117
Odisha,1413,336571,1920,1583,336691,1920,340194,339904,2021-03-29 20:00:30.086117
Puducherry,763,39521,680,900,39521,680,41101,40964,2021-03-29 20:00:30.086117
Punjab,23271,198972,6621,23917,201127,6690,231734,228864,2021-03-29 20:00:30.086117
Rajasthan,6358,320426,2811,7159,320704,2813,330676,329595,2021-03-29 20:00:30.086117
Sikkim,50,6041,135,44,6048,135,6227,6226,2021-03-29 20:00:30.086117
Tamil Nadu,12157,852463,12659,13070,853733,12670,879473,877279,2021-03-29 20:00:30.086117
Telengana,4495,300156,1688,4583,300469,1690,306742,306339,2021-03-29 20:00:30.086117
Tripura,49,33050,392,47,33052,392,33491,33491,2021-03-29 20:00:30.086117
Uttarakhand,1339,96467,1709,1660,96512,1709,99881,99515,2021-03-29 20:00:30.086117
Uttar Pradesh,6667,596953,8783,7692,597320,8786,613798,612403,2021-03-29 20:00:30.086117
West Bengal,4608,568909,10322,4976,569366,10324,584666,583839,2021-03-29 20:00:30.086117
Andaman and Nicobar Islands,8,4976,62,14,4976,62,5052,5046,2021-03-30 21:09:56.950331
Andhra Pradesh,5394,886216,7205,6104,886498,7210,899812,898815,2021-03-30 21:09:56.950331
Arunachal Pradesh,4,16785,56,4,16785,56,16845,16845,2021-03-30 21:09:56.950331
Assam,1800,215366,1104,1816,215390,1104,218310,218270,2021-03-30 21:09:56.950331
Bihar,1347,262036,1572,1488,262133,1573,265194,264955,2021-03-30 21:09:56.950331
Chandigarh,2633,23184,377,2746,23345,377,26468,26194,2021-03-30 21:09:56.950331
Chhattisgarh,19239,316778,4076,20181,317239,4096,341516,340093,2021-03-30 21:09:56.950331
Dadra and Nagar Haveli and Daman and Diu,147,3458,2,158,3463,2,3623,3607,2021-03-30 21:09:56.950331
Delhi,7545,639164,11006,8029,640575,11012,659616,657715,2021-03-30 21:09:56.950331
Goa,1404,55354,826,1429,55455,828,57712,57584,2021-03-30 21:09:56.950331
Gujarat,11528,284846,4492,12041,286577,4500,303118,300866,2021-03-30 21:09:56.950331
Haryana,9120,275458,3141,9312,276259,3143,288714,287719,2021-03-30 21:09:56.950331
Himachal Pradesh,2478,59146,1036,2634,59308,1039,62981,62660,2021-03-30 21:09:56.950331
Jammu and Kashmir,2001,126003,1989,2110,126129,1989,130228,129993,2021-03-30 21:09:56.950331
Jharkhand,1871,119954,1110,1968,120012,1110,123090,122935,2021-03-30 21:09:56.950331
Karnataka,23056,951452,12504,23868,953416,12520,989804,987012,2021-03-30 21:09:56.950331
Kerala,24892,1088522,4579,24533,1090419,4590,1119542,1117993,2021-03-30 21:09:56.950331
Ladakh,108,9736,130,135,9742,130,10007,9974,2021-03-30 21:09:56.950331
Lakshadweep,57,657,1,45,669,1,715,715,2021-03-30 21:09:56.950331
Madhya Pradesh,14185,270540,3958,15150,271889,3967,291006,288683,2021-03-30 21:09:56.950331
Maharashtra,327241,2332453,54181,337928,2353307,54283,2745518,2713875,2021-03-30 21:09:56.950331
Manipur,63,28948,374,67,28950,374,29391,29385,2021-03-30 21:09:56.950331
Meghalaya,26,13856,150,26,13858,150,14034,14032,2021-03-30 21:09:56.950331
Mizoram,26,4428,11,29,4428,11,4468,4465,2021-03-30 21:09:56.950331
Nagaland,4,12134,92,7,12134,92,12233,12230,2021-03-30 21:09:56.950331
Odisha,1583,336691,1920,1672,336809,1921,340402,340194,2021-03-30 21:09:56.950331
Puducherry,900,39521,680,991,39554,681,41226,41101,2021-03-30 21:09:56.950331
Punjab,23917,201127,6690,24143,203710,6749,234602,231734,2021-03-30 21:09:56.950331
Rajasthan,7159,320704,2813,7794,320971,2813,331578,330676,2021-03-30 21:09:56.950331
Sikkim,44,6048,135,43,6049,135,6227,6227,2021-03-30 21:09:56.950331
Tamil Nadu,13070,853733,12670,13983,855085,12684,881752,879473,2021-03-30 21:09:56.950331
Telengana,4583,300469,1690,4678,300833,1694,307205,306742,2021-03-30 21:09:56.950331
Tripura,47,33052,392,49,33052,392,33493,33491,2021-03-30 21:09:56.950331
Uttarakhand,1660,96512,1709,1724,96555,1711,99990,99881,2021-03-30 21:09:56.950331
Uttar Pradesh,7692,597320,8786,8669,597619,8790,615078,613798,2021-03-30 21:09:56.950331
West Bengal,4976,569366,10324,5152,569828,10325,585305,584666,2021-03-30 21:09:56.950331
Andaman and Nicobar Islands,14,4976,62,43,4976,62,5081,5052,2021-03-31 20:01:03.400583
Andhra Pradesh,6104,886498,7210,6614,886978,7213,900805,899812,2021-03-31 20:01:03.400583
Arunachal Pradesh,4,16785,56,4,16785,56,16845,16845,2021-03-31 20:01:03.400583
Assam,1816,215390,1104,1846,215413,1104,218363,218310,2021-03-31 20:01:03.400583
Bihar,1488,262133,1573,1456,262238,1574,265268,265194,2021-03-31 20:01:03.400583
Chandigarh,2746,23345,377,2831,23523,379,26733,26468,2021-03-31 20:01:03.400583
Chhattisgarh,20181,317239,4096,22057,318436,4131,344624,341516,2021-03-31 20:01:03.400583
Dadra and Nagar Haveli and Daman and Diu,158,3463,2,166,3474,2,3642,3623,2021-03-31 20:01:03.400583
Delhi,8029,640575,11012,7429,642166,11016,660611,659616,2021-03-31 20:01:03.400583
Goa,1429,55455,828,1419,55591,829,57839,57712,2021-03-31 20:01:03.400583
Gujarat,12041,286577,4500,12263,288565,4510,305338,303118,2021-03-31 20:01:03.400583
Haryana,9312,276259,3143,9437,277110,3147,289694,288714,2021-03-31 20:01:03.400583
Himachal Pradesh,2634,59308,1039,2830,59445,1045,63320,62981,2021-03-31 20:01:03.400583
Jammu and Kashmir,2110,126129,1989,2293,126304,1990,130587,130228,2021-03-31 20:01:03.400583
Jharkhand,1968,120012,1110,2254,120141,1113,123508,123090,2021-03-31 20:01:03.400583
Karnataka,23868,953416,12520,25560,954678,12541,992779,989804,2021-03-31 20:01:03.400583
Kerala,24533,1090419,4590,24960,1092365,4606,1121931,1119542,2021-03-31 20:01:03.400583
Ladakh,135,9742,130,222,9767,130,10119,10007,2021-03-31 20:01:03.400583
Lakshadweep,45,669,1,39,678,1,718,715,2021-03-31 20:01:03.400583
Madhya Pradesh,15150,271889,3967,16034,273168,3977,293179,291006,2021-03-31 20:01:03.400583
Maharashtra,337928,2353307,54283,341887,2377127,54422,2773436,2745518,2021-03-31 20:01:03.400583
Manipur,67,28950,374,67,28952,374,29393,29391,2021-03-31 20:01:03.400583
Meghalaya,26,13858,150,45,13861,150,14056,14034,2021-03-31 20:01:03.400583
Mizoram,29,4428,11,28,4434,11,4473,4468,2021-03-31 20:01:03.400583
Nagaland,7,12134,92,7,12134,92,12233,12233,2021-03-31 20:01:03.400583
Odisha,1672,336809,1921,1769,336930,1921,340620,340402,2021-03-31 20:01:03.400583
Puducherry,991,39554,681,1011,39648,682,41341,41226,2021-03-31 20:01:03.400583
Punjab,24143,203710,6749,23731,206246,6813,236790,234602,2021-03-31 20:01:03.400583
Rajasthan,7794,320971,2813,8155,321275,2813,332243,331578,2021-03-31 20:01:03.400583
Sikkim,43,6049,135,48,6050,135,6233,6227,2021-03-31 20:01:03.400583
Tamil Nadu,13983,855085,12684,14846,856548,12700,884094,881752,2021-03-31 20:01:03.400583
Telengana,4678,300833,1694,4965,301227,1697,307889,307205,2021-03-31 20:01:03.400583
Tripura,49,33052,392,56,33055,392,33503,33493,2021-03-31 20:01:03.400583
Uttarakhand,1724,96555,1711,1696,96709,1713,100118,99990,2021-03-31 20:01:03.400583
Uttar Pradesh,8669,597619,8790,9195,598001,8800,615996,615078,2021-03-31 20:01:03.400583
West Bengal,5152,569828,10325,5303,570303,10327,585933,585305,2021-03-31 20:01:03.400583
Andaman and Nicobar Islands,43,4976,62,45,4976,62,5083,5081,2021-04-01 20:00:26.444579
Andhra Pradesh,6614,886978,7213,7338,887434,7217,901989,900805,2021-04-01 20:00:26.444579
Arunachal Pradesh,4,16785,56,4,16785,56,16845,16845,2021-04-01 20:00:26.444579
Assam,1846,215413,1104,1862,215445,1105,218412,218363,2021-04-01 20:00:26.444579
Bihar,1456,262238,1574,1580,262371,1576,265527,265268,2021-04-01 20:00:26.444579
Chandigarh,2831,23523,379,2918,23702,379,26999,26733,2021-04-01 20:00:26.444579
Chhattisgarh,22057,318436,4131,25529,319488,4170,349187,344624,2021-04-01 20:00:26.444579
Dadra and Nagar Haveli and Daman and Diu,166,3474,2,177,3482,2,3661,3642,2021-04-01 20:00:26.444579
Delhi,7429,642166,11016,8838,642565,11027,662430,660611,2021-04-01 20:00:26.444579
Goa,1419,55591,829,1556,55653,830,58039,57839,2021-04-01 20:00:26.444579
Gujarat,12263,288565,4510,12610,290569,4519,307698,305338,2021-04-01 20:00:26.444579
Haryana,9437,277110,3147,9726,277919,3155,290800,289694,2021-04-01 20:00:26.444579
Himachal Pradesh,2830,59445,1045,2973,59584,1048,63605,63320,2021-04-01 20:00:26.444579
Jammu and Kashmir,2293,126304,1990,2531,126435,1994,130960,130587,2021-04-01 20:00:26.444579
Jharkhand,2254,120141,1113,2825,120263,1113,124201,123508,2021-04-01 20:00:26.444579
Karnataka,25560,954678,12541,28267,956170,12567,997004,992779,2021-04-01 20:00:26.444579
Kerala,24960,1092365,4606,25559,1094404,4621,1124584,1121931,2021-04-01 20:00:26.444579
Ladakh,222,9767,130,256,9771,130,10157,10119,2021-04-01 20:00:26.444579
Lakshadweep,39,678,1,42,680,1,723,718,2021-04-01 20:00:26.444579
Madhya Pradesh,16034,273168,3977,17096,274429,3986,295511,293179,2021-04-01 20:00:26.444579
Maharashtra,341887,2377127,54422,357604,2400727,54649,2812980,2773436,2021-04-01 20:00:26.444579
Manipur,67,28952,374,70,28956,374,29400,29393,2021-04-01 20:00:26.444579
Meghalaya,45,13861,150,49,13866,150,14065,14056,2021-04-01 20:00:26.444579
Mizoram,28,4434,11,31,4434,11,4476,4473,2021-04-01 20:00:26.444579
Nagaland,7,12134,92,112,12136,92,12340,12233,2021-04-01 20:00:26.444579
Odisha,1769,336930,1921,1905,337091,1921,340917,340620,2021-04-01 20:00:26.444579
Puducherry,1011,39648,682,1074,39712,682,41468,41341,2021-04-01 20:00:26.444579
Punjab,23731,206246,6813,23832,209034,6868,239734,236790,2021-04-01 20:00:26.444579
Rajasthan,8155,321275,2813,8663,321668,2818,333149,332243,2021-04-01 20:00:26.444579
Sikkim,48,6050,135,47,6053,135,6235,6233,2021-04-01 20:00:26.444579
Tamil Nadu,14846,856548,12700,15879,858075,12719,886673,884094,2021-04-01 20:00:26.444579
Telengana,4965,301227,1697,5511,301564,1701,308776,307889,2021-04-01 20:00:26.444579
Tripura,56,33055,392,60,33065,392,33517,33503,2021-04-01 20:00:26.444579
Uttarakhand,1696,96709,1713,1863,96831,1717,100411,100118,2021-04-01 20:00:26.444579
Uttar Pradesh,9195,598001,8800,9848,598535,8811,617194,615996,2021-04-01 20:00:26.444579
West Bengal,5303,570303,10327,5775,570811,10329,586915,585933,2021-04-01 20:00:26.444579
Andaman and Nicobar Islands,45,4976,62,42,4980,62,5084,5083,2021-04-02 20:18:52.294504
Andhra Pradesh,7338,887434,7217,8142,887898,7220,903260,901989,2021-04-02 20:18:52.294504
Arunachal Pradesh,4,16785,56,4,16785,56,16845,16845,2021-04-02 20:18:52.294504
Assam,1862,215445,1105,1884,215479,1107,218470,218412,2021-04-02 20:18:52.294504
Bihar,1580,262371,1576,1908,262529,1578,266015,265527,2021-04-02 20:18:52.294504
Chandigarh,2918,23702,379,2951,23925,380,27256,26999,2021-04-02 20:18:52.294504
Chhattisgarh,25529,319488,4170,28987,320613,4204,353804,349187,2021-04-02 20:18:52.294504
Dadra and Nagar Haveli and Daman and Diu,177,3482,2,191,3490,2,3683,3661,2021-04-02 20:18:52.294504
Delhi,8838,642565,11027,10498,643686,11036,665220,662430,2021-04-02 20:18:52.294504
Goa,1556,55653,830,1716,55757,831,58304,58039,2021-04-02 20:18:52.294504
Gujarat,12610,290569,4519,12996,292584,4528,310108,307698,2021-04-02 20:18:52.294504
Haryana,9726,277919,3155,10362,278883,3164,292409,290800,2021-04-02 20:18:52.294504
Himachal Pradesh,2973,59584,1048,3221,59741,1052,64014,63605,2021-04-02 20:18:52.294504
Jammu and Kashmir,2531,126435,1994,2874,126549,1998,131421,130960,2021-04-02 20:18:52.294504
Jharkhand,2825,120263,1113,3352,120425,1114,124891,124201,2021-04-02 20:18:52.294504
Karnataka,28267,956170,12567,30884,957769,12585,1001238,997004,2021-04-02 20:18:52.294504
Kerala,25559,1094404,4621,26511,1096239,4632,1127382,1124584,2021-04-02 20:18:52.294504
Ladakh,256,9771,130,267,9778,130,10175,10157,2021-04-02 20:18:52.294504
Lakshadweep,42,680,1,37,688,1,726,723,2021-04-02 20:18:52.294504
Madhya Pradesh,17096,274429,3986,18057,276002,3998,298057,295511,2021-04-02 20:18:52.294504
Maharashtra,357604,2400727,54649,367897,2433368,54898,2856163,2812980,2021-04-02 20:18:52.294504
Manipur,70,28956,374,64,28963,374,29401,29400,2021-04-02 20:18:52.294504
Meghalaya,49,13866,150,50,13867,150,14067,14065,2021-04-02 20:18:52.294504
Mizoram,31,4434,11,37,4436,11,4484,4476,2021-04-02 20:18:52.294504
Nagaland,112,12136,92,115,12138,92,12345,12340,2021-04-02 20:18:52.294504
Odisha,1905,337091,1921,2178,337212,1921,341311,340917,2021-04-02 20:18:52.294504
Puducherry,1074,39712,682,1290,39755,683,41728,41468,2021-04-02 20:18:52.294504
Punjab,23832,209034,6868,24644,211325,6926,242895,239734,2021-04-02 20:18:52.294504
Rajasthan,8663,321668,2818,9563,322114,2822,334499,333149,2021-04-02 20:18:52.294504
Sikkim,47,6053,135,46,6060,135,6241,6235,2021-04-02 20:18:52.294504
Tamil Nadu,15879,858075,12719,17043,859709,12738,889490,886673,2021-04-02 20:18:52.294504
Telengana,5511,301564,1701,6159,301876,1706,309741,308776,2021-04-02 20:18:52.294504
Tripura,60,33065,392,59,33070,392,33521,33517,2021-04-02 20:18:52.294504
Uttarakhand,1863,96831,1717,2236,96956,1719,100911,100411,2021-04-02 20:18:52.294504
Uttar Pradesh,9848,598535,8811,11918,599045,8820,619783,617194,2021-04-02 20:18:52.294504
West Bengal,5775,570811,10329,6513,571345,10331,588189,586915,2021-04-02 20:18:52.294504
Andaman and Nicobar Islands,147,4980,62,152,3469,52,3673,5084,2021-04-03 17:39:44
Andhra Pradesh,78836,887898,7220,74518,551821,5410,631749,903260,2021-04-03 17:39:44
Arunachal Pradesh,1964,16785,56,1939,5643,13,7595,16845,2021-04-03 17:39:44
Assam,28780,215479,1107,29609,129133,578,159320,218470,2021-04-03 17:39:44
Bihar,13005,262529,1578,12539,156242,870,169651,266015,2021-04-03 17:39:44
Chandigarh,2821,23925,380,2761,7411,126,10298,27256,2021-04-03 17:39:44
Chhattisgarh,37853,320613,4204,37927,49564,690,88181,353804,2021-04-03 17:39:44
Dadra and Nagar Haveli and Daman and Diu,229,3490,2,220,2711,2,2933,3683,2021-04-03 17:39:44
Delhi,32097,643686,11036,30941,213304,5014,249259,665220,2021-04-03 17:39:44
Goa,5781,55757,831,5667,22726,360,28753,58304,2021-04-03 17:39:44
Gujarat,16208,292584,4528,16305,104964,3336,124605,310108,2021-04-03 17:39:44
Haryana,21411,278883,3164,21014,90884,1177,113075,292409,2021-04-03 17:39:44
Himachal Pradesh,4444,59741,1052,4458,7853,127,12438,64014,2021-04-03 17:39:44
Jammu and Kashmir,22032,126549,1998,21887,42115,1024,65026,131421,2021-04-03 17:39:44
Jharkhand,13791,120425,1114,13504,58543,626,72673,124891,2021-04-03 17:39:44
Karnataka,98062,957769,12585,95354,423377,8145,526876,1001238,2021-04-03 17:39:44
Kerala,39484,1096239,4632,39354,98724,553,138631,1127382,2021-04-03 17:39:44
Ladakh,1013,9778,130,1047,2735,50,3832,10175,2021-04-03 17:39:44
Lakshadweep,0,688,1,0,0,0,0,726,2021-04-03 17:39:44
Madhya Pradesh,22300,276002,3998,22542,83618,2007,108167,298057,2021-04-03 17:39:44
Maharashtra,291630,2433368,54898,275017,916348,33015,1224380,2856163,2021-04-03 17:39:44
Manipur,2070,28963,374,2113,6838,59,9010,29401,2021-04-03 17:39:44
Meghalaya,2111,13867,150,2169,2527,37,4733,14067,2021-04-03 17:39:44
Mizoram,583,4436,11,680,1012,0,1692,4484,2021-04-03 17:39:44
Nagaland,1184,12138,92,1052,4477,15,5544,12345,2021-04-03 17:39:44
Odisha,33504,337212,1921,34033,149379,710,184122,341311,2021-04-03 17:39:44
Puducherry,4908,39755,683,4659,18065,467,23191,41728,2021-04-03 17:39:44
Punjab,22278,211325,6926,21661,75409,2860,99930,242895,2021-04-03 17:39:44
Rajasthan,18184,322114,2822,18245,97284,1352,116881,334499,2021-04-03 17:39:44
Sikkim,469,6060,135,513,1986,29,2528,6241,2021-04-03 17:39:44
Tamil Nadu,46703,859709,12738,46495,491971,8871,547337,889490,2021-04-03 17:39:44
Telengana,29636,301876,1706,29649,144073,1052,174774,309741,2021-04-03 17:39:44
Tripura,6566,33070,392,6700,15883,251,22834,33521,2021-04-03 17:39:44
Uttarakhand,12455,599045,8820,12075,29201,501,41777,619783,2021-04-03 17:39:44
Uttar Pradesh,65954,96956,1719,64164,289594,5135,358893,100911,2021-04-03 17:39:44
West Bengal,24806,571345,10331,24898,198983,4421,228302,588189,2021-04-03 17:39:44
Andaman and Nicobar Islands,147,4981,62,152,3469,52,3673,5084,2021-04-04 17:39:44
Andhra Pradesh,78836,888508,7225,74518,551821,5410,631749,904548,2021-04-04 17:39:44
Arunachal Pradesh,1964,16785,56,1939,5643,13,7595,16846,2021-04-04 17:39:44
Assam,28780,215517,1107,29609,129133,578,159320,218533,2021-04-04 17:39:44
Bihar,13005,262733,1580,12539,156242,870,169651,266677,2021-04-04 17:39:44
Chandigarh,2821,24064,381,2761,7411,126,10298,27543,2021-04-04 17:39:44
Chhattisgarh,37853,321873,4247,37927,49564,690,88181,357978,2021-04-04 17:39:44
Dadra and Nagar Haveli and Daman and Diu,229,3499,2,220,2711,2,2933,3703,2021-04-04 17:39:44
Delhi,32097,645770,11050,30941,213304,5014,249259,668814,2021-04-04 17:39:44
Goa,5781,55838,832,5667,22726,360,28753,58584,2021-04-04 17:39:44
Gujarat,16208,294650,4539,16305,104964,3336,124605,312748,2021-04-04 17:39:44
Haryana,21411,280074,3174,21014,90884,1177,113075,294270,2021-04-04 17:39:44
Himachal Pradesh,4444,60026,1056,4458,7853,127,12438,64420,2021-04-04 17:39:44
Jammu and Kashmir,22032,126720,2003,21887,42115,1024,65026,131938,2021-04-04 17:39:44
Jharkhand,13791,120562,1115,13504,58543,626,72673,125585,2021-04-04 17:39:44
Karnataka,98062,959400,12591,95354,423377,8145,526876,1006229,2021-04-04 17:39:44
Kerala,39484,1098526,4646,39354,98724,553,138631,1129890,2021-04-04 17:39:44
Ladakh,1013,9781,130,1047,2735,50,3832,10189,2021-04-04 17:39:44
Lakshadweep,0,690,1,0,0,0,0,733,2021-04-04 17:39:44
Madhya Pradesh,22300,277484,4014,22542,83618,2007,108167,300834,2021-04-04 17:39:44
Maharashtra,291630,2457494,55379,275017,916348,33015,1224380,2904076,2021-04-04 17:39:44
Manipur,2070,28975,374,2113,6838,59,9010,29406,2021-04-04 17:39:44
Meghalaya,2111,13868,150,2169,2527,37,4733,14082,2021-04-04 17:39:44
Mizoram,583,4436,11,680,1012,0,1692,4487,2021-04-04 17:39:44
Nagaland,1184,12138,92,1052,4477,15,5544,12361,2021-04-04 17:39:44
Odisha,33504,337430,1921,34033,149379,710,184122,341772,2021-04-04 17:39:44
Puducherry,4908,39837,684,4659,18065,467,23191,41941,2021-04-04 17:39:44
Punjab,22278,213327,6983,21661,75409,2860,99930,245768,2021-04-04 17:39:44
Rajasthan,18184,322613,2824,18245,97284,1352,116881,335921,2021-04-04 17:39:44
Sikkim,469,6064,135,513,1986,29,2528,6245,2021-04-04 17:39:44
Tamil Nadu,46703,861424,12750,46495,491971,8871,547337,892780,2021-04-04 17:39:44
Telengana,29636,302207,1712,29649,144073,1052,174774,310819,2021-04-04 17:39:44
Tripura,6566,33075,392,6700,15883,251,22834,33523,2021-04-04 17:39:44
Uttarakhand,12455,599827,8836,12075,29201,501,41777,622736,2021-04-04 17:39:44
Uttar Pradesh,65954,97150,1721,64164,289594,5135,358893,101275,2021-04-04 17:39:44
West Bengal,24806,571895,10335,24898,198983,4421,228302,589922,2021-04-04 17:39:44
Andaman and Nicobar Islands,49,4987,62,57,4990,62,5109,5098,2021-04-05 20:01:03.651563
Andhra Pradesh,9417,889295,7234,10300,890137,7239,907676,905946,2021-04-05 20:01:03.651563
Arunachal Pradesh,8,16785,56,8,16785,56,16849,16849,2021-04-05 20:01:03.651563
Assam,1945,215549,1107,1964,215597,1109,218670,218601,2021-04-05 20:01:03.651563
Bihar,2943,262988,1582,3561,263233,1583,268377,267513,2021-04-05 20:01:03.651563
Chandigarh,3162,24309,382,3150,24661,383,28194,27853,2021-04-05 20:01:03.651563
Chhattisgarh,36312,323201,4283,38450,326277,4319,369046,363796,2021-04-05 20:01:03.651563
Dadra and Nagar Haveli and Daman and Diu,199,3518,2,204,3538,2,3744,3719,2021-04-05 20:01:03.651563
Delhi,12647,648674,11060,13982,651351,11081,676414,672381,2021-04-05 20:01:03.651563
Goa,1980,55989,834,2077,56156,835,59068,58803,2021-04-05 20:01:03.651563
Gujarat,14298,296713,4552,15135,298737,4566,318438,315563,2021-04-05 20:01:03.651563
Haryana,11787,281258,3184,12574,282368,3191,298133,296229,2021-04-05 20:01:03.651563
Himachal Pradesh,3441,60337,1060,3577,60595,1070,65242,64838,2021-04-05 20:01:03.651563
Jammu and Kashmir,3574,126860,2005,3955,127049,2008,133012,132439,2021-04-05 20:01:03.651563
Jharkhand,4613,120723,1122,5244,120872,1130,127246,126458,2021-04-05 20:01:03.651563
Karnataka,36633,961359,12610,39111,963419,12625,1015155,1010602,2021-04-05 20:01:03.651563
Kerala,27587,1100186,4658,28206,1102359,4668,1135233,1132431,2021-04-05 20:01:03.651563
Ladakh,306,9790,130,323,9802,130,10255,10226,2021-04-05 20:01:03.651563
Lakshadweep,38,701,1,36,704,1,741,740,2021-04-05 20:01:03.651563
Madhya Pradesh,20369,279275,4029,21335,281476,4040,306851,303673,2021-04-05 20:01:03.651563
Maharashtra,402552,2495315,55656,431896,2522823,55878,3010597,2953523,2021-04-05 20:01:03.651563
Manipur,60,28981,374,61,28988,374,29423,29415,2021-04-05 20:01:03.651563
Meghalaya,88,13868,150,102,13870,150,14122,14106,2021-04-05 20:01:03.651563
Mizoram,40,4439,11,41,4439,11,4491,4490,2021-04-05 20:01:03.651563
Nagaland,132,12138,92,133,12138,92,12363,12362,2021-04-05 20:01:03.651563
Odisha,2668,337635,1921,2838,337935,1922,342695,342224,2021-04-05 20:01:03.651563
Puducherry,1474,39974,684,1592,40083,684,42359,42132,2021-04-05 20:01:03.651563
Punjab,25314,216108,7032,25314,219063,7083,251460,248454,2021-04-05 20:01:03.651563
Rajasthan,11738,323031,2827,12878,323618,2829,339325,337596,2021-04-05 20:01:03.651563
Sikkim,48,6068,135,51,6071,135,6257,6251,2021-04-05 20:01:03.651563
Tamil Nadu,20204,863258,12764,21958,865071,12778,899807,896226,2021-04-05 20:01:03.651563
Telengana,7923,302500,1717,8746,302768,1723,313237,312140,2021-04-05 20:01:03.651563
Tripura,70,33075,392,63,33085,392,33540,33537,2021-04-05 20:01:03.651563
Uttarakhand,2638,97351,1725,3017,97520,1727,102264,101714,2021-04-05 20:01:03.651563
Uttar Pradesh,16496,600577,8850,19738,601440,8881,630059,625923,2021-04-05 20:01:03.651563
West Bengal,8844,572474,10340,10153,573118,10344,593615,591658,2021-04-05 20:01:03.651563
Andaman and Nicobar Islands,57,4990,62,53,5001,62,5116,5109,2021-04-06 20:59:03.390008
Andhra Pradesh,10300,890137,7239,10710,891048,7244,909002,907676,2021-04-06 20:59:03.390008
Arunachal Pradesh,8,16785,56,10,16785,56,16851,16849,2021-04-06 20:59:03.390008
Assam,1964,215597,1109,1974,215657,1109,218740,218670,2021-04-06 20:59:03.390008
Bihar,3561,263233,1583,4144,263582,1586,269312,268377,2021-04-06 20:59:03.390008
Chandigarh,3150,24661,383,3062,25033,384,28479,28194,2021-04-06 20:59:03.390008
Chhattisgarh,38450,326277,4319,44296,327689,4363,376348,369046,2021-04-06 20:59:03.390008
Dadra and Nagar Haveli and Daman and Diu,204,3538,2,212,3556,2,3770,3744,2021-04-06 20:59:03.390008
Delhi,13982,651351,11081,14589,654277,11096,679962,676414,2021-04-06 20:59:03.390008
Goa,2077,56156,835,2180,56298,837,59315,59068,2021-04-06 20:59:03.390008
Gujarat,15135,298737,4566,16252,300765,4581,321598,318438,2021-04-06 20:59:03.390008
Haryana,12574,282368,3191,13105,283869,3199,300173,298133,2021-04-06 20:59:03.390008
Himachal Pradesh,3577,60595,1070,3828,60905,1076,65809,65242,2021-04-06 20:59:03.390008
Jammu and Kashmir,3955,127049,2008,4154,127290,2010,133454,133012,2021-04-06 20:59:03.390008
Jharkhand,5244,120872,1130,5882,121310,1140,128332,127246,2021-04-06 20:59:03.390008
Karnataka,39111,963419,12625,42502,965275,12657,1020434,1015155,2021-04-06 20:59:03.390008
Kerala,28206,1102359,4668,28685,1104225,4680,1137590,1135233,2021-04-06 20:59:03.390008
Ladakh,323,9802,130,363,9810,130,10303,10255,2021-04-06 20:59:03.390008
Lakshadweep,36,704,1,31,712,1,744,741,2021-04-06 20:59:03.390008
Madhya Pradesh,21335,281476,4040,22654,283540,4055,310249,306851,2021-04-06 20:59:03.390008
Maharashtra,431896,2522823,55878,452777,2549075,56033,3057885,3010597,2021-04-06 20:59:03.390008
Manipur,61,28988,374,57,28997,374,29428,29423,2021-04-06 20:59:03.390008
Meghalaya,102,13870,150,99,13877,150,14126,14122,2021-04-06 20:59:03.390008
Mizoram,41,4439,11,45,4444,11,4500,4491,2021-04-06 20:59:03.390008
Nagaland,133,12138,92,135,12138,92,12365,12363,2021-04-06 20:59:03.390008
Odisha,2838,337935,1922,3196,338150,1922,343268,342695,2021-04-06 20:59:03.390008
Puducherry,1592,40083,684,1677,40178,684,42539,42359,2021-04-06 20:59:03.390008
Punjab,25314,219063,7083,25419,221578,7155,254152,251460,2021-04-06 20:59:03.390008
Rajasthan,12878,323618,2829,14768,324145,2841,341754,339325,2021-04-06 20:59:03.390008
Sikkim,51,6071,135,56,6071,136,6263,6257,2021-04-06 20:59:03.390008
Tamil Nadu,21958,865071,12778,23777,866913,12789,903479,899807,2021-04-06 20:59:03.390008
Telengana,8746,302768,1723,9993,303013,1729,314735,313237,2021-04-06 20:59:03.390008
Tripura,63,33085,392,71,33091,392,33554,33540,2021-04-06 20:59:03.390008
Uttarakhand,3017,97520,1727,3201,97881,1729,102811,102264,2021-04-06 20:59:03.390008
Uttar Pradesh,19738,601440,8881,22820,602319,8894,634033,630059,2021-04-06 20:59:03.390008
West Bengal,10153,573118,10344,11446,573782,10348,595576,593615,2021-04-06 20:59:03.390008
Andaman and Nicobar Islands,53,5001,62,51,5010,62,5123,5116,2021-04-07 20:06:38.143558
Andhra Pradesh,10710,891048,7244,11809,891883,7251,910943,909002,2021-04-07 20:06:38.143558
Arunachal Pradesh,10,16785,56,11,16786,56,16853,16851,2021-04-07 20:06:38.143558
Assam,1974,215657,1109,2030,215691,1111,218832,218740,2021-04-07 20:06:38.143558
Bihar,4144,263582,1586,4955,263849,1588,270392,269312,2021-04-07 20:06:38.143558
Chandigarh,3062,25033,384,3037,25375,386,28798,28479,2021-04-07 20:06:38.143558
Chhattisgarh,44296,327689,4363,52445,329408,4416,386269,376348,2021-04-07 20:06:38.143558
Dadra and Nagar Haveli and Daman and Diu,212,3556,2,196,3590,2,3788,3770,2021-04-07 20:06:38.143558
Delhi,14589,654277,11096,17332,656617,11113,685062,679962,2021-04-07 20:06:38.143558
Goa,2180,56298,837,2471,56393,838,59702,59315,2021-04-07 20:06:38.143558
Gujarat,16252,300765,4581,17348,302932,4598,324878,321598,2021-04-07 20:06:38.143558
Haryana,13105,283869,3199,14080,284984,3208,302272,300173,2021-04-07 20:06:38.143558
Himachal Pradesh,3828,60905,1076,3740,61416,1081,66237,65809,2021-04-07 20:06:38.143558
Jammu and Kashmir,4154,127290,2010,4483,127520,2012,134015,133454,2021-04-07 20:06:38.143558
Jharkhand,5882,121310,1140,6844,121608,1144,129596,128332,2021-04-07 20:06:38.143558
Karnataka,42502,965275,12657,45126,968762,12696,1026584,1020434,2021-04-07 20:06:38.143558
Kerala,28685,1104225,4680,30275,1106123,4694,1141092,1137590,2021-04-07 20:06:38.143558
Ladakh,363,9810,130,399,9824,130,10353,10303,2021-04-07 20:06:38.143558
Lakshadweep,31,712,1,38,712,1,751,744,2021-04-07 20:06:38.143558
Madhya Pradesh,22654,283540,4055,24155,285743,4073,313971,310249,2021-04-07 20:06:38.143558
Maharashtra,452777,2549075,56033,473693,2583331,56330,3113354,3057885,2021-04-07 20:06:38.143558
Manipur,57,28997,374,63,28998,374,29435,29428,2021-04-07 20:06:38.143558
Meghalaya,99,13877,150,104,13881,150,14135,14126,2021-04-07 20:06:38.143558
Mizoram,45,4444,11,50,4447,11,4508,4500,2021-04-07 20:06:38.143558
Nagaland,135,12138,92,133,12140,92,12365,12365,2021-04-07 20:06:38.143558
Odisha,3196,338150,1922,3518,338416,1922,343856,343268,2021-04-07 20:06:38.143558
Puducherry,1677,40178,684,1773,40317,686,42776,42539,2021-04-07 20:06:38.143558
Punjab,25419,221578,7155,25913,223928,7216,257057,254152,2021-04-07 20:06:38.143558
Rajasthan,14768,324145,2841,16140,324996,2854,343990,341754,2021-04-07 20:06:38.143558
Sikkim,56,6071,136,65,6085,136,6286,6263,2021-04-07 20:06:38.143558
Tamil Nadu,23777,866913,12789,25598,868722,12804,907124,903479,2021-04-07 20:06:38.143558
Telengana,9993,303013,1729,11617,303298,1734,316649,314735,2021-04-07 20:06:38.143558
Tripura,71,33091,392,90,33092,393,33575,33554,2021-04-07 20:06:38.143558
Uttarakhand,3201,97881,1729,3607,98259,1736,103602,102811,2021-04-07 20:06:38.143558
Uttar Pradesh,22820,602319,8894,27509,603495,8924,639928,634033,2021-04-07 20:06:38.143558
West Bengal,11446,573782,10348,12775,574504,10355,597634,595576,2021-04-07 20:06:38.143558
Andaman and Nicobar Islands,51,5010,62,49,5020,62,5131,5123,2021-04-08 20:32:06.152284
Andhra Pradesh,11809,891883,7251,13276,892736,7262,913274,910943,2021-04-08 20:32:06.152284
Arunachal Pradesh,11,16786,56,17,16788,56,16861,16853,2021-04-08 20:32:06.152284
Assam,2030,215691,1111,2194,215722,1111,219027,218832,2021-04-08 20:32:06.152284
Bihar,4955,263849,1588,5926,264402,1591,271919,270392,2021-04-08 20:32:06.152284
Chandigarh,3037,25375,386,3121,25688,388,29197,28798,2021-04-08 20:32:06.152284
Chhattisgarh,52445,329408,4416,58883,333227,4469,396579,386269,2021-04-08 20:32:06.152284
Dadra and Nagar Haveli and Daman and Diu,196,3590,2,191,3619,2,3812,3788,2021-04-08 20:32:06.152284
Delhi,17332,656617,11113,19455,659980,11133,690568,685062,2021-04-08 20:32:06.152284
Goa,2471,56393,838,2858,56531,840,60229,59702,2021-04-08 20:32:06.152284
Gujarat,17348,302932,4598,18684,305149,4620,328453,324878,2021-04-08 20:32:06.152284
Haryana,14080,284984,3208,15237,286182,3219,304638,302272,2021-04-08 20:32:06.152284
Himachal Pradesh,3740,61416,1081,4158,61642,1090,66890,66237,2021-04-08 20:32:06.152284
Jammu and Kashmir,4483,127520,2012,5035,127774,2018,134827,134015,2021-04-08 20:32:06.152284
Jharkhand,6844,121608,1144,7872,121885,1151,130908,129596,2021-04-08 20:32:06.152284
Karnataka,45126,968762,12696,49273,971556,12731,1033560,1026584,2021-04-08 20:32:06.152284
Kerala,30275,1106123,4694,31806,1108078,4710,1144594,1141092,2021-04-08 20:32:06.152284
Ladakh,399,9824,130,446,9836,130,10412,10353,2021-04-08 20:32:06.152284
Lakshadweep,38,712,1,53,716,1,770,751,2021-04-08 20:32:06.152284
Madhya Pradesh,24155,285743,4073,26059,287869,4086,318014,313971,2021-04-08 20:32:06.152284
Maharashtra,473693,2583331,56330,502982,2613627,56652,3173261,3113354,2021-04-08 20:32:06.152284
Manipur,63,28998,374,75,28998,374,29447,29435,2021-04-08 20:32:06.152284
Meghalaya,104,13881,150,108,13882,150,14140,14135,2021-04-08 20:32:06.152284
Mizoram,50,4447,11,60,4451,11,4522,4508,2021-04-08 20:32:06.152284
Nagaland,133,12140,92,141,12143,92,12376,12365,2021-04-08 20:32:06.152284
Odisha,3518,338416,1922,4062,338662,1923,344647,343856,2021-04-08 20:32:06.152284
Puducherry,1773,40317,686,1820,40442,687,42949,42776,2021-04-08 20:32:06.152284
Punjab,25913,223928,7216,25855,226887,7278,260020,257057,2021-04-08 20:32:06.152284
Rajasthan,16140,324996,2854,18146,325779,2866,346791,343990,2021-04-08 20:32:06.152284
Sikkim,65,6085,136,95,6086,136,6317,6286,2021-04-08 20:32:06.152284
Tamil Nadu,25598,868722,12804,27743,870546,12821,911110,907124,2021-04-08 20:32:06.152284
Telengana,11617,303298,1734,13712,303601,1741,319054,316649,2021-04-08 20:32:06.152284
Tripura,90,33092,393,124,33095,393,33612,33575,2021-04-08 20:32:06.152284
Uttarakhand,3607,98259,1736,4526,98444,1741,104711,103602,2021-04-08 20:32:06.152284
Uttar Pradesh,27509,603495,8924,31987,604979,8964,645930,639928,2021-04-08 20:32:06.152284
West Bengal,12775,574504,10355,14290,575371,10363,600024,597634,2021-04-08 20:32:06.152284
Andaman and Nicobar Islands,49,5020,62,60,5027,62,5149,5131,2021-04-09 20:22:02.498399
Andhra Pradesh,13276,892736,7262,14913,893651,7268,915832,913274,2021-04-09 20:22:02.498399
Arunachal Pradesh,17,16788,56,29,16788,56,16873,16861,2021-04-09 20:22:02.498399
Assam,2194,215722,1111,2370,215790,1112,219272,219027,2021-04-09 20:22:02.498399
Bihar,5926,264402,1591,7505,264730,1595,273830,271919,2021-04-09 20:22:02.498399
Chandigarh,3121,25688,388,3115,26017,389,29521,29197,2021-04-09 20:22:02.498399
Chhattisgarh,58883,333227,4469,68125,334543,4563,407231,396579,2021-04-09 20:22:02.498399
Dadra and Nagar Haveli and Daman and Diu,191,3619,2,209,3631,2,3842,3812,2021-04-09 20:22:02.498399
Delhi,19455,659980,11133,23181,663667,11157,698005,690568,2021-04-09 20:22:02.498399
Goa,2858,56531,840,3331,56638,842,60811,60229,2021-04-09 20:22:02.498399
Gujarat,18684,305149,4620,20473,307346,4655,332474,328453,2021-04-09 20:22:02.498399
Haryana,15237,286182,3219,17129,287151,3230,307510,304638,2021-04-09 20:22:02.498399
Himachal Pradesh,4158,61642,1090,4513,61902,1096,67511,66890,2021-04-09 20:22:02.498399
Jammu and Kashmir,5035,127774,2018,5623,128020,2019,135662,134827,2021-04-09 20:22:02.498399
Jharkhand,7872,121885,1151,9249,122383,1158,132790,130908,2021-04-09 20:22:02.498399
Karnataka,49273,971556,12731,53414,973949,12767,1040130,1033560,2021-04-09 20:22:02.498399
Kerala,31806,1108078,4710,33936,1110283,4728,1148947,1144594,2021-04-09 20:22:02.498399
Ladakh,446,9836,130,505,9868,130,10503,10412,2021-04-09 20:22:02.498399
Lakshadweep,53,716,1,58,719,1,778,770,2021-04-09 20:22:02.498399
Madhya Pradesh,26059,287869,4086,28060,290165,4113,322338,318014,2021-04-09 20:22:02.498399
Maharashtra,502982,2613627,56652,522762,2649757,57028,3229547,3173261,2021-04-09 20:22:02.498399
Manipur,75,28998,374,87,29001,375,29463,29447,2021-04-09 20:22:02.498399
Meghalaya,108,13882,150,131,13883,151,14165,14140,2021-04-09 20:22:02.498399
Mizoram,60,4451,11,93,4454,11,4558,4522,2021-04-09 20:22:02.498399
Nagaland,141,12143,92,146,12143,92,12381,12376,2021-04-09 20:22:02.498399
Odisha,4062,338662,1923,4713,338890,1923,345526,344647,2021-04-09 20:22:02.498399
Puducherry,1820,40442,687,2000,40555,687,43242,42949,2021-04-09 20:22:02.498399
Punjab,25855,226887,7278,26389,229367,7334,263090,260020,2021-04-09 20:22:02.498399
Rajasthan,18146,325779,2866,21152,326299,2866,350317,346791,2021-04-09 20:22:02.498399
Sikkim,95,6086,136,97,6090,136,6323,6317,2021-04-09 20:22:02.498399
Tamil Nadu,27743,870546,12821,30131,872415,12840,915386,911110,2021-04-09 20:22:02.498399
Telengana,13712,303601,1741,15472,303964,1746,321182,319054,2021-04-09 20:22:02.498399
Tripura,124,33095,393,148,33103,393,33644,33612,2021-04-09 20:22:02.498399
Uttarakhand,4526,98444,1741,5042,98712,1744,105498,104711,2021-04-09 20:22:02.498399
Uttar Pradesh,31987,604979,8964,39338,606063,9003,654404,645930,2021-04-09 20:22:02.498399
West Bengal,14290,575371,10363,16109,576328,10370,602807,600024,2021-04-09 20:22:02.498399
Andaman and Nicobar Islands,60,5027,62,71,5028,62,5161,5149,2021-04-10 22:47:06.913987
Andhra Pradesh,14913,893651,7268,16422,894896,7279,918597,915832,2021-04-10 22:47:06.913987
Arunachal Pradesh,29,16788,56,30,16789,56,16875,16873,2021-04-10 22:47:06.913987
Assam,2370,215790,1112,2610,215828,1115,219553,219272,2021-04-10 22:47:06.913987
Bihar,7505,264730,1595,9358,265048,1598,276004,273830,2021-04-10 22:47:06.913987
Chandigarh,3115,26017,389,3213,26337,393,29943,29521,2021-04-10 22:47:06.913987
Chhattisgarh,68125,334543,4563,76868,337156,4654,418678,407231,2021-04-10 22:47:06.913987
Dadra and Nagar Haveli and Daman and Diu,209,3631,2,230,3652,2,3884,3842,2021-04-10 22:47:06.913987
Delhi,23181,663667,11157,26631,668699,11196,706526,698005,2021-04-10 22:47:06.913987
Goa,3331,56638,842,3597,56797,845,61239,60811,2021-04-10 22:47:06.913987
Gujarat,20473,307346,4655,22692,309626,4697,337015,332474,2021-04-10 22:47:06.913987
Haryana,17129,287151,3230,18142,289121,3241,310504,307510,2021-04-10 22:47:06.913987
Himachal Pradesh,4513,61902,1096,4659,62411,1103,68173,67511,2021-04-10 22:47:06.913987
Jammu and Kashmir,5623,128020,2019,6115,128332,2023,136470,135662,2021-04-10 22:47:06.913987
Jharkhand,9249,122383,1158,10604,122936,1175,134715,132790,2021-04-10 22:47:06.913987
Karnataka,53414,973949,12767,58103,977169,12813,1048085,1040130,2021-04-10 22:47:06.913987
Kerala,33936,1110283,4728,36502,1112758,4750,1154010,1148947,2021-04-10 22:47:06.913987
Ladakh,505,9868,130,557,9932,130,10619,10503,2021-04-10 22:47:06.913987
Lakshadweep,58,719,1,55,728,1,784,778,2021-04-10 22:47:06.913987
Madhya Pradesh,28060,290165,4113,30486,292598,4136,327220,322338,2021-04-10 22:47:06.913987
Maharashtra,522762,2649757,57028,536063,2695148,57329,3288540,3229547,2021-04-10 22:47:06.913987
Manipur,87,29001,375,91,29009,375,29475,29463,2021-04-10 22:47:06.913987
Meghalaya,131,13883,151,167,13889,151,14207,14165,2021-04-10 22:47:06.913987
Mizoram,93,4454,11,115,4457,11,4583,4558,2021-04-10 22:47:06.913987
Nagaland,146,12143,92,146,12150,92,12388,12381,2021-04-10 22:47:06.913987
Odisha,4713,338890,1923,5684,339200,1924,346808,345526,2021-04-10 22:47:06.913987
Puducherry,2000,40555,687,2084,40694,687,43465,43242,2021-04-10 22:47:06.913987
Punjab,26389,229367,7334,27219,231885,7390,266494,263090,2021-04-10 22:47:06.913987
Rajasthan,21152,326299,2866,24085,327304,2898,354287,350317,2021-04-10 22:47:06.913987
Sikkim,97,6090,136,101,6092,136,6329,6323,2021-04-10 22:47:06.913987
Tamil Nadu,30131,872415,12840,33659,874305,12863,920827,915386,2021-04-10 22:47:06.913987
Telengana,15472,303964,1746,17791,304548,1752,324091,321182,2021-04-10 22:47:06.913987
Tripura,148,33103,393,188,33104,393,33685,33644,2021-04-10 22:47:06.913987
Uttarakhand,5042,98712,1744,5384,99113,1749,106246,105498,2021-04-10 22:47:06.913987
Uttar Pradesh,39338,606063,9003,48306,606646,9039,663991,654404,2021-04-10 22:47:06.913987
West Bengal,16109,576328,10370,18603,577474,10378,606455,602807,2021-04-10 22:47:06.913987
Andaman and Nicobar Islands,71,5028,62,75,5038,62,5175,5161,2021-04-11 21:05:36.913025
Andhra Pradesh,16422,894896,7279,18666,895949,7291,921906,918597,2021-04-11 21:05:36.913025
Arunachal Pradesh,30,16789,56,32,16790,56,16878,16875,2021-04-11 21:05:36.913025
Assam,2610,215828,1115,2934,215907,1117,219958,219553,2021-04-11 21:05:36.913025
Bihar,9358,265048,1598,11999,265870,1604,279473,276004,2021-04-11 21:05:36.913025
Chandigarh,3213,26337,393,3265,26680,396,30341,29943,2021-04-11 21:05:36.913025
Chhattisgarh,76868,337156,4654,85860,342139,4777,432776,418678,2021-04-11 21:05:36.913025
Dadra and Nagar Haveli and Daman and Diu,230,3652,2,345,3667,2,4014,3884,2021-04-11 21:05:36.913025
Delhi,26631,668699,11196,28773,674415,11235,714423,706526,2021-04-11 21:05:36.913025
Goa,3597,56797,845,3969,56964,846,61779,61239,2021-04-11 21:05:36.913025
Gujarat,22692,309626,4697,25129,312151,4746,342026,337015,2021-04-11 21:05:36.913025
Haryana,18142,289121,3241,19453,290736,3252,313441,310504,2021-04-11 21:05:36.913025
Himachal Pradesh,4659,62411,1103,5223,62776,1115,69114,68173,2021-04-11 21:05:36.913025
Jammu and Kashmir,6115,128332,2023,6755,128691,2029,137475,136470,2021-04-11 21:05:36.913025
Jharkhand,10604,122936,1175,12293,123603,1192,137088,134715,2021-04-11 21:05:36.913025
Karnataka,58103,977169,12813,61672,980519,12849,1055040,1048085,2021-04-11 21:05:36.913025
Kerala,36502,1112758,4750,40095,1115342,4767,1160204,1154010,2021-04-11 21:05:36.913025
Ladakh,557,9932,130,611,10023,131,10765,10619,2021-04-11 21:05:36.913025
Lakshadweep,55,728,1,60,733,1,794,784,2021-04-11 21:05:36.913025
Madhya Pradesh,30486,292598,4136,32707,295339,4160,332206,327220,2021-04-11 21:05:36.913025
Maharashtra,536063,2695148,57329,538160,2748153,57638,3343951,3288540,2021-04-11 21:05:36.913025
Manipur,91,29009,375,101,29010,375,29486,29475,2021-04-11 21:05:36.913025
Meghalaya,167,13889,151,202,13893,151,14246,14207,2021-04-11 21:05:36.913025
Mizoram,115,4457,11,143,4458,11,4612,4583,2021-04-11 21:05:36.913025
Nagaland,146,12150,92,156,12152,92,12400,12388,2021-04-11 21:05:36.913025
Odisha,5684,339200,1924,6653,339603,1926,348182,346808,2021-04-11 21:05:36.913025
Puducherry,2084,40694,687,2218,40830,689,43737,43465,2021-04-11 21:05:36.913025
Punjab,27219,231885,7390,28015,234270,7448,269733,266494,2021-04-11 21:05:36.913025
Rajasthan,24085,327304,2898,27906,327866,2916,358688,354287,2021-04-11 21:05:36.913025
Sikkim,101,6092,136,116,6099,136,6351,6329,2021-04-11 21:05:36.913025
Tamil Nadu,33659,874305,12863,37673,876257,12886,926816,920827,2021-04-11 21:05:36.913025
Telengana,17791,304548,1752,20184,305335,1759,327278,324091,2021-04-11 21:05:36.913025
Tripura,188,33104,393,236,33104,393,33733,33685,2021-04-11 21:05:36.913025
Uttarakhand,5384,99113,1749,6241,99486,1752,107479,106246,2021-04-11 21:05:36.913025
Uttar Pradesh,48306,606646,9039,58801,608853,9085,676739,663991,2021-04-11 21:05:36.913025
West Bengal,18603,577474,10378,21366,578742,10390,610498,606455,2021-04-11 21:05:36.913025
Andaman and Nicobar Islands,75,5038,62,88,5040,62,5190,5175,2021-04-12 20:04:52.572502
Andhra Pradesh,18666,895949,7291,20954,897147,7300,925401,921906,2021-04-12 20:04:52.572502
Arunachal Pradesh,32,16790,56,36,16790,56,16882,16878,2021-04-12 20:04:52.572502
Assam,2934,215907,1117,3249,215943,1118,220310,219958,2021-04-12 20:04:52.572502
Bihar,11999,265870,1604,14696,266923,1610,283229,279473,2021-04-12 20:04:52.572502
Chandigarh,3265,26680,396,3307,27037,399,30743,30341,2021-04-12 20:04:52.572502
Chhattisgarh,85860,342139,4777,90277,348121,4899,443297,432776,2021-04-12 20:04:52.572502
Dadra and Nagar Haveli and Daman and Diu,345,3667,2,394,3687,2,4083,4014,2021-04-12 20:04:52.572502
Delhi,28773,674415,11235,34341,679573,11283,725197,714423,2021-04-12 20:04:52.572502
Goa,3969,56964,846,4322,57134,848,62304,61779,2021-04-12 20:04:52.572502
Gujarat,25129,312151,4746,27568,315127,4800,347495,342026,2021-04-12 20:04:52.572502
Haryana,19453,290736,3252,20981,292632,3268,316881,313441,2021-04-12 20:04:52.572502
Himachal Pradesh,5223,62776,1115,5369,63202,1115,69686,69114,2021-04-12 20:04:52.572502
Jammu and Kashmir,6755,128691,2029,7335,129021,2034,138390,137475,2021-04-12 20:04:52.572502
Jharkhand,12293,123603,1192,13933,124238,1213,139384,137088,2021-04-12 20:04:52.572502
Karnataka,61672,980519,12849,69244,983157,12889,1065290,1055040,2021-04-12 20:04:52.572502
Kerala,40095,1115342,4767,44707,1117700,4783,1167190,1160204,2021-04-12 20:04:52.572502
Ladakh,611,10023,131,612,10037,131,10780,10765,2021-04-12 20:04:52.572502
Lakshadweep,60,733,1,62,736,1,799,794,2021-04-12 20:04:52.572502
Madhya Pradesh,32707,295339,4160,35316,298645,4184,338145,332206,2021-04-12 20:04:52.572502
Maharashtra,538160,2748153,57638,567097,2782161,57987,3407245,3343951,2021-04-12 20:04:52.572502
Manipur,101,29010,375,107,29013,376,29496,29486,2021-04-12 20:04:52.572502
Meghalaya,202,13893,151,189,13933,151,14273,14246,2021-04-12 20:04:52.572502
Mizoram,143,4458,11,143,4464,12,4619,4612,2021-04-12 20:04:52.572502
Nagaland,156,12152,92,157,12155,93,12405,12400,2021-04-12 20:04:52.572502
Odisha,6653,339603,1926,7573,340062,1926,349561,348182,2021-04-12 20:04:52.572502
Puducherry,2218,40830,689,2316,41036,691,44043,43737,2021-04-12 20:04:52.572502
Punjab,28015,234270,7448,27874,237391,7507,272772,269733,2021-04-12 20:04:52.572502
Rajasthan,27906,327866,2916,31986,328881,2926,363793,358688,2021-04-12 20:04:52.572502
Sikkim,116,6099,136,169,6100,136,6405,6351,2021-04-12 20:04:52.572502
Tamil Nadu,37673,876257,12886,41955,878571,12908,933434,926816,2021-04-12 20:04:52.572502
Telengana,20184,305335,1759,21864,305900,1765,329529,327278,2021-04-12 20:04:52.572502
Tripura,236,33104,393,243,33106,394,33743,33733,2021-04-12 20:04:52.572502
Uttarakhand,6241,99486,1752,7323,99729,1760,108812,107479,2021-04-12 20:04:52.572502
Uttar Pradesh,58801,608853,9085,71241,611622,9152,692015,676739,2021-04-12 20:04:52.572502
West Bengal,21366,578742,10390,23981,580515,10400,614896,610498,2021-04-12 20:04:52.572502
Kerala,0,0,0,0,0,0,0,1,30/01/20
Kerala,0,0,0,0,0,0,0,1,31/01/20
Kerala,0,0,0,0,0,0,0,2,01/02/20
Kerala,0,0,0,0,0,0,0,3,02/02/20
Kerala,0,0,0,0,0,0,0,3,03/02/20
Kerala,0,0,0,0,0,0,0,3,04/02/20
Kerala,0,0,0,0,0,0,0,3,05/02/20
Kerala,0,0,0,0,0,0,0,3,06/02/20
Kerala,0,0,0,0,0,0,0,3,07/02/20
Kerala,0,0,0,0,0,0,0,3,08/02/20
Kerala,0,0,0,0,0,0,0,3,09/02/20
Kerala,0,0,0,0,0,0,0,3,10/02/20
Kerala,0,0,0,0,0,0,0,3,11/02/20
Kerala,0,0,0,0,0,0,0,3,12/02/20
Kerala,0,0,0,0,0,0,0,3,13/02/20
Kerala,0,0,0,0,0,0,0,3,14/02/20
Kerala,0,0,0,0,0,0,0,3,15/02/20
Kerala,0,0,0,0,0,0,0,3,16/02/20
Kerala,0,0,0,0,0,0,0,3,17/02/20
Kerala,0,0,0,0,0,0,0,3,18/02/20
Kerala,0,0,0,0,0,0,0,3,19/02/20
Kerala,0,0,0,0,0,0,0,3,20/02/20
Kerala,0,0,0,0,0,0,0,3,21/02/20
Kerala,0,0,0,0,0,0,0,3,22/02/20
Kerala,0,0,0,0,0,0,0,3,23/02/20
Kerala,0,0,0,0,0,0,0,3,24/02/20
Kerala,0,0,0,0,0,0,0,3,25/02/20
Kerala,0,0,0,0,0,0,0,3,26/02/20
Kerala,0,0,0,0,0,0,0,3,27/02/20
Kerala,0,0,0,0,0,0,0,3,28/02/20
Kerala,0,0,0,0,0,0,0,3,29/02/20
Kerala,0,0,0,0,0,0,0,3,01/03/20
Telengana,0,0,0,0,0,0,0,1,02/03/20
Kerala,0,0,0,0,0,0,0,3,02/03/20
Delhi,0,0,0,0,0,0,0,1,02/03/20
Telengana,0,0,0,0,0,0,0,1,03/03/20
Rajasthan,0,0,0,0,0,0,0,1,03/03/20
Kerala,0,3,0,0,0,0,0,3,03/03/20
Delhi,0,0,0,0,0,0,0,1,03/03/20
Uttar Pradesh,0,0,0,0,0,0,0,6,04/03/20
Kerala,0,3,0,0,0,0,0,3,04/03/20
Haryana,0,0,0,0,0,0,0,2,04/03/20
Delhi,0,0,0,0,0,0,0,1,04/03/20
Telengana,0,0,0,0,0,0,0,1,04/03/20
Rajasthan,0,0,0,0,0,0,0,15,04/03/20
Delhi,0,0,0,0,0,0,0,2,05/03/20
Haryana,0,0,0,0,0,0,0,2,05/03/20
Kerala,0,3,0,0,0,0,0,3,05/03/20
Rajasthan,0,0,0,0,0,0,0,15,05/03/20
Telengana,0,0,0,0,0,0,0,1,05/03/20
Uttar Pradesh,0,0,0,0,0,0,0,7,05/03/20
Delhi,0,0,0,0,0,0,0,3,06/03/20
Haryana,0,0,0,0,0,0,0,2,06/03/20
Kerala,0,3,0,0,0,0,0,3,06/03/20
Rajasthan,0,0,0,0,0,0,0,15,06/03/20
Uttar Pradesh,0,0,0,0,0,0,0,7,06/03/20
Telengana,0,0,0,0,0,0,0,1,06/03/20
Kerala,0,3,0,0,0,0,0,3,07/03/20
Uttar Pradesh,0,0,0,0,0,0,0,7,07/03/20
Ladakh,0,0,0,0,0,0,0,2,07/03/20
Telengana,0,0,0,0,0,0,0,1,07/03/20
Tamil Nadu,0,0,0,0,0,0,0,1,07/03/20
Delhi,0,0,0,0,0,0,0,3,07/03/20
Haryana,0,0,0,0,0,0,0,2,07/03/20
Rajasthan,0,0,0,0,0,0,0,15,07/03/20
Ladakh,0,0,0,0,0,0,0,2,08/03/20
Telengana,0,0,0,0,0,0,0,1,08/03/20
Tamil Nadu,0,0,0,0,0,0,0,1,08/03/20
Rajasthan,0,0,0,0,0,0,0,15,08/03/20
Kerala,0,3,0,0,0,0,0,8,08/03/20
Haryana,0,0,0,0,0,0,0,2,08/03/20
Delhi,0,0,0,0,0,0,0,3,08/03/20
Uttar Pradesh,0,0,0,0,0,0,0,7,08/03/20
Ladakh,0,0,0,0,0,0,0,2,09/03/20
Karnataka,0,0,0,0,0,0,0,1,09/03/20
Kerala,0,3,0,0,0,0,0,9,09/03/20
Maharashtra,0,0,0,0,0,0,0,2,09/03/20
Punjab,0,0,0,0,0,0,0,1,09/03/20
Rajasthan,0,0,0,0,0,0,0,15,09/03/20
Tamil Nadu,0,0,0,0,0,0,0,1,09/03/20
Telengana,0,0,0,0,0,0,0,1,09/03/20
Jammu and Kashmir,0,0,0,0,0,0,0,1,09/03/20
Uttar Pradesh,0,0,0,0,0,0,0,7,09/03/20
Haryana,0,0,0,0,0,0,0,2,09/03/20
Delhi,0,0,0,0,0,0,0,4,09/03/20
Uttar Pradesh,0,0,0,0,0,0,0,7,10/03/20
Ladakh,0,0,0,0,0,0,0,2,10/03/20
Delhi,0,0,0,0,0,0,0,4,10/03/20
Haryana,0,0,0,0,0,0,0,2,10/03/20
Karnataka,0,0,0,0,0,0,0,4,10/03/20
Kerala,0,3,0,0,0,0,0,15,10/03/20
Maharashtra,0,0,0,0,0,0,0,5,10/03/20
Punjab,0,0,0,0,0,0,0,1,10/03/20
Rajasthan,0,0,0,0,0,0,0,15,10/03/20
Tamil Nadu,0,0,0,0,0,0,0,1,10/03/20
Telengana,0,0,0,0,0,0,0,1,10/03/20
Jammu and Kashmir,0,0,0,0,0,0,0,1,10/03/20
Maharashtra,0,0,0,0,0,0,0,2,11/03/20
Delhi,0,0,0,0,0,0,0,5,11/03/20
Haryana,0,0,0,0,0,0,0,14,11/03/20
Kerala,0,3,0,0,0,0,0,17,11/03/20
Rajasthan,0,0,0,0,0,0,0,3,11/03/20
Telengana,0,0,0,0,0,0,0,1,11/03/20
Uttar Pradesh,0,0,0,0,0,0,0,9,11/03/20
Ladakh,0,0,0,0,0,0,0,2,11/03/20
Tamil Nadu,0,0,0,0,0,0,0,1,11/03/20
Jammu and Kashmir,0,0,0,0,0,0,0,1,11/03/20
Punjab,0,0,0,0,0,0,0,1,11/03/20
Karnataka,0,0,0,0,0,0,0,4,11/03/20
Delhi,0,0,0,0,0,0,0,6,12/03/20
Haryana,0,0,0,0,0,0,0,14,12/03/20
Kerala,0,3,0,0,0,0,0,17,12/03/20
Rajasthan,0,0,0,0,0,0,0,3,12/03/20
Telengana,0,0,0,0,0,0,0,1,12/03/20
Uttar Pradesh,0,0,0,0,0,0,0,11,12/03/20
Ladakh,0,0,0,0,0,0,0,3,12/03/20
Tamil Nadu,0,0,0,0,0,0,0,1,12/03/20
Jammu and Kashmir,0,0,0,0,0,0,0,1,12/03/20
Punjab,0,0,0,0,0,0,0,1,12/03/20
Karnataka,0,0,0,0,0,0,0,4,12/03/20
Maharashtra,0,0,0,0,0,0,0,11,12/03/20
Andhra Pradesh,0,0,0,0,0,0,0,1,12/03/20
Delhi,0,0,0,0,0,0,0,6,13/03/20
Haryana,0,0,0,0,0,0,0,14,13/03/20
Kerala,0,3,0,0,0,0,0,19,13/03/20
Rajasthan,0,0,0,0,0,0,0,3,13/03/20
Telengana,0,0,0,0,0,0,0,1,13/03/20
Uttar Pradesh,0,0,0,0,0,0,0,11,13/03/20
Ladakh,0,0,0,0,0,0,0,3,13/03/20
Tamil Nadu,0,0,0,0,0,0,0,1,13/03/20
Jammu and Kashmir,0,0,0,0,0,0,0,1,13/03/20
Punjab,0,0,0,0,0,0,0,1,13/03/20
Karnataka,0,0,1,0,0,0,0,6,13/03/20
Maharashtra,0,0,0,0,0,0,0,14,13/03/20
Andhra Pradesh,0,0,0,0,0,0,0,1,13/03/20
Delhi,0,1,1,0,0,0,0,7,14/03/20
Haryana,0,0,0,0,0,0,0,14,14/03/20
Kerala,0,3,0,0,0,0,0,19,14/03/20
Rajasthan,0,1,0,0,0,0,0,3,14/03/20
Telengana,0,0,0,0,0,0,0,1,14/03/20
Uttar Pradesh,0,5,0,0,0,0,0,12,14/03/20
Ladakh,0,0,0,0,0,0,0,3,14/03/20
Tamil Nadu,0,0,0,0,0,0,0,1,14/03/20
Jammu and Kashmir,0,0,0,0,0,0,0,2,14/03/20
Punjab,0,0,0,0,0,0,0,1,14/03/20
Karnataka,0,0,1,0,0,0,0,6,14/03/20
Maharashtra,0,0,0,0,0,0,0,14,14/03/20
Andhra Pradesh,0,0,0,0,0,0,0,1,14/03/20
Andhra Pradesh,0,0,0,0,0,0,0,1,15/03/20
Delhi,0,2,1,0,0,0,0,7,15/03/20
Haryana,0,0,0,0,0,0,0,14,15/03/20
Karnataka,0,0,1,0,0,0,0,6,15/03/20
Kerala,0,3,0,0,0,0,0,22,15/03/20
Maharashtra,0,0,0,0,0,0,0,32,15/03/20
Punjab,0,0,0,0,0,0,0,1,15/03/20
Rajasthan,0,3,0,0,0,0,0,4,15/03/20
Tamil Nadu,0,0,0,0,0,0,0,1,15/03/20
Telengana,0,1,0,0,0,0,0,3,15/03/20
Jammu and Kashmir,0,0,0,0,0,0,0,2,15/03/20
Ladakh,0,0,0,0,0,0,0,3,15/03/20
Uttar Pradesh,0,4,0,0,0,0,0,13,15/03/20
Uttarakhand,0,0,0,0,0,0,0,1,15/03/20
Andhra Pradesh,0,0,0,0,0,0,0,1,16/03/20
Delhi,0,2,1,0,0,0,0,7,16/03/20
Haryana,0,0,0,0,0,0,0,14,16/03/20
Karnataka,0,0,1,0,0,0,0,6,16/03/20
Kerala,0,3,0,0,0,0,0,23,16/03/20
Maharashtra,0,0,0,0,0,0,0,32,16/03/20
Odisha,0,0,0,0,0,0,0,1,16/03/20
Punjab,0,0,0,0,0,0,0,1,16/03/20
Rajasthan,0,3,0,0,0,0,0,4,16/03/20
Tamil Nadu,0,0,0,0,0,0,0,1,16/03/20
Telengana,0,1,0,0,0,0,0,3,16/03/20
Jammu and Kashmir,0,0,0,0,0,0,0,3,16/03/20
Ladakh,0,0,0,0,0,0,0,4,16/03/20
Uttar Pradesh,0,4,0,0,0,0,0,13,16/03/20
Uttarakhand,0,0,0,0,0,0,0,1,16/03/20
Andhra Pradesh,0,0,0,0,0,0,0,1,17/03/20
Delhi,0,2,1,0,0,0,0,8,17/03/20
Haryana,0,0,0,0,0,0,0,15,17/03/20
Karnataka,0,0,1,0,0,0,0,11,17/03/20
Kerala,0,3,0,0,0,0,0,26,17/03/20
Maharashtra,0,0,1,0,0,0,0,39,17/03/20
Odisha,0,0,0,0,0,0,0,1,17/03/20
Punjab,0,0,0,0,0,0,0,1,17/03/20
Rajasthan,0,3,0,0,0,0,0,4,17/03/20
Tamil Nadu,0,0,0,0,0,0,0,1,17/03/20
Telengana,0,1,0,0,0,0,0,5,17/03/20
Jammu and Kashmir,0,0,0,0,0,0,0,3,17/03/20
Ladakh,0,0,0,0,0,0,0,6,17/03/20
Uttar Pradesh,0,5,0,0,0,0,0,15,17/03/20
Uttarakhand,0,0,0,0,0,0,0,1,17/03/20
Andhra Pradesh,0,0,0,0,0,0,0,1,18/03/20
Delhi,0,2,1,0,0,0,0,10,18/03/20
Haryana,0,0,0,0,0,0,0,17,18/03/20
Karnataka,0,0,1,0,0,0,0,11,18/03/20
Kerala,0,3,0,0,0,0,0,27,18/03/20
Maharashtra,0,0,1,0,0,0,0,42,18/03/20
Odisha,0,0,0,0,0,0,0,1,18/03/20
Puducherry,0,0,0,0,0,0,0,1,18/03/20
Punjab,0,0,0,0,0,0,0,1,18/03/20
Rajasthan,0,3,0,0,0,0,0,4,18/03/20
Tamil Nadu,0,0,0,0,0,0,0,1,18/03/20
Telengana,0,1,0,0,0,0,0,6,18/03/20
Jammu and Kashmir,0,0,0,0,0,0,0,3,18/03/20
Ladakh,0,0,0,0,0,0,0,8,18/03/20
Uttar Pradesh,0,5,0,0,0,0,0,16,18/03/20
Uttarakhand,0,0,0,0,0,0,0,1,18/03/20
West Bengal,0,0,0,0,0,0,0,1,18/03/20
Andhra Pradesh,0,0,0,0,0,0,0,2,19/03/20
Chhattisgarh,0,0,0,0,0,0,0,1,19/03/20
Delhi,0,3,1,0,0,0,0,12,19/03/20
Haryana,0,0,0,0,0,0,0,17,19/03/20
Karnataka,0,0,1,0,0,0,0,14,19/03/20
Kerala,0,3,0,0,0,0,0,27,19/03/20
Maharashtra,0,0,1,0,0,0,0,47,19/03/20
Odisha,0,0,0,0,0,0,0,1,19/03/20
Puducherry,0,0,0,0,0,0,0,1,19/03/20
Punjab,0,0,1,0,0,0,0,2,19/03/20
Rajasthan,0,3,0,0,0,0,0,7,19/03/20
Tamil Nadu,0,1,0,0,0,0,0,2,19/03/20
Telengana,0,1,0,0,0,0,0,6,19/03/20
Chandigarh,0,0,0,0,0,0,0,1,19/03/20
Jammu and Kashmir,0,0,0,0,0,0,0,4,19/03/20
Ladakh,0,0,0,0,0,0,0,8,19/03/20
Uttar Pradesh,0,9,0,0,0,0,0,19,19/03/20
Uttarakhand,0,0,0,0,0,0,0,1,19/03/20
West Bengal,0,0,0,0,0,0,0,1,19/03/20
Andhra Pradesh,0,0,0,0,0,0,0,3,20/03/20
Chhattisgarh,0,0,0,0,0,0,0,1,20/03/20
Delhi,0,5,1,0,0,0,0,17,20/03/20
Gujarat,0,0,0,0,0,0,0,5,20/03/20
Haryana,0,0,0,0,0,0,0,17,20/03/20
Karnataka,0,1,1,0,0,0,0,15,20/03/20
Kerala,0,3,0,0,0,0,0,28,20/03/20
Maharashtra,0,0,1,0,0,0,0,52,20/03/20
Odisha,0,0,0,0,0,0,0,2,20/03/20
Puducherry,0,0,0,0,0,0,0,1,20/03/20
Punjab,0,0,1,0,0,0,0,2,20/03/20
Rajasthan,0,3,0,0,0,0,0,17,20/03/20
Tamil Nadu,0,1,0,0,0,0,0,3,20/03/20
Telengana,0,1,0,0,0,0,0,17,20/03/20
Chandigarh,0,0,0,0,0,0,0,1,20/03/20
Jammu and Kashmir,0,0,0,0,0,0,0,4,20/03/20
Ladakh,0,0,0,0,0,0,0,10,20/03/20
Uttar Pradesh,0,9,0,0,0,0,0,23,20/03/20
Uttarakhand,0,0,0,0,0,0,0,3,20/03/20
West Bengal,0,0,0,0,0,0,0,2,20/03/20
Andhra Pradesh,0,0,0,0,0,0,0,3,21/03/20
Chhattisgarh,0,0,0,0,0,0,0,1,21/03/20
Delhi,0,5,1,0,0,0,0,26,21/03/20
Gujarat,0,0,0,0,0,0,0,7,21/03/20
Haryana,0,0,0,0,0,0,0,17,21/03/20
Himachal Pradesh,0,0,0,0,0,0,0,2,21/03/20
Karnataka,0,1,1,0,0,0,0,15,21/03/20
Kerala,0,3,0,0,0,0,0,40,21/03/20
Madhya Pradesh,0,0,0,0,0,0,0,4,21/03/20
Maharashtra,0,0,1,0,0,0,0,63,21/03/20
Odisha,0,0,0,0,0,0,0,2,21/03/20
Puducherry,0,0,0,0,0,0,0,1,21/03/20
Punjab,0,0,1,0,0,0,0,13,21/03/20
Rajasthan,0,3,0,0,0,0,0,17,21/03/20
Tamil Nadu,0,1,0,0,0,0,0,3,21/03/20
Telengana,0,1,0,0,0,0,0,21,21/03/20
Chandigarh,0,0,0,0,0,0,0,1,21/03/20
Jammu and Kashmir,0,0,0,0,0,0,0,4,21/03/20
Ladakh,0,0,0,0,0,0,0,13,21/03/20
Uttar Pradesh,0,9,0,0,0,0,0,24,21/03/20
Uttarakhand,0,0,0,0,0,0,0,3,21/03/20
West Bengal,0,0,0,0,0,0,0,3,21/03/20
Andhra Pradesh,0,0,0,0,0,0,0,5,22/03/20
Bihar,0,0,1,0,0,0,0,2,22/03/20
Chhattisgarh,0,0,0,0,0,0,0,1,22/03/20
Delhi,0,5,1,0,0,0,0,29,22/03/20
Gujarat,0,0,1,0,0,0,0,18,22/03/20
Haryana,0,0,0,0,0,0,0,21,22/03/20
Himachal Pradesh,0,0,0,0,0,0,0,2,22/03/20
Karnataka,0,2,1,0,0,0,0,26,22/03/20
Kerala,0,3,0,0,0,0,0,52,22/03/20
Madhya Pradesh,0,0,0,0,0,0,0,4,22/03/20
Maharashtra,0,0,2,0,0,0,0,67,22/03/20
Odisha,0,0,0,0,0,0,0,2,22/03/20
Puducherry,0,0,0,0,0,0,0,1,22/03/20
Punjab,0,0,1,0,0,0,0,21,22/03/20
Rajasthan,0,3,0,0,0,0,0,24,22/03/20
Tamil Nadu,0,1,0,0,0,0,0,7,22/03/20
Telengana,0,1,0,0,0,0,0,22,22/03/20
Chandigarh,0,0,0,0,0,0,0,5,22/03/20
Jammu and Kashmir,0,0,0,0,0,0,0,4,22/03/20
Ladakh,0,0,0,0,0,0,0,13,22/03/20
Uttar Pradesh,0,9,0,0,0,0,0,27,22/03/20
Uttarakhand,0,0,0,0,0,0,0,3,22/03/20
West Bengal,0,0,0,0,0,0,0,4,22/03/20
Andhra Pradesh,0,0,0,0,0,0,0,7,23/03/20
Bihar,0,0,1,0,0,0,0,2,23/03/20
Chhattisgarh,0,0,0,0,0,0,0,1,23/03/20
Delhi,0,5,1,0,0,0,0,29,23/03/20
Gujarat,0,0,1,0,0,0,0,29,23/03/20
Haryana,0,0,0,0,0,0,0,26,23/03/20
Himachal Pradesh,0,0,0,0,0,0,0,2,23/03/20
Karnataka,0,2,1,0,0,0,0,33,23/03/20
Kerala,0,3,0,0,0,0,0,67,23/03/20
Madhya Pradesh,0,0,0,0,0,0,0,6,23/03/20
Maharashtra,0,0,2,0,0,0,0,74,23/03/20
Odisha,0,0,0,0,0,0,0,2,23/03/20
Puducherry,0,0,0,0,0,0,0,1,23/03/20
Punjab,0,0,1,0,0,0,0,21,23/03/20
Rajasthan,0,3,0,0,0,0,0,28,23/03/20
Tamil Nadu,0,1,0,0,0,0,0,9,23/03/20
Telengana,0,1,0,0,0,0,0,32,23/03/20
Chandigarh,0,0,0,0,0,0,0,6,23/03/20
Jammu and Kashmir,0,0,0,0,0,0,0,4,23/03/20
Ladakh,0,0,0,0,0,0,0,13,23/03/20
Uttar Pradesh,0,9,0,0,0,0,0,31,23/03/20
Uttarakhand,0,0,0,0,0,0,0,3,23/03/20
West Bengal,0,0,0,0,0,0,0,7,23/03/20
Andhra Pradesh,0,0,0,0,0,0,0,8,24/03/20
Bihar,0,0,1,0,0,0,0,3,24/03/20
Chhattisgarh,0,0,0,0,0,0,0,1,24/03/20
Delhi,0,6,1,0,0,0,0,30,24/03/20
Gujarat,0,0,1,0,0,0,0,33,24/03/20
Haryana,0,11,0,0,0,0,0,28,24/03/20
Himachal Pradesh,0,0,1,0,0,0,0,3,24/03/20
Karnataka,0,3,1,0,0,0,0,37,24/03/20
Kerala,0,4,0,0,0,0,0,95,24/03/20
Madhya Pradesh,0,0,0,0,0,0,0,7,24/03/20
Maharashtra,0,0,2,0,0,0,0,89,24/03/20
Manipur,0,0,0,0,0,0,0,1,24/03/20
Odisha,0,0,0,0,0,0,0,2,24/03/20
Puducherry,0,0,0,0,0,0,0,1,24/03/20
Punjab,0,0,1,0,0,0,0,29,24/03/20
Rajasthan,0,3,0,0,0,0,0,32,24/03/20
Tamil Nadu,0,1,0,0,0,0,0,15,24/03/20
Telengana,0,1,0,0,0,0,0,35,24/03/20
Chandigarh,0,0,0,0,0,0,0,7,24/03/20
Jammu and Kashmir,0,0,0,0,0,0,0,4,24/03/20
Ladakh,0,0,0,0,0,0,0,13,24/03/20
Uttar Pradesh,0,11,0,0,0,0,0,33,24/03/20
Uttarakhand,0,0,0,0,0,0,0,4,24/03/20
West Bengal,0,0,1,0,0,0,0,9,24/03/20
Andhra Pradesh,0,1,0,0,0,0,0,9,25/03/20
Bihar,0,0,1,0,0,0,0,4,25/03/20
Chhattisgarh,0,0,0,0,0,0,0,1,25/03/20
Delhi,0,6,1,0,0,0,0,31,25/03/20
Gujarat,0,0,1,0,0,0,0,38,25/03/20
Haryana,0,11,0,0,0,0,0,28,25/03/20
Himachal Pradesh,0,0,1,0,0,0,0,3,25/03/20
Karnataka,0,3,1,0,0,0,0,41,25/03/20
Kerala,0,4,0,0,0,0,0,109,25/03/20
Madhya Pradesh,0,0,0,0,0,0,0,14,25/03/20
Maharashtra,0,1,3,0,0,0,0,128,25/03/20
Manipur,0,0,0,0,0,0,0,1,25/03/20
Mizoram,0,0,0,0,0,0,0,1,25/03/20
Odisha,0,0,0,0,0,0,0,2,25/03/20
Puducherry,0,0,0,0,0,0,0,1,25/03/20
Punjab,0,0,1,0,0,0,0,29,25/03/20
Rajasthan,0,3,0,0,0,0,0,36,25/03/20
Tamil Nadu,0,1,0,0,0,0,0,18,25/03/20
Telengana,0,1,0,0,0,0,0,35,25/03/20
Chandigarh,0,0,0,0,0,0,0,7,25/03/20
Jammu and Kashmir,0,1,0,0,0,0,0,7,25/03/20
Ladakh,0,0,0,0,0,0,0,13,25/03/20
Uttar Pradesh,0,11,0,0,0,0,0,37,25/03/20
Uttarakhand,0,0,0,0,0,0,0,4,25/03/20
West Bengal,0,0,1,0,0,0,0,9,25/03/20
Andaman and Nicobar Islands,0,0,0,0,0,0,0,1,26/03/20
Andhra Pradesh,0,1,0,0,0,0,0,11,26/03/20
Bihar,0,0,1,0,0,0,0,6,26/03/20
Chandigarh,0,0,0,0,0,0,0,7,26/03/20
Chhattisgarh,0,0,0,0,0,0,0,6,26/03/20
Delhi,0,6,1,0,0,0,0,36,26/03/20
Goa,0,0,0,0,0,0,0,3,26/03/20
Gujarat,0,0,3,0,0,0,0,43,26/03/20
Haryana,0,11,0,0,0,0,0,30,26/03/20
Himachal Pradesh,0,0,1,0,0,0,0,3,26/03/20
Jammu and Kashmir,0,1,0,0,0,0,0,13,26/03/20
Karnataka,0,3,2,0,0,0,0,55,26/03/20
Kerala,0,6,0,0,0,0,0,118,26/03/20
Ladakh,0,0,0,0,0,0,0,13,26/03/20
Madhya Pradesh,0,0,1,0,0,0,0,20,26/03/20
Maharashtra,0,1,3,0,0,0,0,124,26/03/20
Manipur,0,0,0,0,0,0,0,1,26/03/20
Mizoram,0,0,0,0,0,0,0,1,26/03/20
Odisha,0,0,0,0,0,0,0,2,26/03/20
Puducherry,0,0,0,0,0,0,0,1,26/03/20
Punjab,0,0,1,0,0,0,0,33,26/03/20
Rajasthan,0,3,0,0,0,0,0,41,26/03/20
Tamil Nadu,0,1,1,0,0,0,0,26,26/03/20
Telengana,0,1,0,0,0,0,0,44,26/03/20
Uttarakhand,0,0,0,0,0,0,0,5,26/03/20
Uttar Pradesh,0,11,0,0,0,0,0,41,26/03/20
West Bengal,0,0,1,0,0,0,0,10,26/03/20
Andaman and Nicobar Islands,0,0,0,0,0,0,0,1,27/03/20
Andhra Pradesh,0,1,0,0,0,0,0,12,27/03/20
Bihar,0,0,1,0,0,0,0,6,27/03/20
Chandigarh,0,0,0,0,0,0,0,7,27/03/20
Chhattisgarh,0,0,0,0,0,0,0,6,27/03/20
Delhi,0,6,1,0,0,0,0,36,27/03/20
Goa,0,0,0,0,0,0,0,3,27/03/20
Gujarat,0,0,3,0,0,0,0,43,27/03/20
Haryana,0,11,0,0,0,0,0,30,27/03/20
Himachal Pradesh,0,0,1,0,0,0,0,3,27/03/20
Jammu and Kashmir,0,1,1,0,0,0,0,13,27/03/20
Karnataka,0,3,2,0,0,0,0,55,27/03/20
Kerala,0,11,0,0,0,0,0,137,27/03/20
Ladakh,0,3,0,0,0,0,0,13,27/03/20
Madhya Pradesh,0,0,1,0,0,0,0,20,27/03/20
Maharashtra,0,15,4,0,0,0,0,130,27/03/20
Manipur,0,0,0,0,0,0,0,1,27/03/20
Mizoram,0,0,0,0,0,0,0,1,27/03/20
Odisha,0,0,0,0,0,0,0,2,27/03/20
Puducherry,0,0,0,0,0,0,0,1,27/03/20
Punjab,0,0,1,0,0,0,0,33,27/03/20
Rajasthan,0,3,0,0,0,0,0,41,27/03/20
Tamil Nadu,0,1,1,0,0,0,0,29,27/03/20
Telengana,0,1,0,0,0,0,0,45,27/03/20
Uttarakhand,0,0,0,0,0,0,0,5,27/03/20
Uttar Pradesh,0,11,0,0,0,0,0,41,27/03/20
West Bengal,0,0,1,0,0,0,0,10,27/03/20
Andhra Pradesh,0,1,0,0,0,0,0,14,28/03/20
Andaman and Nicobar Islands,0,0,0,0,0,0,0,6,28/03/20
Bihar,0,0,1,0,0,0,0,9,28/03/20
Chandigarh,0,0,0,0,0,0,0,8,28/03/20
Chhattisgarh,0,0,0,0,0,0,0,6,28/03/20
Delhi,0,6,1,0,0,0,0,39,28/03/20
Goa,0,0,0,0,0,0,0,3,28/03/20
Gujarat,0,0,3,0,0,0,0,45,28/03/20
Haryana,0,12,0,0,0,0,0,33,28/03/20
Himachal Pradesh,0,0,1,0,0,0,0,3,28/03/20
Jammu and Kashmir,0,1,1,0,0,0,0,20,28/03/20
Karnataka,0,3,2,0,0,0,0,55,28/03/20
Kerala,0,11,0,0,0,0,0,176,28/03/20
Ladakh,0,3,0,0,0,0,0,13,28/03/20
Madhya Pradesh,0,0,2,0,0,0,0,30,28/03/20
Maharashtra,0,25,5,0,0,0,0,180,28/03/20
Manipur,0,0,0,0,0,0,0,1,28/03/20
Mizoram,0,0,0,0,0,0,0,1,28/03/20
Odisha,0,0,0,0,0,0,0,3,28/03/20
Puducherry,0,0,0,0,0,0,0,1,28/03/20
Punjab,0,1,1,0,0,0,0,38,28/03/20
Rajasthan,0,3,0,0,0,0,0,54,28/03/20
Tamil Nadu,0,2,1,0,0,0,0,40,28/03/20
Telengana,0,1,0,0,0,0,0,56,28/03/20
Uttarakhand,0,0,0,0,0,0,0,5,28/03/20
Uttar Pradesh,0,11,0,0,0,0,0,55,28/03/20
West Bengal,0,0,1,0,0,0,0,15,28/03/20
Andhra Pradesh,0,1,0,0,0,0,0,19,29/03/20
Andaman and Nicobar Islands,0,0,0,0,0,0,0,9,29/03/20
Bihar,0,0,1,0,0,0,0,11,29/03/20
Chandigarh,0,0,0,0,0,0,0,8,29/03/20
Chhattisgarh,0,0,0,0,0,0,0,7,29/03/20
Delhi,0,6,2,0,0,0,0,49,29/03/20
Goa,0,0,0,0,0,0,0,5,29/03/20
Gujarat,0,1,5,0,0,0,0,58,29/03/20
Haryana,0,17,0,0,0,0,0,33,29/03/20
Himachal Pradesh,0,0,1,0,0,0,0,3,29/03/20
Jammu and Kashmir,0,1,2,0,0,0,0,31,29/03/20
Karnataka,0,5,3,0,0,0,0,76,29/03/20
Kerala,0,15,1,0,0,0,0,182,29/03/20
Ladakh,0,3,0,0,0,0,0,13,29/03/20
Madhya Pradesh,0,0,2,0,0,0,0,30,29/03/20
Maharashtra,0,25,6,0,0,0,0,186,29/03/20
Manipur,0,0,0,0,0,0,0,1,29/03/20
Mizoram,0,0,0,0,0,0,0,1,29/03/20
Odisha,0,0,0,0,0,0,0,3,29/03/20
Puducherry,0,0,0,0,0,0,0,1,29/03/20
Punjab,0,1,1,0,0,0,0,38,29/03/20
Rajasthan,0,3,0,0,0,0,0,55,29/03/20
Tamil Nadu,0,4,1,0,0,0,0,49,29/03/20
Telengana,0,1,1,0,0,0,0,66,29/03/20
Uttarakhand,0,2,0,0,0,0,0,7,29/03/20
Uttar Pradesh,0,11,0,0,0,0,0,65,29/03/20
West Bengal,0,0,1,0,0,0,0,18,29/03/20
Andhra Pradesh,0,1,0,0,0,0,0,23,30/03/20
Andaman and Nicobar Islands,0,0,0,0,0,0,0,9,30/03/20
Bihar,0,0,1,0,0,0,0,15,30/03/20
Chandigarh,0,0,0,0,0,0,0,8,30/03/20
Chhattisgarh,0,0,0,0,0,0,0,7,30/03/20
Delhi,0,6,2,0,0,0,0,87,30/03/20
Goa,0,0,0,0,0,0,0,5,30/03/20
Gujarat,0,1,6,0,0,0,0,69,30/03/20
Haryana,0,18,0,0,0,0,0,36,30/03/20
Himachal Pradesh,0,0,1,0,0,0,0,3,30/03/20
Jammu and Kashmir,0,2,2,0,0,0,0,48,30/03/20
Karnataka,0,5,3,0,0,0,0,83,30/03/20
Kerala,0,19,1,0,0,0,0,202,30/03/20
Ladakh,0,3,0,0,0,0,0,13,30/03/20
Madhya Pradesh,0,0,3,0,0,0,0,47,30/03/20
Maharashtra,0,25,8,0,0,0,0,198,30/03/20
Manipur,0,0,0,0,0,0,0,1,30/03/20
Mizoram,0,0,0,0,0,0,0,1,30/03/20
Odisha,0,0,0,0,0,0,0,3,30/03/20
Puducherry,0,0,0,0,0,0,0,1,30/03/20
Punjab,0,1,1,0,0,0,0,38,30/03/20
Rajasthan,0,3,0,0,0,0,0,59,30/03/20
Tamil Nadu,0,4,1,0,0,0,0,67,30/03/20
Telengana,0,1,1,0,0,0,0,71,30/03/20
Uttarakhand,0,2,0,0,0,0,0,7,30/03/20
Uttar Pradesh,0,11,0,0,0,0,0,82,30/03/20
West Bengal,0,0,1,0,0,0,0,22,30/03/20
Unassigned,0,0,0,0,0,0,0,46,30/03/20
Andhra Pradesh,0,1,0,0,0,0,0,40,31/03/20
Andaman and Nicobar Islands,0,0,0,0,0,0,0,10,31/03/20
Bihar,0,0,1,0,0,0,0,15,31/03/20
Chandigarh,0,0,0,0,0,0,0,13,31/03/20
Chhattisgarh,0,0,0,0,0,0,0,8,31/03/20
Delhi,0,6,2,0,0,0,0,97,31/03/20
Goa,0,0,0,0,0,0,0,5,31/03/20
Gujarat,0,3,6,0,0,0,0,73,31/03/20
Haryana,0,21,0,0,0,0,0,40,31/03/20
Himachal Pradesh,0,0,1,0,0,0,0,3,31/03/20
Jammu and Kashmir,0,2,2,0,0,0,0,54,31/03/20
Karnataka,0,5,3,0,0,0,0,83,31/03/20
Kerala,0,19,1,0,0,0,0,234,31/03/20
Ladakh,0,3,0,0,0,0,0,13,31/03/20
Madhya Pradesh,0,0,3,0,0,0,0,47,31/03/20
Maharashtra,0,39,9,0,0,0,0,216,31/03/20
Manipur,0,0,0,0,0,0,0,1,31/03/20
Mizoram,0,0,0,0,0,0,0,1,31/03/20
Odisha,0,0,0,0,0,0,0,3,31/03/20
Puducherry,0,0,0,0,0,0,0,1,31/03/20
Punjab,0,1,3,0,0,0,0,41,31/03/20
Rajasthan,0,3,0,0,0,0,0,74,31/03/20
Tamil Nadu,0,4,1,0,0,0,0,74,31/03/20
Telengana,0,1,1,0,0,0,0,79,31/03/20
Uttarakhand,0,2,0,0,0,0,0,7,31/03/20
Uttar Pradesh,0,14,0,0,0,0,0,101,31/03/20
West Bengal,0,0,2,0,0,0,0,26,31/03/20
Unassigned,0,0,0,0,0,0,0,38,31/03/20
Andhra Pradesh,0,1,0,0,0,0,0,83,01/04/20
Andaman and Nicobar Islands,0,0,0,0,0,0,0,10,01/04/20
Assam,0,0,0,0,0,0,0,1,01/04/20
Bihar,0,0,1,0,0,0,0,23,01/04/20
Chandigarh,0,0,0,0,0,0,0,16,01/04/20
Chhattisgarh,0,2,0,0,0,0,0,9,01/04/20
Delhi,0,6,2,0,0,0,0,152,01/04/20
Goa,0,0,0,0,0,0,0,5,01/04/20
Gujarat,0,5,6,0,0,0,0,82,01/04/20
Haryana,0,21,0,0,0,0,0,43,01/04/20
Himachal Pradesh,0,0,1,0,0,0,0,3,01/04/20
Jammu and Kashmir,0,2,2,0,0,0,0,62,01/04/20
Jharkhand,0,0,0,0,0,0,0,1,01/04/20
Karnataka,0,8,3,0,0,0,0,101,01/04/20
Kerala,0,23,2,0,0,0,0,241,01/04/20
Ladakh,0,3,0,0,0,0,0,13,01/04/20
Madhya Pradesh,0,0,3,0,0,0,0,66,01/04/20
Maharashtra,0,39,9,0,0,0,0,302,01/04/20
Manipur,0,0,0,0,0,0,0,1,01/04/20
Mizoram,0,0,0,0,0,0,0,1,01/04/20
Odisha,0,0,0,0,0,0,0,4,01/04/20
Puducherry,0,1,0,0,0,0,0,3,01/04/20
Punjab,0,1,3,0,0,0,0,42,01/04/20
Rajasthan,0,3,0,0,0,0,0,93,01/04/20
Tamil Nadu,0,6,1,0,0,0,0,234,01/04/20
Telengana,0,1,3,0,0,0,0,96,01/04/20
Uttarakhand,0,2,0,0,0,0,0,7,01/04/20
Uttar Pradesh,0,14,2,0,0,0,0,103,01/04/20
West Bengal,0,6,3,0,0,0,0,37,01/04/20
Andhra Pradesh,0,1,1,0,0,0,0,86,02/04/20
Andaman and Nicobar Islands,0,0,0,0,0,0,0,10,02/04/20
Assam,0,0,0,0,0,0,0,5,02/04/20
Bihar,0,0,1,0,0,0,0,24,02/04/20
Chandigarh,0,0,0,0,0,0,0,16,02/04/20
Chhattisgarh,0,2,0,0,0,0,0,9,02/04/20
Delhi,0,8,4,0,0,0,0,219,02/04/20
Goa,0,0,0,0,0,0,0,5,02/04/20
Gujarat,0,8,7,0,0,0,0,87,02/04/20
Haryana,0,21,0,0,0,0,0,43,02/04/20
Himachal Pradesh,0,1,1,0,0,0,0,3,02/04/20
Jammu and Kashmir,0,2,2,0,0,0,0,62,02/04/20
Jharkhand,0,0,0,0,0,0,0,1,02/04/20
Karnataka,0,9,3,0,0,0,0,110,02/04/20
Kerala,0,25,2,0,0,0,0,265,02/04/20
Ladakh,0,3,0,0,0,0,0,13,02/04/20
Madhya Pradesh,0,0,6,0,0,0,0,99,02/04/20
Maharashtra,0,42,13,0,0,0,0,335,02/04/20
Manipur,0,0,0,0,0,0,0,1,02/04/20
Mizoram,0,0,0,0,0,0,0,1,02/04/20
Odisha,0,0,0,0,0,0,0,4,02/04/20
Puducherry,0,1,0,0,0,0,0,3,02/04/20
Punjab,0,1,4,0,0,0,0,46,02/04/20
Rajasthan,0,3,0,0,0,0,0,108,02/04/20
Tamil Nadu,0,6,1,0,0,0,0,234,02/04/20
Telengana,0,1,3,0,0,0,0,107,02/04/20
Uttarakhand,0,2,0,0,0,0,0,7,02/04/20
Uttar Pradesh,0,14,2,0,0,0,0,113,02/04/20
West Bengal,0,6,3,0,0,0,0,53,02/04/20
Andhra Pradesh,0,1,1,0,0,0,0,132,03/04/20
Andaman and Nicobar Islands,0,0,0,0,0,0,0,10,03/04/20
Arunachal Pradesh,0,0,0,0,0,0,0,1,03/04/20
Assam,0,0,0,0,0,0,0,16,03/04/20
Bihar,0,0,1,0,0,0,0,29,03/04/20
Chandigarh,0,0,0,0,0,0,0,18,03/04/20
Chhattisgarh,0,3,0,0,0,0,0,9,03/04/20
Delhi,0,8,4,0,0,0,0,219,03/04/20
Goa,0,0,0,0,0,0,0,6,03/04/20
Gujarat,0,10,8,0,0,0,0,95,03/04/20
Haryana,0,24,0,0,0,0,0,49,03/04/20
Himachal Pradesh,0,1,1,0,0,0,0,6,03/04/20
Jammu and Kashmir,0,3,2,0,0,0,0,75,03/04/20
Jharkhand,0,0,0,0,0,0,0,2,03/04/20
Karnataka,0,10,3,0,0,0,0,124,03/04/20
Kerala,0,27,2,0,0,0,0,286,03/04/20
Ladakh,0,3,0,0,0,0,0,14,03/04/20
Madhya Pradesh,0,0,6,0,0,0,0,104,03/04/20
Maharashtra,0,42,16,0,0,0,0,335,03/04/20
Manipur,0,0,0,0,0,0,0,2,03/04/20
Mizoram,0,0,0,0,0,0,0,1,03/04/20
Odisha,0,0,0,0,0,0,0,5,03/04/20
Puducherry,0,1,0,0,0,0,0,5,03/04/20
Punjab,0,1,5,0,0,0,0,48,03/04/20
Rajasthan,0,3,0,0,0,0,0,167,03/04/20
Tamil Nadu,0,6,1,0,0,0,0,309,03/04/20
Telengana,0,1,7,0,0,0,0,158,03/04/20
Uttarakhand,0,2,0,0,0,0,0,10,03/04/20
Uttar Pradesh,0,14,2,0,0,0,0,172,03/04/20
West Bengal,0,3,3,0,0,0,0,63,03/04/20
Unassigned,0,0,0,0,0,0,0,77,03/04/20
Andhra Pradesh,0,1,1,0,0,0,0,161,04/04/20
Andaman and Nicobar Islands,0,0,0,0,0,0,0,10,04/04/20
Arunachal Pradesh,0,0,0,0,0,0,0,1,04/04/20
Assam,0,0,0,0,0,0,0,24,04/04/20
Bihar,0,0,1,0,0,0,0,30,04/04/20
Chandigarh,0,0,0,0,0,0,0,18,04/04/20
Chhattisgarh,0,3,0,0,0,0,0,9,04/04/20
Delhi,0,15,6,0,0,0,0,445,04/04/20
Goa,0,0,0,0,0,0,0,7,04/04/20
Gujarat,0,14,10,0,0,0,0,105,04/04/20
Haryana,0,24,0,0,0,0,0,49,04/04/20
Himachal Pradesh,0,1,1,0,0,0,0,6,04/04/20
Jammu and Kashmir,0,3,2,0,0,0,0,75,04/04/20
Jharkhand,0,0,0,0,0,0,0,2,04/04/20
Karnataka,0,12,3,0,0,0,0,128,04/04/20
Kerala,0,41,2,0,0,0,0,295,04/04/20
Ladakh,0,3,0,0,0,0,0,14,04/04/20
Madhya Pradesh,0,0,6,0,0,0,0,104,04/04/20
Maharashtra,0,42,24,0,0,0,0,490,04/04/20
Manipur,0,0,0,0,0,0,0,2,04/04/20
Mizoram,0,0,0,0,0,0,0,1,04/04/20
Odisha,0,0,0,0,0,0,0,5,04/04/20
Puducherry,0,1,0,0,0,0,0,5,04/04/20
Punjab,0,1,5,0,0,0,0,57,04/04/20
Rajasthan,0,21,0,0,0,0,0,200,04/04/20
Tamil Nadu,0,6,2,0,0,0,0,411,04/04/20
Telengana,0,1,7,0,0,0,0,159,04/04/20
Uttarakhand,0,2,0,0,0,0,0,16,04/04/20
Uttar Pradesh,0,19,2,0,0,0,0,174,04/04/20
West Bengal,0,3,3,0,0,0,0,69,04/04/20
Andhra Pradesh,0,1,1,0,0,0,0,190,05/04/20
Andaman and Nicobar Islands,0,0,0,0,0,0,0,10,05/04/20
Arunachal Pradesh,0,0,0,0,0,0,0,1,05/04/20
Assam,0,0,0,0,0,0,0,26,05/04/20
Bihar,0,0,1,0,0,0,0,30,05/04/20
Chandigarh,0,0,0,0,0,0,0,18,05/04/20
Chhattisgarh,0,3,0,0,0,0,0,9,05/04/20
Delhi,0,18,7,0,0,0,0,503,05/04/20
Goa,0,0,0,0,0,0,0,7,05/04/20
Gujarat,0,18,11,0,0,0,0,122,05/04/20
Haryana,0,25,1,0,0,0,0,59,05/04/20
Himachal Pradesh,0,1,1,0,0,0,0,6,05/04/20
Jammu and Kashmir,0,4,2,0,0,0,0,106,05/04/20
Jharkhand,0,0,0,0,0,0,0,3,05/04/20
Karnataka,0,12,4,0,0,0,0,144,05/04/20
Kerala,0,49,2,0,0,0,0,306,05/04/20
Ladakh,0,10,0,0,0,0,0,14,05/04/20
Madhya Pradesh,0,0,9,0,0,0,0,165,05/04/20
Maharashtra,0,42,24,0,0,0,0,490,05/04/20
Manipur,0,0,0,0,0,0,0,2,05/04/20
Mizoram,0,0,0,0,0,0,0,1,05/04/20
Odisha,0,0,0,0,0,0,0,20,05/04/20
Puducherry,0,1,0,0,0,0,0,5,05/04/20
Punjab,0,1,5,0,0,0,0,57,05/04/20
Rajasthan,0,21,0,0,0,0,0,200,05/04/20
Tamil Nadu,0,6,3,0,0,0,0,485,05/04/20
Telengana,0,32,7,0,0,0,0,269,05/04/20
Uttarakhand,0,2,0,0,0,0,0,22,05/04/20
Uttar Pradesh,0,19,2,0,0,0,0,227,05/04/20
West Bengal,0,10,3,0,0,0,0,80,05/04/20
Andhra Pradesh,0,1,3,0,0,0,0,226,06/04/20
Andaman and Nicobar Islands,0,0,0,0,0,0,0,10,06/04/20
Arunachal Pradesh,0,0,0,0,0,0,0,1,06/04/20
Assam,0,0,0,0,0,0,0,26,06/04/20
Bihar,0,0,1,0,0,0,0,32,06/04/20
Chandigarh,0,0,0,0,0,0,0,18,06/04/20
Chhattisgarh,0,8,0,0,0,0,0,10,06/04/20
Delhi,0,19,7,0,0,0,0,523,06/04/20
Goa,0,0,0,0,0,0,0,7,06/04/20
Gujarat,0,22,12,0,0,0,0,144,06/04/20
Haryana,0,25,1,0,0,0,0,84,06/04/20
Himachal Pradesh,0,2,1,0,0,0,0,13,06/04/20
Jammu and Kashmir,0,4,2,0,0,0,0,109,06/04/20
Jharkhand,0,0,0,0,0,0,0,4,06/04/20
Karnataka,0,12,4,0,0,0,0,151,06/04/20
Kerala,0,55,2,0,0,0,0,314,06/04/20
Ladakh,0,10,0,0,0,0,0,14,06/04/20
Madhya Pradesh,0,0,9,0,0,0,0,165,06/04/20
Maharashtra,0,56,45,0,0,0,0,748,06/04/20
Manipur,0,0,0,0,0,0,0,2,06/04/20
Mizoram,0,0,0,0,0,0,0,1,06/04/20
Odisha,0,2,0,0,0,0,0,21,06/04/20
Puducherry,0,1,0,0,0,0,0,5,06/04/20
Punjab,0,4,6,0,0,0,0,76,06/04/20
Rajasthan,0,21,0,0,0,0,0,274,06/04/20
Tamil Nadu,0,8,5,0,0,0,0,571,06/04/20
Telengana,0,34,7,0,0,0,0,321,06/04/20
Uttarakhand,0,4,0,0,0,0,0,26,06/04/20
Uttar Pradesh,0,21,3,0,0,0,0,305,06/04/20
West Bengal,0,10,3,0,0,0,0,80,06/04/20
Andhra Pradesh,0,1,3,0,0,0,0,266,07/04/20
Andaman and Nicobar Islands,0,0,0,0,0,0,0,10,07/04/20
Arunachal Pradesh,0,0,0,0,0,0,0,1,07/04/20
Assam,0,0,0,0,0,0,0,26,07/04/20
Bihar,0,0,1,0,0,0,0,32,07/04/20
Chandigarh,0,7,0,0,0,0,0,18,07/04/20
Chhattisgarh,0,9,0,0,0,0,0,10,07/04/20
Delhi,0,21,7,0,0,0,0,576,07/04/20
Goa,0,0,0,0,0,0,0,7,07/04/20
Gujarat,0,25,13,0,0,0,0,165,07/04/20
Haryana,0,25,1,0,0,0,0,90,07/04/20
Himachal Pradesh,0,2,1,0,0,0,0,13,07/04/20
Jammu and Kashmir,0,4,2,0,0,0,0,116,07/04/20
Jharkhand,0,0,0,0,0,0,0,4,07/04/20
Karnataka,0,25,4,0,0,0,0,175,07/04/20
Kerala,0,58,2,0,0,0,0,327,07/04/20
Ladakh,0,10,0,0,0,0,0,14,07/04/20
Madhya Pradesh,0,0,13,0,0,0,0,229,07/04/20
Maharashtra,0,56,48,0,0,0,0,868,07/04/20
Manipur,0,0,0,0,0,0,0,2,07/04/20
Mizoram,0,0,0,0,0,0,0,1,07/04/20
Odisha,0,2,1,0,0,0,0,42,07/04/20
Puducherry,0,1,0,0,0,0,0,5,07/04/20
Punjab,0,4,7,0,0,0,0,91,07/04/20
Rajasthan,0,21,3,0,0,0,0,288,07/04/20
Tamil Nadu,0,8,5,0,0,0,0,621,07/04/20
Telengana,0,35,7,0,0,0,0,364,07/04/20
Tripura,0,0,0,0,0,0,0,1,07/04/20
Uttarakhand,0,5,0,0,0,0,0,31,07/04/20
Uttar Pradesh,0,21,3,0,0,0,0,305,07/04/20
West Bengal,0,13,3,0,0,0,0,91,07/04/20
Andhra Pradesh,0,5,4,0,0,0,0,305,08/04/20
Andaman and Nicobar Islands,0,0,0,0,0,0,0,10,08/04/20
Arunachal Pradesh,0,0,0,0,0,0,0,1,08/04/20
Assam,0,0,0,0,0,0,0,27,08/04/20
Bihar,0,0,1,0,0,0,0,38,08/04/20
Chandigarh,0,7,0,0,0,0,0,18,08/04/20
Chhattisgarh,0,9,0,0,0,0,0,10,08/04/20
Delhi,0,21,9,0,0,0,0,576,08/04/20
Goa,0,0,0,0,0,0,0,7,08/04/20
Gujarat,0,25,13,0,0,0,0,165,08/04/20
Haryana,0,28,3,0,0,0,0,147,08/04/20
Himachal Pradesh,0,2,1,0,0,0,0,18,08/04/20
Jammu and Kashmir,0,4,2,0,0,0,0,116,08/04/20
Jharkhand,0,0,0,0,0,0,0,4,08/04/20
Karnataka,0,25,4,0,0,0,0,175,08/04/20
Kerala,0,70,2,0,0,0,0,336,08/04/20
Ladakh,0,10,0,0,0,0,0,14,08/04/20
Madhya Pradesh,0,0,13,0,0,0,0,229,08/04/20
Maharashtra,0,79,64,0,0,0,0,1018,08/04/20
Manipur,0,0,0,0,0,0,0,2,08/04/20
Mizoram,0,0,0,0,0,0,0,1,08/04/20
Odisha,0,2,1,0,0,0,0,42,08/04/20
Puducherry,0,1,0,0,0,0,0,5,08/04/20
Punjab,0,4,7,0,0,0,0,91,08/04/20
Rajasthan,0,21,3,0,0,0,0,328,08/04/20
Tamil Nadu,0,19,7,0,0,0,0,690,08/04/20
Telengana,0,35,7,0,0,0,0,427,08/04/20
Tripura,0,0,0,0,0,0,0,1,08/04/20
Uttarakhand,0,5,0,0,0,0,0,31,08/04/20
Uttar Pradesh,0,26,3,0,0,0,0,343,08/04/20
West Bengal,0,13,5,0,0,0,0,99,08/04/20
Andhra Pradesh,0,6,4,0,0,0,0,348,09/04/20
Andaman and Nicobar Islands,0,0,0,0,0,0,0,11,09/04/20
Arunachal Pradesh,0,0,0,0,0,0,0,1,09/04/20
Assam,0,0,0,0,0,0,0,28,09/04/20
Bihar,0,0,1,0,0,0,0,39,09/04/20
Chandigarh,0,7,0,0,0,0,0,18,09/04/20
Chhattisgarh,0,9,0,0,0,0,0,10,09/04/20
Delhi,0,21,9,0,0,0,0,669,09/04/20
Goa,0,0,0,0,0,0,0,7,09/04/20
Gujarat,0,25,16,0,0,0,0,179,09/04/20
Haryana,0,29,3,0,0,0,0,169,09/04/20
Himachal Pradesh,0,2,1,0,0,0,0,18,09/04/20
Jammu and Kashmir,0,4,4,0,0,0,0,158,09/04/20
Jharkhand,0,0,0,0,0,0,0,13,09/04/20
Karnataka,0,28,5,0,0,0,0,181,09/04/20
Kerala,0,83,2,0,0,0,0,345,09/04/20
Ladakh,0,10,0,0,0,0,0,14,09/04/20
Madhya Pradesh,0,0,16,0,0,0,0,259,09/04/20
Maharashtra,0,117,72,0,0,0,0,1135,09/04/20
Manipur,0,1,0,0,0,0,0,2,09/04/20
Mizoram,0,0,0,0,0,0,0,1,09/04/20
Odisha,0,2,1,0,0,0,0,42,09/04/20
Puducherry,0,1,0,0,0,0,0,5,09/04/20
Punjab,0,4,8,0,0,0,0,101,09/04/20
Rajasthan,0,21,3,0,0,0,0,383,09/04/20
Tamil Nadu,0,21,8,0,0,0,0,738,09/04/20
Telengana,0,35,7,0,0,0,0,442,09/04/20
Tripura,0,0,0,0,0,0,0,1,09/04/20
Uttarakhand,0,5,0,0,0,0,0,35,09/04/20
Uttar Pradesh,0,31,4,0,0,0,0,410,09/04/20
West Bengal,0,16,5,0,0,0,0,103,09/04/20
Andhra Pradesh,0,7,6,0,0,0,0,363,10/04/20
Andaman and Nicobar Islands,0,0,0,0,0,0,0,11,10/04/20
Arunachal Pradesh,0,0,0,0,0,0,0,1,10/04/20
Assam,0,0,0,0,0,0,0,29,10/04/20
Bihar,0,0,1,0,0,0,0,60,10/04/20
Chandigarh,0,7,0,0,0,0,0,18,10/04/20
Chhattisgarh,0,9,0,0,0,0,0,10,10/04/20
Delhi,0,25,13,0,0,0,0,898,10/04/20
Goa,0,1,0,0,0,0,0,7,10/04/20
Gujarat,0,26,17,0,0,0,0,241,10/04/20
Haryana,0,29,3,0,0,0,0,169,10/04/20
Himachal Pradesh,0,6,1,0,0,0,0,28,10/04/20
Jammu and Kashmir,0,6,4,0,0,0,0,184,10/04/20
Jharkhand,0,0,1,0,0,0,0,13,10/04/20
Karnataka,0,30,6,0,0,0,0,197,10/04/20
Kerala,0,96,2,0,0,0,0,357,10/04/20
Ladakh,0,10,0,0,0,0,0,15,10/04/20
Madhya Pradesh,0,0,16,0,0,0,0,259,10/04/20
Maharashtra,0,125,97,0,0,0,0,1364,10/04/20
Manipur,0,1,0,0,0,0,0,2,10/04/20
Mizoram,0,0,0,0,0,0,0,1,10/04/20
Odisha,0,2,1,0,0,0,0,44,10/04/20
Puducherry,0,1,0,0,0,0,0,5,10/04/20
Punjab,0,5,11,0,0,0,0,132,10/04/20
Rajasthan,0,21,3,0,0,0,0,463,10/04/20
Tamil Nadu,0,21,8,0,0,0,0,834,10/04/20
Telengana,0,35,7,0,0,0,0,473,10/04/20
Tripura,0,0,0,0,0,0,0,1,10/04/20
Uttarakhand,0,5,0,0,0,0,0,35,10/04/20
Uttar Pradesh,0,32,4,0,0,0,0,431,10/04/20
West Bengal,0,16,5,0,0,0,0,116,10/04/20
Andhra Pradesh,0,11,6,0,0,0,0,381,11/04/20
Andaman and Nicobar Islands,0,0,0,0,0,0,0,11,11/04/20
Arunachal Pradesh,0,0,0,0,0,0,0,1,11/04/20
Assam,0,0,1,0,0,0,0,29,11/04/20
Bihar,0,0,1,0,0,0,0,60,11/04/20
Chandigarh,0,7,0,0,0,0,0,18,11/04/20
Chhattisgarh,0,9,0,0,0,0,0,18,11/04/20
Delhi,0,25,14,0,0,0,0,903,11/04/20
Goa,0,1,0,0,0,0,0,7,11/04/20
Gujarat,0,31,19,0,0,0,0,308,11/04/20
Haryana,0,29,3,0,0,0,0,177,11/04/20
Himachal Pradesh,0,6,1,0,0,0,0,28,11/04/20
Jammu and Kashmir,0,6,4,0,0,0,0,207,11/04/20
Jharkhand,0,0,1,0,0,0,0,17,11/04/20
Karnataka,0,37,6,0,0,0,0,214,11/04/20
Kerala,0,123,2,0,0,0,0,364,11/04/20
Ladakh,0,10,0,0,0,0,0,15,11/04/20
Madhya Pradesh,0,0,33,0,0,0,0,443,11/04/20
Maharashtra,0,188,110,0,0,0,0,1574,11/04/20
Manipur,0,1,0,0,0,0,0,2,11/04/20
Mizoram,0,0,0,0,0,0,0,1,11/04/20
Odisha,0,2,1,0,0,0,0,48,11/04/20
Puducherry,0,1,0,0,0,0,0,7,11/04/20
Punjab,0,5,11,0,0,0,0,132,11/04/20
Rajasthan,0,21,3,0,0,0,0,553,11/04/20
Tamil Nadu,0,44,8,0,0,0,0,911,11/04/20
Telengana,0,43,9,0,0,0,0,504,11/04/20
Tripura,0,0,0,0,0,0,0,2,11/04/20
Uttarakhand,0,5,0,0,0,0,0,35,11/04/20
Uttar Pradesh,0,32,4,0,0,0,0,433,11/04/20
West Bengal,0,16,5,0,0,0,0,126,11/04/20
Andhra Pradesh,0,11,6,0,0,0,0,381,12/04/20
Andaman and Nicobar Islands,0,10,0,0,0,0,0,11,12/04/20
Arunachal Pradesh,0,0,0,0,0,0,0,1,12/04/20
Assam,0,0,1,0,0,0,0,29,12/04/20
Bihar,0,19,1,0,0,0,0,64,12/04/20
Chandigarh,0,7,0,0,0,0,0,19,12/04/20
Chhattisgarh,0,10,0,0,0,0,0,25,12/04/20
Delhi,0,25,19,0,0,0,0,1069,12/04/20
Goa,0,5,0,0,0,0,0,7,12/04/20
Gujarat,0,44,22,0,0,0,0,432,12/04/20
Haryana,0,29,3,0,0,0,0,185,12/04/20
Himachal Pradesh,0,6,1,0,0,0,0,32,12/04/20
Jammu and Kashmir,0,6,4,0,0,0,0,224,12/04/20
Jharkhand,0,0,1,0,0,0,0,17,12/04/20
Karnataka,0,37,6,0,0,0,0,226,12/04/20
Kerala,0,142,2,0,0,0,0,374,12/04/20
Ladakh,0,10,0,0,0,0,0,15,12/04/20
Madhya Pradesh,0,0,36,0,0,0,0,564,12/04/20
Maharashtra,0,208,127,0,0,0,0,1761,12/04/20
Manipur,0,1,0,0,0,0,0,2,12/04/20
Mizoram,0,0,0,0,0,0,0,1,12/04/20
Odisha,0,12,1,0,0,0,0,54,12/04/20
Puducherry,0,1,0,0,0,0,0,7,12/04/20
Punjab,0,5,11,0,0,0,0,151,12/04/20
Rajasthan,0,21,3,0,0,0,0,700,12/04/20
Tamil Nadu,0,44,10,0,0,0,0,969,12/04/20
Telengana,0,43,9,0,0,0,0,504,12/04/20
Tripura,0,0,0,0,0,0,0,2,12/04/20
Uttarakhand,0,5,0,0,0,0,0,35,12/04/20
Uttar Pradesh,0,45,5,0,0,0,0,452,12/04/20
West Bengal,0,19,5,0,0,0,0,134,12/04/20
Andhra Pradesh,0,11,7,0,0,0,0,432,13/04/20
Andaman and Nicobar Islands,0,10,0,0,0,0,0,11,13/04/20
Arunachal Pradesh,0,0,0,0,0,0,0,1,13/04/20
Assam,0,0,1,0,0,0,0,31,13/04/20
Bihar,0,26,1,0,0,0,0,64,13/04/20
Chandigarh,0,7,0,0,0,0,0,21,13/04/20
Chhattisgarh,0,10,0,0,0,0,0,31,13/04/20
Delhi,0,27,24,0,0,0,0,1154,13/04/20
Goa,0,5,0,0,0,0,0,7,13/04/20
Gujarat,0,47,26,0,0,0,0,539,13/04/20
Haryana,0,29,3,0,0,0,0,185,13/04/20
Himachal Pradesh,0,13,1,0,0,0,0,32,13/04/20
Jammu and Kashmir,0,6,4,0,0,0,0,245,13/04/20
Jharkhand,0,0,2,0,0,0,0,19,13/04/20
Karnataka,0,59,6,0,0,0,0,247,13/04/20
Kerala,0,179,3,0,0,0,0,376,13/04/20
Ladakh,0,10,0,0,0,0,0,15,13/04/20
Madhya Pradesh,0,44,43,0,0,0,0,604,13/04/20
Maharashtra,0,217,149,0,0,0,0,1985,13/04/20
Manipur,0,1,0,0,0,0,0,2,13/04/20
Mizoram,0,0,0,0,0,0,0,1,13/04/20
Nagaland,0,0,0,0,0,0,0,1,13/04/20
Odisha,0,12,1,0,0,0,0,54,13/04/20
Puducherry,0,1,0,0,0,0,0,7,13/04/20
Punjab,0,14,11,0,0,0,0,167,13/04/20
Rajasthan,0,21,3,0,0,0,0,812,13/04/20
Tamil Nadu,0,50,11,0,0,0,0,1075,13/04/20
Telengana,0,100,16,0,0,0,0,562,13/04/20
Tripura,0,0,0,0,0,0,0,2,13/04/20
Uttarakhand,0,5,0,0,0,0,0,35,13/04/20
Uttar Pradesh,0,47,5,0,0,0,0,483,13/04/20
West Bengal,0,29,7,0,0,0,0,152,13/04/20
Andhra Pradesh,0,14,9,0,0,0,0,473,14/04/20
Andaman and Nicobar Islands,0,10,0,0,0,0,0,11,14/04/20
Arunachal Pradesh,0,0,0,0,0,0,0,1,14/04/20
Assam,0,0,1,0,0,0,0,31,14/04/20
Bihar,0,26,1,0,0,0,0,66,14/04/20
Chandigarh,0,7,0,0,0,0,0,21,14/04/20
Chhattisgarh,0,10,0,0,0,0,0,31,14/04/20
Delhi,0,30,28,0,0,0,0,1510,14/04/20
Goa,0,5,0,0,0,0,0,7,14/04/20
Gujarat,0,55,26,0,0,0,0,617,14/04/20
Haryana,0,34,3,0,0,0,0,199,14/04/20
Himachal Pradesh,0,13,1,0,0,0,0,32,14/04/20
Jammu and Kashmir,0,16,4,0,0,0,0,270,14/04/20
Jharkhand,0,0,2,0,0,0,0,24,14/04/20
Karnataka,0,65,9,0,0,0,0,258,14/04/20
Kerala,0,198,3,0,0,0,0,379,14/04/20
Ladakh,0,10,0,0,0,0,0,15,14/04/20
Madhya Pradesh,0,51,50,0,0,0,0,730,14/04/20
Maharashtra,0,229,160,0,0,0,0,2337,14/04/20
Manipur,0,1,0,0,0,0,0,2,14/04/20
Meghalaya,0,0,0,0,0,0,0,1,14/04/20
Mizoram,0,0,0,0,0,0,0,1,14/04/20
Nagaland,0,0,0,0,0,0,0,1,14/04/20
Odisha,0,18,1,0,0,0,0,55,14/04/20
Puducherry,0,1,0,0,0,0,0,7,14/04/20
Punjab,0,14,12,0,0,0,0,176,14/04/20
Rajasthan,0,133,3,0,0,0,0,879,14/04/20
Tamil Nadu,0,58,11,0,0,0,0,1173,14/04/20
Telengana,0,100,17,0,0,0,0,624,14/04/20
Tripura,0,0,0,0,0,0,0,2,14/04/20
Uttarakhand,0,7,0,0,0,0,0,35,14/04/20
Uttar Pradesh,0,49,5,0,0,0,0,657,14/04/20
West Bengal,0,36,7,0,0,0,0,190,14/04/20
Andaman and Nicobar Islands,0,10,0,0,0,0,0,11,15/04/20
Andhra Pradesh,0,16,9,0,0,0,0,503,15/04/20
Arunachal Pradesh,0,0,0,0,0,0,0,1,15/04/20
Assam,0,0,1,0,0,0,0,33,15/04/20
Bihar,0,29,1,0,0,0,0,70,15/04/20
Chandigarh,0,7,0,0,0,0,0,21,15/04/20
Chhattisgarh,0,13,0,0,0,0,0,33,15/04/20
Delhi,0,30,30,0,0,0,0,1561,15/04/20
Goa,0,5,0,0,0,0,0,7,15/04/20
Gujarat,0,59,30,0,0,0,0,695,15/04/20
Haryana,0,34,3,0,0,0,0,199,15/04/20
Himachal Pradesh,0,13,1,0,0,0,0,33,15/04/20
Jammu and Kashmir,0,30,4,0,0,0,0,278,15/04/20
Jharkhand,0,0,2,0,0,0,0,27,15/04/20
Karnataka,0,75,11,0,0,0,0,277,15/04/20
Kerala,0,211,3,0,0,0,0,387,15/04/20
Ladakh,0,10,0,0,0,0,0,17,15/04/20
Madhya Pradesh,0,64,53,0,0,0,0,987,15/04/20
Maharashtra,0,259,178,0,0,0,0,2687,15/04/20
Manipur,0,1,0,0,0,0,0,2,15/04/20
Meghalaya,0,0,1,0,0,0,0,7,15/04/20
Mizoram,0,0,0,0,0,0,0,1,15/04/20
Nagaland,0,0,0,0,0,0,0,0,15/04/20
Odisha,0,18,1,0,0,0,0,60,15/04/20
Puducherry,0,1,0,0,0,0,0,7,15/04/20
Punjab,0,14,13,0,0,0,0,186,15/04/20
Rajasthan,0,147,3,0,0,0,0,1005,15/04/20
Tamil Nadu,0,81,12,0,0,0,0,1204,15/04/20
Telengana,0,120,18,0,0,0,0,647,15/04/20
Tripura,0,0,0,0,0,0,0,2,15/04/20
Uttarakhand,0,9,0,0,0,0,0,37,15/04/20
Uttar Pradesh,0,51,11,0,0,0,0,735,15/04/20
West Bengal,0,37,7,0,0,0,0,213,15/04/20
Andaman and Nicobar Islands,0,10,0,0,0,0,0,11,16/04/20
Andhra Pradesh,0,20,14,0,0,0,0,534,16/04/20
Arunachal Pradesh,0,0,0,0,0,0,0,1,16/04/20
Assam,0,5,1,0,0,0,0,33,16/04/20
Bihar,0,29,1,0,0,0,0,74,16/04/20
Chandigarh,0,7,0,0,0,0,0,21,16/04/20
Chhattisgarh,0,17,0,0,0,0,0,33,16/04/20
Delhi,0,42,32,0,0,0,0,1578,16/04/20
Goa,0,5,0,0,0,0,0,7,16/04/20
Gujarat,0,64,36,0,0,0,0,871,16/04/20
Haryana,0,43,3,0,0,0,0,205,16/04/20
Himachal Pradesh,0,16,1,0,0,0,0,35,16/04/20
Jammu and Kashmir,0,36,4,0,0,0,0,300,16/04/20
Jharkhand,0,0,2,0,0,0,0,28,16/04/20
Karnataka,0,82,13,0,0,0,0,315,16/04/20
Kerala,0,218,3,0,0,0,0,388,16/04/20
Ladakh,0,10,0,0,0,0,0,17,16/04/20
Madhya Pradesh,0,64,53,0,0,0,0,1120,16/04/20
Maharashtra,0,295,187,0,0,0,0,2919,16/04/20
Manipur,0,1,0,0,0,0,0,2,16/04/20
Meghalaya,0,0,1,0,0,0,0,7,16/04/20
Mizoram,0,0,0,0,0,0,0,1,16/04/20
Nagaland,0,0,0,0,0,0,0,0,16/04/20
Odisha,0,18,1,0,0,0,0,60,16/04/20
Puducherry,0,1,0,0,0,0,0,7,16/04/20
Punjab,0,27,13,0,0,0,0,186,16/04/20
Rajasthan,0,147,3,0,0,0,0,1023,16/04/20
Tamil Nadu,0,118,14,0,0,0,0,1242,16/04/20
Telengana,0,120,18,0,0,0,0,698,16/04/20
Tripura,0,1,0,0,0,0,0,2,16/04/20
Uttarakhand,0,9,0,0,0,0,0,37,16/04/20
Uttar Pradesh,0,68,13,0,0,0,0,773,16/04/20
West Bengal,0,42,7,0,0,0,0,231,16/04/20
Andaman and Nicobar Islands,0,10,0,0,0,0,0,11,17/04/20
Andhra Pradesh,0,36,14,0,0,0,0,572,17/04/20
Arunachal Pradesh,0,0,0,0,0,0,0,1,17/04/20
Assam,0,5,1,0,0,0,0,35,17/04/20
Bihar,0,37,1,0,0,0,0,83,17/04/20
Chandigarh,0,9,0,0,0,0,0,21,17/04/20
Chhattisgarh,0,23,0,0,0,0,0,36,17/04/20
Delhi,0,51,38,0,0,0,0,1640,17/04/20
Goa,0,6,0,0,0,0,0,7,17/04/20
Gujarat,0,74,38,0,0,0,0,1021,17/04/20
Haryana,0,43,3,0,0,0,0,205,17/04/20
Himachal Pradesh,0,16,1,0,0,0,0,35,17/04/20
Jammu and Kashmir,0,38,4,0,0,0,0,314,17/04/20
Jharkhand,0,0,2,0,0,0,0,29,17/04/20
Karnataka,0,82,13,0,0,0,0,353,17/04/20
Kerala,0,245,3,0,0,0,0,395,17/04/20
Ladakh,0,14,0,0,0,0,0,18,17/04/20
Madhya Pradesh,0,65,57,0,0,0,0,1308,17/04/20
Maharashtra,0,300,194,0,0,0,0,3205,17/04/20
Manipur,0,1,0,0,0,0,0,2,17/04/20
Meghalaya,0,0,1,0,0,0,0,9,17/04/20
Mizoram,0,0,0,0,0,0,0,1,17/04/20
Nagaland,0,0,0,0,0,0,0,0,17/04/20
Odisha,0,19,1,0,0,0,0,60,17/04/20
Puducherry,0,1,0,0,0,0,0,7,17/04/20
Punjab,0,27,13,0,0,0,0,186,17/04/20
Rajasthan,0,164,11,0,0,0,0,1131,17/04/20
Tamil Nadu,0,180,15,0,0,0,0,1267,17/04/20
Telengana,0,186,18,0,0,0,0,743,17/04/20
Tripura,0,1,0,0,0,0,0,2,17/04/20
Uttarakhand,0,9,0,0,0,0,0,37,17/04/20
Uttar Pradesh,0,74,14,0,0,0,0,846,17/04/20
West Bengal,0,51,10,0,0,0,0,255,17/04/20
Andaman and Nicobar Islands,0,11,0,0,0,0,0,12,18/04/20
Andhra Pradesh,0,42,15,0,0,0,0,603,18/04/20
Arunachal Pradesh,0,0,0,0,0,0,0,1,18/04/20
Assam,0,9,1,0,0,0,0,35,18/04/20
Bihar,0,37,2,0,0,0,0,85,18/04/20
Chandigarh,0,9,0,0,0,0,0,21,18/04/20
Chhattisgarh,0,24,0,0,0,0,0,36,18/04/20
Delhi,0,72,42,0,0,0,0,1707,18/04/20
Goa,0,6,0,0,0,0,0,7,18/04/20
Gujarat,0,88,48,0,0,0,0,1272,18/04/20
Haryana,0,43,3,0,0,0,0,225,18/04/20
Himachal Pradesh,0,16,1,0,0,0,0,38,18/04/20
Jammu and Kashmir,0,42,5,0,0,0,0,328,18/04/20
Jharkhand,0,0,2,0,0,0,0,33,18/04/20
Karnataka,0,92,13,0,0,0,0,371,18/04/20
Kerala,0,255,3,0,0,0,0,396,18/04/20
Ladakh,0,14,0,0,0,0,0,18,18/04/20
Madhya Pradesh,0,69,69,0,0,0,0,1355,18/04/20
Maharashtra,0,331,201,0,0,0,0,3323,18/04/20
Manipur,0,1,0,0,0,0,0,2,18/04/20
Meghalaya,0,0,1,0,0,0,0,11,18/04/20
Mizoram,0,0,0,0,0,0,0,1,18/04/20
Nagaland,0,0,0,0,0,0,0,0,18/04/20
Odisha,0,21,1,0,0,0,0,60,18/04/20
Puducherry,0,3,0,0,0,0,0,7,18/04/20
Punjab,0,27,13,0,0,0,0,202,18/04/20
Rajasthan,0,183,11,0,0,0,0,1229,18/04/20
Tamil Nadu,0,283,15,0,0,0,0,1323,18/04/20
Telengana,0,186,18,0,0,0,0,791,18/04/20
Tripura,0,1,0,0,0,0,0,2,18/04/20
Uttarakhand,0,9,0,0,0,0,0,42,18/04/20
Uttar Pradesh,0,86,14,0,0,0,0,969,18/04/20
West Bengal,0,55,10,0,0,0,0,287,18/04/20
Andaman and Nicobar Islands,0,11,0,0,0,0,0,14,19/04/20
Andhra Pradesh,0,42,15,0,0,0,0,603,19/04/20
Arunachal Pradesh,0,0,0,0,0,0,0,1,19/04/20
Assam,0,12,1,0,0,0,0,35,19/04/20
Bihar,0,37,2,0,0,0,0,86,19/04/20
Chandigarh,0,10,0,0,0,0,0,23,19/04/20
Chhattisgarh,0,24,0,0,0,0,0,36,19/04/20
Delhi,0,72,43,0,0,0,0,1893,19/04/20
Goa,0,6,0,0,0,0,0,7,19/04/20
Gujarat,0,94,58,0,0,0,0,1604,19/04/20
Haryana,0,87,3,0,0,0,0,233,19/04/20
Himachal Pradesh,0,16,1,0,0,0,0,39,19/04/20
Jammu and Kashmir,0,51,5,0,0,0,0,341,19/04/20
Jharkhand,0,0,2,0,0,0,0,35,19/04/20
Karnataka,0,104,14,0,0,0,0,384,19/04/20
Kerala,0,257,3,0,0,0,0,400,19/04/20
Ladakh,0,14,0,0,0,0,0,18,19/04/20
Madhya Pradesh,0,127,70,0,0,0,0,1407,19/04/20
Maharashtra,0,365,211,0,0,0,0,3651,19/04/20
Manipur,0,1,0,0,0,0,0,2,19/04/20
Meghalaya,0,0,1,0,0,0,0,11,19/04/20
Mizoram,0,0,0,0,0,0,0,1,19/04/20
Nagaland,0,0,0,0,0,0,0,0,19/04/20
Odisha,0,24,1,0,0,0,0,61,19/04/20
Puducherry,0,3,0,0,0,0,0,7,19/04/20
Punjab,0,31,16,0,0,0,0,219,19/04/20
Rajasthan,0,183,11,0,0,0,0,1351,19/04/20
Tamil Nadu,0,365,15,0,0,0,0,1372,19/04/20
Telengana,0,186,18,0,0,0,0,844,19/04/20
Tripura,0,1,0,0,0,0,0,2,19/04/20
Uttarakhand,0,9,0,0,0,0,0,42,19/04/20
Uttar Pradesh,0,108,17,0,0,0,0,1084,19/04/20
West Bengal,0,62,12,0,0,0,0,310,19/04/20
Andaman and Nicobar Islands,0,11,0,0,0,0,0,15,20/04/20
Andhra Pradesh,0,92,20,0,0,0,0,722,20/04/20
Arunachal Pradesh,0,0,0,0,0,0,0,1,20/04/20
Assam,0,17,1,0,0,0,0,35,20/04/20
Bihar,0,42,2,0,0,0,0,96,20/04/20
Chandigarh,0,13,0,0,0,0,0,26,20/04/20
Chhattisgarh,0,25,0,0,0,0,0,36,20/04/20
Delhi,0,290,45,0,0,0,0,2003,20/04/20
Goa,0,7,0,0,0,0,0,7,20/04/20
Gujarat,0,106,67,0,0,0,0,1851,20/04/20
Haryana,0,87,3,0,0,0,0,233,20/04/20
Himachal Pradesh,0,16,1,0,0,0,0,39,20/04/20
Jammu and Kashmir,0,56,5,0,0,0,0,350,20/04/20
Jharkhand,0,0,2,0,0,0,0,42,20/04/20
Karnataka,0,111,16,0,0,0,0,395,20/04/20
Kerala,0,270,3,0,0,0,0,402,20/04/20
Ladakh,0,14,0,0,0,0,0,18,20/04/20
Madhya Pradesh,0,127,74,0,0,0,0,1485,20/04/20
Maharashtra,0,507,223,0,0,0,0,4203,20/04/20
Manipur,0,2,0,0,0,0,0,2,20/04/20
Meghalaya,0,0,1,0,0,0,0,11,20/04/20
Mizoram,0,0,0,0,0,0,0,1,20/04/20
Nagaland,0,0,0,0,0,0,0,0,20/04/20
Odisha,0,24,1,0,0,0,0,68,20/04/20
Puducherry,0,3,0,0,0,0,0,7,20/04/20
Punjab,0,31,16,0,0,0,0,219,20/04/20
Rajasthan,0,183,14,0,0,0,0,1478,20/04/20
Tamil Nadu,0,411,15,0,0,0,0,1477,20/04/20
Telengana,0,190,21,0,0,0,0,873,20/04/20
Tripura,0,1,0,0,0,0,0,2,20/04/20
Uttarakhand,0,11,0,0,0,0,0,44,20/04/20
Uttar Pradesh,0,129,17,0,0,0,0,1176,20/04/20
West Bengal,0,66,12,0,0,0,0,339,20/04/20
Andaman and Nicobar Islands,0,11,0,0,0,0,0,16,21/04/20
Andhra Pradesh,0,96,22,0,0,0,0,757,21/04/20
Arunachal Pradesh,0,1,0,0,0,0,0,1,21/04/20
Assam,0,19,1,0,0,0,0,35,21/04/20
Bihar,0,42,2,0,0,0,0,114,21/04/20
Chandigarh,0,13,0,0,0,0,0,26,21/04/20
Chhattisgarh,0,25,0,0,0,0,0,36,21/04/20
Delhi,0,431,47,0,0,0,0,2081,21/04/20
Goa,0,7,0,0,0,0,0,7,21/04/20
Gujarat,0,131,77,0,0,0,0,2066,21/04/20
Haryana,0,127,3,0,0,0,0,254,21/04/20
Himachal Pradesh,0,16,1,0,0,0,0,39,21/04/20
Jammu and Kashmir,0,71,5,0,0,0,0,368,21/04/20
Jharkhand,0,0,2,0,0,0,0,46,21/04/20
Karnataka,0,114,17,0,0,0,0,415,21/04/20
Kerala,0,291,3,0,0,0,0,408,21/04/20
Ladakh,0,14,0,0,0,0,0,18,21/04/20
Madhya Pradesh,0,127,76,0,0,0,0,1540,21/04/20
Maharashtra,0,572,232,0,0,0,0,4669,21/04/20
Manipur,0,2,0,0,0,0,0,2,21/04/20
Meghalaya,0,0,1,0,0,0,0,11,21/04/20
Mizoram,0,0,0,0,0,0,0,1,21/04/20
Nagaland,0,0,0,0,0,0,0,0,21/04/20
Odisha,0,24,1,0,0,0,0,74,21/04/20
Puducherry,0,3,0,0,0,0,0,7,21/04/20
Punjab,0,39,16,0,0,0,0,245,21/04/20
Rajasthan,0,205,25,0,0,0,0,1576,21/04/20
Tamil Nadu,0,457,17,0,0,0,0,1520,21/04/20
Telengana,0,190,23,0,0,0,0,919,21/04/20
Tripura,0,1,0,0,0,0,0,2,21/04/20
Uttarakhand,0,18,0,0,0,0,0,46,21/04/20
Uttar Pradesh,0,140,20,0,0,0,0,1294,21/04/20
West Bengal,0,73,12,0,0,0,0,392,21/04/20
Andaman and Nicobar Islands,0,11,0,0,0,0,0,17,22/04/20
Andhra Pradesh,0,120,24,0,0,0,0,813,22/04/20
Arunachal Pradesh,0,1,0,0,0,0,0,1,22/04/20
Assam,0,19,1,0,0,0,0,35,22/04/20
Bihar,0,46,2,0,0,0,0,126,22/04/20
Chandigarh,0,14,0,0,0,0,0,27,22/04/20
Chhattisgarh,0,26,0,0,0,0,0,36,22/04/20
Delhi,0,611,47,0,0,0,0,2156,22/04/20
Goa,0,7,0,0,0,0,0,7,22/04/20
Gujarat,0,144,95,0,0,0,0,2272,22/04/20
Haryana,0,127,3,0,0,0,0,254,22/04/20
Himachal Pradesh,0,16,1,0,0,0,0,39,22/04/20
Jammu and Kashmir,0,81,5,0,0,0,0,380,22/04/20
Jharkhand,0,0,3,0,0,0,0,45,22/04/20
Karnataka,0,129,17,0,0,0,0,425,22/04/20
Kerala,0,323,3,0,0,0,0,427,22/04/20
Ladakh,0,14,0,0,0,0,0,18,22/04/20
Madhya Pradesh,0,148,80,0,0,0,0,1592,22/04/20
Maharashtra,0,722,251,0,0,0,0,5221,22/04/20
Manipur,0,2,0,0,0,0,0,2,22/04/20
Meghalaya,0,0,1,0,0,0,0,12,22/04/20
Mizoram,0,0,0,0,0,0,0,1,22/04/20
Odisha,0,30,1,0,0,0,0,82,22/04/20
Puducherry,0,3,0,0,0,0,0,7,22/04/20
Punjab,0,49,16,0,0,0,0,251,22/04/20
Rajasthan,0,230,25,0,0,0,0,1801,22/04/20
Tamil Nadu,0,635,18,0,0,0,0,1596,22/04/20
Telengana,0,194,23,0,0,0,0,945,22/04/20
Tripura,0,1,0,0,0,0,0,2,22/04/20
Uttarakhand,0,19,0,0,0,0,0,46,22/04/20
Uttar Pradesh,0,165,21,0,0,0,0,1412,22/04/20
West Bengal,0,73,15,0,0,0,0,423,22/04/20
Andaman and Nicobar Islands,0,11,0,0,0,0,0,18,23/04/20
Andhra Pradesh,0,141,27,0,0,0,0,895,23/04/20
Arunachal Pradesh,0,1,0,0,0,0,0,1,23/04/20
Assam,0,19,1,0,0,0,0,35,23/04/20
Bihar,0,46,2,0,0,0,0,148,23/04/20
Chandigarh,0,14,0,0,0,0,0,27,23/04/20
Chhattisgarh,0,28,0,0,0,0,0,36,23/04/20
Delhi,0,724,48,0,0,0,0,2248,23/04/20
Goa,0,7,0,0,0,0,0,7,23/04/20
Gujarat,0,179,103,0,0,0,0,2407,23/04/20
Haryana,0,140,3,0,0,0,0,262,23/04/20
Himachal Pradesh,0,18,1,0,0,0,0,40,23/04/20
Jammu and Kashmir,0,92,5,0,0,0,0,407,23/04/20
Jharkhand,0,8,3,0,0,0,0,49,23/04/20
Karnataka,0,141,17,0,0,0,0,443,23/04/20
Kerala,0,324,3,0,0,0,0,438,23/04/20
Ladakh,0,14,0,0,0,0,0,18,23/04/20
Madhya Pradesh,0,148,81,0,0,0,0,1695,23/04/20
Maharashtra,0,789,269,0,0,0,0,5652,23/04/20
Manipur,0,2,0,0,0,0,0,2,23/04/20
Meghalaya,0,0,1,0,0,0,0,12,23/04/20
Mizoram,0,0,0,0,0,0,0,1,23/04/20
Odisha,0,32,1,0,0,0,0,83,23/04/20
Puducherry,0,3,0,0,0,0,0,7,23/04/20
Punjab,0,65,16,0,0,0,0,277,23/04/20
Rajasthan,0,230,27,0,0,0,0,1890,23/04/20
Tamil Nadu,0,662,18,0,0,0,0,1629,23/04/20
Telengana,0,197,24,0,0,0,0,960,23/04/20
Tripura,0,1,0,0,0,0,0,2,23/04/20
Uttarakhand,0,23,0,0,0,0,0,46,23/04/20
Uttar Pradesh,0,187,21,0,0,0,0,1509,23/04/20
West Bengal,0,79,15,0,0,0,0,456,23/04/20
Andaman and Nicobar Islands,0,11,0,0,0,0,0,22,24/04/20
Andhra Pradesh,0,145,29,0,0,0,0,955,24/04/20
Arunachal Pradesh,0,1,0,0,0,0,0,1,24/04/20
Assam,0,19,1,0,0,0,0,36,24/04/20
Bihar,0,46,2,0,0,0,0,176,24/04/20
Chandigarh,0,14,0,0,0,0,0,27,24/04/20
Chhattisgarh,0,28,0,0,0,0,0,36,24/04/20
Delhi,0,808,50,0,0,0,0,2376,24/04/20
Goa,0,7,0,0,0,0,0,7,24/04/20
Gujarat,0,258,112,0,0,0,0,2624,24/04/20
Haryana,0,156,3,0,0,0,0,272,24/04/20
Himachal Pradesh,0,18,1,0,0,0,0,40,24/04/20
Jammu and Kashmir,0,92,5,0,0,0,0,427,24/04/20
Jharkhand,0,8,3,0,0,0,0,55,24/04/20
Karnataka,0,150,18,0,0,0,0,463,24/04/20
Kerala,0,324,3,0,0,0,0,448,24/04/20
Ladakh,0,14,0,0,0,0,0,18,24/04/20
Madhya Pradesh,0,203,83,0,0,0,0,1852,24/04/20
Maharashtra,0,840,283,0,0,0,0,6430,24/04/20
Manipur,0,2,0,0,0,0,0,2,24/04/20
Meghalaya,0,0,1,0,0,0,0,12,24/04/20
Mizoram,0,0,0,0,0,0,0,1,24/04/20
Odisha,0,33,1,0,0,0,0,90,24/04/20
Puducherry,0,3,0,0,0,0,0,7,24/04/20
Punjab,0,65,16,0,0,0,0,277,24/04/20
Rajasthan,0,230,27,0,0,0,0,1964,24/04/20
Tamil Nadu,0,752,20,0,0,0,0,1683,24/04/20
Telengana,0,253,26,0,0,0,0,984,24/04/20
Tripura,0,1,0,0,0,0,0,2,24/04/20
Uttarakhand,0,24,0,0,0,0,0,47,24/04/20
Uttar Pradesh,0,206,24,0,0,0,0,1604,24/04/20
West Bengal,0,103,15,0,0,0,0,514,24/04/20
Andaman and Nicobar Islands,0,11,0,0,0,0,0,27,25/04/20
Andhra Pradesh,0,171,31,0,0,0,0,1061,25/04/20
Arunachal Pradesh,0,1,0,0,0,0,0,1,25/04/20
Assam,0,19,1,0,0,0,0,36,25/04/20
Bihar,0,46,2,0,0,0,0,228,25/04/20
Chandigarh,0,15,0,0,0,0,0,28,25/04/20
Chhattisgarh,0,30,0,0,0,0,0,36,25/04/20
Delhi,0,857,53,0,0,0,0,2514,25/04/20
Goa,0,7,0,0,0,0,0,7,25/04/20
Gujarat,0,265,127,0,0,0,0,2815,25/04/20
Haryana,0,156,3,0,0,0,0,272,25/04/20
Himachal Pradesh,0,18,1,0,0,0,0,40,25/04/20
Jammu and Kashmir,0,109,5,0,0,0,0,454,25/04/20
Jharkhand,0,9,3,0,0,0,0,59,25/04/20
Karnataka,0,153,18,0,0,0,0,489,25/04/20
Kerala,0,331,4,0,0,0,0,451,25/04/20
Ladakh,0,14,0,0,0,0,0,20,25/04/20
Madhya Pradesh,0,210,92,0,0,0,0,1952,25/04/20
Maharashtra,0,957,301,0,0,0,0,6817,25/04/20
Manipur,0,2,0,0,0,0,0,2,25/04/20
Meghalaya,0,0,1,0,0,0,0,12,25/04/20
Mizoram,0,0,0,0,0,0,0,1,25/04/20
Odisha,0,33,1,0,0,0,0,94,25/04/20
Puducherry,0,3,0,0,0,0,0,7,25/04/20
Punjab,0,67,17,0,0,0,0,298,25/04/20
Rajasthan,0,230,27,0,0,0,0,2034,25/04/20
Tamil Nadu,0,866,22,0,0,0,0,1755,25/04/20
Telengana,0,253,26,0,0,0,0,984,25/04/20
Tripura,0,1,0,0,0,0,0,2,25/04/20
Uttarakhand,0,25,0,0,0,0,0,48,25/04/20
Uttar Pradesh,0,248,26,0,0,0,0,1778,25/04/20
West Bengal,0,103,18,0,0,0,0,571,25/04/20
Andaman and Nicobar Islands,0,11,0,0,0,0,0,33,26/04/20
Andhra Pradesh,0,231,31,0,0,0,0,1097,26/04/20
Arunachal Pradesh,0,1,0,0,0,0,0,1,26/04/20
Assam,0,19,1,0,0,0,0,36,26/04/20
Bihar,0,46,2,0,0,0,0,251,26/04/20
Chandigarh,0,17,0,0,0,0,0,30,26/04/20
Chhattisgarh,0,32,0,0,0,0,0,37,26/04/20
Delhi,0,869,54,0,0,0,0,2625,26/04/20
Goa,0,7,0,0,0,0,0,7,26/04/20
Gujarat,0,282,133,0,0,0,0,3071,26/04/20
Haryana,0,176,3,0,0,0,0,289,26/04/20
Himachal Pradesh,0,22,1,0,0,0,0,40,26/04/20
Jammu and Kashmir,0,112,6,0,0,0,0,494,26/04/20
Jharkhand,0,13,3,0,0,0,0,67,26/04/20
Karnataka,0,177,18,0,0,0,0,501,26/04/20
Kerala,0,338,4,0,0,0,0,458,26/04/20
Ladakh,0,14,0,0,0,0,0,20,26/04/20
Madhya Pradesh,0,210,99,0,0,0,0,2096,26/04/20
Maharashtra,0,1076,323,0,0,0,0,7628,26/04/20
Manipur,0,2,0,0,0,0,0,2,26/04/20
Meghalaya,0,0,1,0,0,0,0,12,26/04/20
Mizoram,0,0,0,0,0,0,0,1,26/04/20
Odisha,0,34,1,0,0,0,0,103,26/04/20
Puducherry,0,3,0,0,0,0,0,7,26/04/20
Punjab,0,67,17,0,0,0,0,298,26/04/20
Rajasthan,0,493,33,0,0,0,0,2083,26/04/20
Tamil Nadu,0,960,23,0,0,0,0,1821,26/04/20
Telengana,0,280,26,0,0,0,0,991,26/04/20
Tripura,0,2,0,0,0,0,0,2,26/04/20
Uttarakhand,0,26,0,0,0,0,0,50,26/04/20
Uttar Pradesh,0,289,29,0,0,0,0,1843,26/04/20
West Bengal,0,105,18,0,0,0,0,611,26/04/20
Andaman and Nicobar Islands,0,11,0,0,0,0,0,33,27/04/20
Andhra Pradesh,0,235,31,0,0,0,0,1177,27/04/20
Arunachal Pradesh,0,1,0,0,0,0,0,1,27/04/20
Assam,0,27,1,0,0,0,0,36,27/04/20
Bihar,0,56,2,0,0,0,0,277,27/04/20
Chandigarh,0,17,0,0,0,0,0,30,27/04/20
Chhattisgarh,0,32,0,0,0,0,0,37,27/04/20
Delhi,0,877,54,0,0,0,0,2918,27/04/20
Goa,0,7,0,0,0,0,0,7,27/04/20
Gujarat,0,313,151,0,0,0,0,3301,27/04/20
Haryana,0,176,3,0,0,0,0,289,27/04/20
Himachal Pradesh,0,22,1,0,0,0,0,40,27/04/20
Jammu and Kashmir,0,137,6,0,0,0,0,523,27/04/20
Jharkhand,0,13,3,0,0,0,0,82,27/04/20
Karnataka,0,188,20,0,0,0,0,511,27/04/20
Kerala,0,342,4,0,0,0,0,469,27/04/20
Ladakh,0,14,0,0,0,0,0,20,27/04/20
Madhya Pradesh,0,302,106,0,0,0,0,2168,27/04/20
Maharashtra,0,1188,342,0,0,0,0,8068,27/04/20
Manipur,0,2,0,0,0,0,0,2,27/04/20
Meghalaya,0,0,1,0,0,0,0,12,27/04/20
Mizoram,0,0,0,0,0,0,0,1,27/04/20
Odisha,0,35,1,0,0,0,0,108,27/04/20
Puducherry,0,3,0,0,0,0,0,8,27/04/20
Punjab,0,71,18,0,0,0,0,313,27/04/20
Rajasthan,0,518,41,0,0,0,0,2185,27/04/20
Tamil Nadu,0,1020,24,0,0,0,0,1885,27/04/20
Telengana,0,280,26,0,0,0,0,1002,27/04/20
Tripura,0,2,0,0,0,0,0,2,27/04/20
Uttarakhand,0,33,0,0,0,0,0,51,27/04/20
Uttar Pradesh,0,335,31,0,0,0,0,1955,27/04/20
West Bengal,0,105,20,0,0,0,0,649,27/04/20
Andaman and Nicobar Islands,0,11,0,0,0,0,0,33,28/04/20
Andhra Pradesh,0,258,31,0,0,0,0,1259,28/04/20
Arunachal Pradesh,0,1,0,0,0,0,0,1,28/04/20
Assam,0,27,1,0,0,0,0,38,28/04/20
Bihar,0,57,2,0,0,0,0,346,28/04/20
Chandigarh,0,17,0,0,0,0,0,40,28/04/20
Chhattisgarh,0,32,0,0,0,0,0,37,28/04/20
Delhi,0,877,54,0,0,0,0,3108,28/04/20
Goa,0,7,0,0,0,0,0,7,28/04/20
Gujarat,0,394,162,0,0,0,0,3548,28/04/20
Haryana,0,183,3,0,0,0,0,296,28/04/20
Himachal Pradesh,0,22,1,0,0,0,0,40,28/04/20
Jammu and Kashmir,0,164,7,0,0,0,0,546,28/04/20
Jharkhand,0,17,3,0,0,0,0,103,28/04/20
Karnataka,0,198,20,0,0,0,0,520,28/04/20
Kerala,0,355,4,0,0,0,0,482,28/04/20
Ladakh,0,16,0,0,0,0,0,22,28/04/20
Madhya Pradesh,0,361,113,0,0,0,0,2368,28/04/20
Maharashtra,0,1282,369,0,0,0,0,8590,28/04/20
Manipur,0,2,0,0,0,0,0,2,28/04/20
Meghalaya,0,0,1,0,0,0,0,12,28/04/20
Mizoram,0,0,0,0,0,0,0,1,28/04/20
Odisha,0,37,1,0,0,0,0,118,28/04/20
Puducherry,0,3,0,0,0,0,0,8,28/04/20
Punjab,0,71,18,0,0,0,0,313,28/04/20
Rajasthan,0,669,46,0,0,0,0,2262,28/04/20
Tamil Nadu,0,1101,24,0,0,0,0,1937,28/04/20
Telengana,0,321,26,0,0,0,0,1004,28/04/20
Tripura,0,2,0,0,0,0,0,2,28/04/20
Uttarakhand,0,33,0,0,0,0,0,51,28/04/20
Uttar Pradesh,0,400,31,0,0,0,0,2043,28/04/20
West Bengal,0,109,20,0,0,0,0,697,28/04/20
Andaman and Nicobar Islands,0,15,0,0,0,0,0,33,29/04/20
Andhra Pradesh,0,287,31,0,0,0,0,1332,29/04/20
Arunachal Pradesh,0,1,0,0,0,0,0,1,29/04/20
Assam,0,27,1,0,0,0,0,38,29/04/20
Bihar,0,64,2,0,0,0,0,383,29/04/20
Chandigarh,0,17,0,0,0,0,0,56,29/04/20
Chhattisgarh,0,34,0,0,0,0,0,38,29/04/20
Delhi,0,1078,54,0,0,0,0,3314,29/04/20
Goa,0,7,0,0,0,0,0,7,29/04/20
Gujarat,0,434,181,0,0,0,0,3774,29/04/20
Haryana,0,209,3,0,0,0,0,310,29/04/20
Himachal Pradesh,0,25,1,0,0,0,0,40,29/04/20
Jammu and Kashmir,0,176,8,0,0,0,0,565,29/04/20
Jharkhand,0,19,3,0,0,0,0,105,29/04/20
Karnataka,0,215,20,0,0,0,0,532,29/04/20
Kerala,0,359,4,0,0,0,0,486,29/04/20
Ladakh,0,16,0,0,0,0,0,22,29/04/20
Madhya Pradesh,0,377,119,0,0,0,0,2561,29/04/20
Maharashtra,0,1388,400,0,0,0,0,9318,29/04/20
Manipur,0,2,0,0,0,0,0,2,29/04/20
Meghalaya,0,0,1,0,0,0,0,12,29/04/20
Mizoram,0,0,0,0,0,0,0,1,29/04/20
Odisha,0,38,1,0,0,0,0,119,29/04/20
Puducherry,0,3,0,0,0,0,0,8,29/04/20
Punjab,0,71,19,0,0,0,0,322,29/04/20
Rajasthan,0,768,51,0,0,0,0,2364,29/04/20
Tamil Nadu,0,1168,25,0,0,0,0,2058,29/04/20
Telengana,0,367,26,0,0,0,0,1012,29/04/20
Tripura,0,2,0,0,0,0,0,2,29/04/20
Uttarakhand,0,34,0,0,0,0,0,54,29/04/20
Uttar Pradesh,0,477,36,0,0,0,0,2115,29/04/20
West Bengal,0,119,22,0,0,0,0,725,29/04/20
Andaman and Nicobar Islands,0,15,0,0,0,0,0,33,30/04/20
Andhra Pradesh,0,321,31,0,0,0,0,1403,30/04/20
Arunachal Pradesh,0,1,0,0,0,0,0,1,30/04/20
Assam,0,29,1,0,0,0,0,42,30/04/20
Bihar,0,65,2,0,0,0,0,403,30/04/20
Chandigarh,0,17,0,0,0,0,0,56,30/04/20
Chhattisgarh,0,36,0,0,0,0,0,38,30/04/20
Delhi,0,1092,56,0,0,0,0,3439,30/04/20
Goa,0,7,0,0,0,0,0,7,30/04/20
Gujarat,0,527,197,0,0,0,0,4082,30/04/20
Haryana,0,209,3,0,0,0,0,310,30/04/20
Himachal Pradesh,0,25,1,0,0,0,0,40,30/04/20
Jammu and Kashmir,0,192,8,0,0,0,0,581,30/04/20
Jharkhand,0,19,3,0,0,0,0,107,30/04/20
Karnataka,0,223,21,0,0,0,0,557,30/04/20
Kerala,0,369,4,0,0,0,0,496,30/04/20
Ladakh,0,16,0,0,0,0,0,22,30/04/20
Madhya Pradesh,0,461,130,0,0,0,0,2660,30/04/20
Maharashtra,0,1593,432,0,0,0,0,9915,30/04/20
Manipur,0,2,0,0,0,0,0,2,30/04/20
Meghalaya,0,0,1,0,0,0,0,12,30/04/20
Mizoram,0,0,0,0,0,0,0,1,30/04/20
Odisha,0,39,1,0,0,0,0,128,30/04/20
Puducherry,0,5,0,0,0,0,0,8,30/04/20
Punjab,0,90,19,0,0,0,0,357,30/04/20
Rajasthan,0,768,51,0,0,0,0,2438,30/04/20
Tamil Nadu,0,1210,27,0,0,0,0,2162,30/04/20
Telengana,0,367,26,0,0,0,0,1012,30/04/20
Tripura,0,2,0,0,0,0,0,2,30/04/20
Uttarakhand,0,36,0,0,0,0,0,55,30/04/20
Uttar Pradesh,0,513,39,0,0,0,0,2203,30/04/20
West Bengal,0,124,22,0,0,0,0,758,30/04/20
Andaman and Nicobar Islands,0,16,0,0,0,0,0,33,01/05/20
Andhra Pradesh,0,403,33,0,0,0,0,1463,01/05/20
Arunachal Pradesh,0,1,0,0,0,0,0,1,01/05/20
Assam,0,29,1,0,0,0,0,42,01/05/20
Bihar,0,82,2,0,0,0,0,426,01/05/20
Chandigarh,0,17,0,0,0,0,0,56,01/05/20
Chhattisgarh,0,36,0,0,0,0,0,40,01/05/20
Delhi,0,1094,59,0,0,0,0,3515,01/05/20
Goa,0,7,0,0,0,0,0,7,01/05/20
Gujarat,0,613,214,0,0,0,0,4395,01/05/20
Haryana,0,209,3,0,0,0,0,313,01/05/20
Himachal Pradesh,0,28,1,0,0,0,0,40,01/05/20
Jammu and Kashmir,0,216,8,0,0,0,0,614,01/05/20
Jharkhand,0,20,3,0,0,0,0,111,01/05/20
Karnataka,0,235,22,0,0,0,0,576,01/05/20
Kerala,0,383,4,0,0,0,0,497,01/05/20
Ladakh,0,16,0,0,0,0,0,22,01/05/20
Madhya Pradesh,0,482,137,0,0,0,0,2719,01/05/20
Maharashtra,0,1773,459,0,0,0,0,10498,01/05/20
Manipur,0,2,0,0,0,0,0,2,01/05/20
Meghalaya,0,0,1,0,0,0,0,12,01/05/20
Mizoram,0,0,0,0,0,0,0,1,01/05/20
Odisha,0,41,1,0,0,0,0,143,01/05/20
Puducherry,0,5,0,0,0,0,0,8,01/05/20
Punjab,0,90,19,0,0,0,0,357,01/05/20
Rajasthan,0,836,58,0,0,0,0,2584,01/05/20
Tamil Nadu,0,1258,27,0,0,0,0,2323,01/05/20
Telengana,0,441,26,0,0,0,0,1039,01/05/20
Tripura,0,2,0,0,0,0,0,2,01/05/20
Uttarakhand,0,36,0,0,0,0,0,57,01/05/20
Uttar Pradesh,0,555,41,0,0,0,0,2281,01/05/20
West Bengal,0,139,33,0,0,0,0,795,01/05/20
Andaman and Nicobar Islands,0,16,0,0,0,0,0,33,02/05/20
Andhra Pradesh,0,403,33,0,0,0,0,1463,02/05/20
Arunachal Pradesh,0,1,0,0,0,0,0,1,02/05/20
Assam,0,32,1,0,0,0,0,43,02/05/20
Bihar,0,98,3,0,0,0,0,471,02/05/20
Chandigarh,0,17,0,0,0,0,0,88,02/05/20
Chhattisgarh,0,36,0,0,0,0,0,43,02/05/20
Delhi,0,1167,61,0,0,0,0,3738,02/05/20
Goa,0,7,0,0,0,0,0,7,02/05/20
Gujarat,0,735,236,0,0,0,0,4721,02/05/20
Haryana,0,227,4,0,0,0,0,360,02/05/20
Himachal Pradesh,0,30,1,0,0,0,0,40,02/05/20
Jammu and Kashmir,0,247,8,0,0,0,0,639,02/05/20
Jharkhand,0,20,3,0,0,0,0,111,02/05/20
Karnataka,0,251,22,0,0,0,0,589,02/05/20
Kerala,0,392,4,0,0,0,0,497,02/05/20
Ladakh,0,17,0,0,0,0,0,22,02/05/20
Madhya Pradesh,0,524,145,0,0,0,0,2719,02/05/20
Maharashtra,0,1879,485,0,0,0,0,11506,02/05/20
Manipur,0,2,0,0,0,0,0,2,02/05/20
Meghalaya,0,0,1,0,0,0,0,12,02/05/20
Mizoram,0,0,0,0,0,0,0,1,02/05/20
Odisha,0,55,1,0,0,0,0,149,02/05/20
Puducherry,0,5,0,0,0,0,0,8,02/05/20
Punjab,0,90,19,0,0,0,0,480,02/05/20
Rajasthan,0,1116,62,0,0,0,0,2666,02/05/20
Tamil Nadu,0,1312,28,0,0,0,0,2526,02/05/20
Telengana,0,441,26,0,0,0,0,1039,02/05/20
Tripura,0,2,0,0,0,0,0,2,02/05/20
Uttarakhand,0,36,0,0,0,0,0,58,02/05/20
Uttar Pradesh,0,654,42,0,0,0,0,2328,02/05/20
West Bengal,0,139,33,0,0,0,0,795,02/05/20
Andaman and Nicobar Islands,0,17,0,0,0,0,0,33,03/05/20
Andhra Pradesh,0,488,33,0,0,0,0,1583,03/05/20
Arunachal Pradesh,0,1,0,0,0,0,0,1,03/05/20
Assam,0,32,1,0,0,0,0,43,03/05/20
Bihar,0,117,4,0,0,0,0,482,03/05/20
Chandigarh,0,19,0,0,0,0,0,94,03/05/20
Chhattisgarh,0,36,0,0,0,0,0,43,03/05/20
Delhi,0,1256,64,0,0,0,0,4122,03/05/20
Goa,0,7,0,0,0,0,0,7,03/05/20
Gujarat,0,896,262,0,0,0,0,5055,03/05/20
Haryana,0,227,4,0,0,0,0,394,03/05/20
Himachal Pradesh,0,33,1,0,0,0,0,40,03/05/20
Jammu and Kashmir,0,254,8,0,0,0,0,666,03/05/20
Jharkhand,0,22,3,0,0,0,0,115,03/05/20
Karnataka,0,282,25,0,0,0,0,606,03/05/20
Kerala,0,400,4,0,0,0,0,500,03/05/20
Ladakh,0,17,0,0,0,0,0,40,03/05/20
Madhya Pradesh,0,798,156,0,0,0,0,2846,03/05/20
Maharashtra,0,2000,521,0,0,0,0,12296,03/05/20
Manipur,0,2,0,0,0,0,0,2,03/05/20
Meghalaya,0,0,1,0,0,0,0,12,03/05/20
Mizoram,0,0,0,0,0,0,0,1,03/05/20
Odisha,0,56,1,0,0,0,0,160,03/05/20
Puducherry,0,5,0,0,0,0,0,8,03/05/20
Punjab,0,112,20,0,0,0,0,772,03/05/20
Rajasthan,0,1121,65,0,0,0,0,2772,03/05/20
Tamil Nadu,0,1341,29,0,0,0,0,2757,03/05/20
Telengana,0,458,28,0,0,0,0,1063,03/05/20
Tripura,0,2,0,0,0,0,0,4,03/05/20
Uttarakhand,0,39,0,0,0,0,0,59,03/05/20
Uttar Pradesh,0,698,43,0,0,0,0,2626,03/05/20
West Bengal,0,151,33,0,0,0,0,922,03/05/20
Andaman and Nicobar Islands,0,32,0,0,0,0,0,33,04/05/20
Andhra Pradesh,0,524,36,0,0,0,0,1650,04/05/20
Arunachal Pradesh,0,1,0,0,0,0,0,1,04/05/20
Assam,0,32,1,0,0,0,0,43,04/05/20
Bihar,0,125,4,0,0,0,0,517,04/05/20
Chandigarh,0,19,0,0,0,0,0,94,04/05/20
Chhattisgarh,0,36,0,0,0,0,0,57,04/05/20
Delhi,0,1362,64,0,0,0,0,4549,04/05/20
Goa,0,7,0,0,0,0,0,7,04/05/20
Gujarat,0,1042,290,0,0,0,0,5428,04/05/20
Haryana,0,245,5,0,0,0,0,442,04/05/20
Himachal Pradesh,0,34,1,0,0,0,0,40,04/05/20
Jammu and Kashmir,0,287,8,0,0,0,0,701,04/05/20
Jharkhand,0,22,3,0,0,0,0,115,04/05/20
Karnataka,0,304,26,0,0,0,0,642,04/05/20
Kerala,0,401,4,0,0,0,0,500,04/05/20
Ladakh,0,17,0,0,0,0,0,41,04/05/20
Madhya Pradesh,0,798,165,0,0,0,0,2942,04/05/20
Maharashtra,0,2115,548,0,0,0,0,12974,04/05/20
Manipur,0,2,0,0,0,0,0,2,04/05/20
Meghalaya,0,0,1,0,0,0,0,12,04/05/20
Mizoram,0,0,0,0,0,0,0,1,04/05/20
Odisha,0,60,1,0,0,0,0,163,04/05/20
Puducherry,0,5,0,0,0,0,0,8,04/05/20
Punjab,0,117,21,0,0,0,0,1102,04/05/20
Rajasthan,0,1356,71,0,0,0,0,2886,04/05/20
Tamil Nadu,0,1379,30,0,0,0,0,3023,04/05/20
Telengana,0,490,29,0,0,0,0,1082,04/05/20
Tripura,0,2,0,0,0,0,0,16,04/05/20
Uttarakhand,0,39,1,0,0,0,0,60,04/05/20
Uttar Pradesh,0,758,45,0,0,0,0,2742,04/05/20
West Bengal,0,151,35,0,0,0,0,963,04/05/20
Andaman and Nicobar Islands,0,32,0,0,0,0,0,33,05/05/20
Andhra Pradesh,0,589,36,0,0,0,0,1717,05/05/20
Arunachal Pradesh,0,1,0,0,0,0,0,1,05/05/20
Assam,0,32,1,0,0,0,0,43,05/05/20
Bihar,0,130,4,0,0,0,0,529,05/05/20
Chandigarh,0,21,1,0,0,0,0,102,05/05/20
Chhattisgarh,0,36,0,0,0,0,0,58,05/05/20
Delhi,0,1431,64,0,0,0,0,4898,05/05/20
Goa,0,7,0,0,0,0,0,7,05/05/20
Gujarat,0,1195,319,0,0,0,0,5804,05/05/20
Haryana,0,254,6,0,0,0,0,517,05/05/20
Himachal Pradesh,0,38,1,0,0,0,0,41,05/05/20
Jammu and Kashmir,0,303,8,0,0,0,0,726,05/05/20
Jharkhand,0,27,3,0,0,0,0,115,05/05/20
Karnataka,0,324,28,0,0,0,0,659,05/05/20
Kerala,0,462,4,0,0,0,0,500,05/05/20
Ladakh,0,17,0,0,0,0,0,41,05/05/20
Madhya Pradesh,0,1000,176,0,0,0,0,3049,05/05/20
Maharashtra,0,2465,583,0,0,0,0,14541,05/05/20
Manipur,0,2,0,0,0,0,0,2,05/05/20
Meghalaya,0,10,1,0,0,0,0,12,05/05/20
Mizoram,0,0,0,0,0,0,0,1,05/05/20
Odisha,0,60,1,0,0,0,0,170,05/05/20
Puducherry,0,6,0,0,0,0,0,9,05/05/20
Punjab,0,128,23,0,0,0,0,1233,05/05/20
Rajasthan,0,1394,77,0,0,0,0,3061,05/05/20
Tamil Nadu,0,1409,31,0,0,0,0,3550,05/05/20
Telengana,0,585,29,0,0,0,0,1085,05/05/20
Tripura,0,2,0,0,0,0,0,29,05/05/20
Uttarakhand,0,39,1,0,0,0,0,60,05/05/20
Uttar Pradesh,0,944,53,0,0,0,0,2859,05/05/20
West Bengal,0,218,133,0,0,0,0,1259,05/05/20
Andaman and Nicobar Islands,0,32,0,0,0,0,0,33,06/05/20
Andhra Pradesh,0,589,36,0,0,0,0,1717,06/05/20
Arunachal Pradesh,0,1,0,0,0,0,0,1,06/05/20
Assam,0,32,1,0,0,0,0,43,06/05/20
Bihar,0,142,4,0,0,0,0,536,06/05/20
Chandigarh,0,21,1,0,0,0,0,111,06/05/20
Chhattisgarh,0,36,0,0,0,0,0,59,06/05/20
Dadar Nagar Haveli,0,0,0,0,0,0,0,1,06/05/20
Delhi,0,1468,64,0,0,0,0,5104,06/05/20
Goa,0,7,0,0,0,0,0,7,06/05/20
Gujarat,0,1381,368,0,0,0,0,6245,06/05/20
Haryana,0,256,6,0,0,0,0,548,06/05/20
Himachal Pradesh,0,38,2,0,0,0,0,42,06/05/20
Jammu and Kashmir,0,320,8,0,0,0,0,741,06/05/20
Jharkhand,0,33,3,0,0,0,0,125,06/05/20
Karnataka,0,331,29,0,0,0,0,671,06/05/20
Kerala,0,462,4,0,0,0,0,502,06/05/20
Ladakh,0,17,0,0,0,0,0,41,06/05/20
Madhya Pradesh,0,1000,176,0,0,0,0,3049,06/05/20
Maharashtra,0,2819,617,0,0,0,0,15525,06/05/20
Manipur,0,2,0,0,0,0,0,2,06/05/20
Meghalaya,0,10,1,0,0,0,0,12,06/05/20
Mizoram,0,0,0,0,0,0,0,1,06/05/20
Odisha,0,60,1,0,0,0,0,175,06/05/20
Puducherry,0,6,0,0,0,0,0,9,06/05/20
Punjab,0,133,25,0,0,0,0,1451,06/05/20
Rajasthan,0,1525,89,0,0,0,0,3158,06/05/20
Tamil Nadu,0,1485,33,0,0,0,0,4058,06/05/20
Telengana,0,585,29,0,0,0,0,1096,06/05/20
Tripura,0,2,0,0,0,0,0,43,06/05/20
Uttarakhand,0,39,1,0,0,0,0,61,06/05/20
Uttar Pradesh,0,987,56,0,0,0,0,2880,06/05/20
West Bengal,0,364,140,0,0,0,0,1344,06/05/20
Andaman and Nicobar Islands,0,32,0,0,0,0,0,33,07/05/20
Andhra Pradesh,0,729,36,0,0,0,0,1777,07/05/20
Arunachal Pradesh,0,1,0,0,0,0,0,1,07/05/20
Assam,0,32,1,0,0,0,0,45,07/05/20
Bihar,0,188,4,0,0,0,0,542,07/05/20
Chandigarh,0,21,1,0,0,0,0,120,07/05/20
Chhattisgarh,0,36,0,0,0,0,0,59,07/05/20
Dadar Nagar Haveli,0,0,0,0,0,0,0,1,07/05/20
Delhi,0,1542,65,0,0,0,0,5532,07/05/20
Goa,0,7,0,0,0,0,0,7,07/05/20
Gujarat,0,1500,396,0,0,0,0,6625,07/05/20
Haryana,0,260,7,0,0,0,0,594,07/05/20
Himachal Pradesh,0,38,2,0,0,0,0,45,07/05/20
Jammu and Kashmir,0,322,8,0,0,0,0,775,07/05/20
Jharkhand,0,37,3,0,0,0,0,127,07/05/20
Karnataka,0,354,29,0,0,0,0,693,07/05/20
Kerala,0,469,4,0,0,0,0,503,07/05/20
Ladakh,0,17,0,0,0,0,0,41,07/05/20
Madhya Pradesh,0,1099,185,0,0,0,0,3138,07/05/20
Maharashtra,0,3094,651,0,0,0,0,16758,07/05/20
Manipur,0,2,0,0,0,0,0,2,07/05/20
Meghalaya,0,10,1,0,0,0,0,12,07/05/20
Mizoram,0,0,0,0,0,0,0,1,07/05/20
Odisha,0,61,2,0,0,0,0,185,07/05/20
Puducherry,0,6,0,0,0,0,0,9,07/05/20
Punjab,0,135,27,0,0,0,0,1516,07/05/20
Rajasthan,0,1596,92,0,0,0,0,3317,07/05/20
Tamil Nadu,0,1516,35,0,0,0,0,4829,07/05/20
Telengana,0,628,29,0,0,0,0,1107,07/05/20
Tripura,0,2,0,0,0,0,0,43,07/05/20
Uttarakhand,0,39,1,0,0,0,0,61,07/05/20
Uttar Pradesh,0,1130,60,0,0,0,0,2998,07/05/20
West Bengal,0,364,144,0,0,0,0,1456,07/05/20
Andaman and Nicobar Islands,0,33,0,0,0,0,0,33,08/05/20
Andhra Pradesh,0,780,38,0,0,0,0,1847,08/05/20
Arunachal Pradesh,0,1,0,0,0,0,0,1,08/05/20
Assam,0,34,1,0,0,0,0,54,08/05/20
Bihar,0,246,5,0,0,0,0,550,08/05/20
Chandigarh,0,21,1,0,0,0,0,135,08/05/20
Chhattisgarh,0,38,0,0,0,0,0,59,08/05/20
Dadar Nagar Haveli,0,0,0,0,0,0,0,1,08/05/20
Delhi,0,1931,66,0,0,0,0,5980,08/05/20
Goa,0,7,0,0,0,0,0,7,08/05/20
Gujarat,0,1709,425,0,0,0,0,7012,08/05/20
Haryana,0,260,7,0,0,0,0,625,08/05/20
Himachal Pradesh,0,38,2,0,0,0,0,46,08/05/20
Jammu and Kashmir,0,335,9,0,0,0,0,793,08/05/20
Jharkhand,0,41,3,0,0,0,0,132,08/05/20
Karnataka,0,366,30,0,0,0,0,705,08/05/20
Kerala,0,474,4,0,0,0,0,503,08/05/20
Ladakh,0,17,0,0,0,0,0,42,08/05/20
Madhya Pradesh,0,1231,193,0,0,0,0,3252,08/05/20
Maharashtra,0,3301,694,0,0,0,0,17974,08/05/20
Manipur,0,2,0,0,0,0,0,2,08/05/20
Meghalaya,0,10,1,0,0,0,0,12,08/05/20
Mizoram,0,0,0,0,0,0,0,1,08/05/20
Odisha,0,62,2,0,0,0,0,219,08/05/20
Puducherry,0,6,0,0,0,0,0,9,08/05/20
Punjab,0,149,28,0,0,0,0,1644,08/05/20
Rajasthan,0,1596,97,0,0,0,0,3427,08/05/20
Tamil Nadu,0,1547,37,0,0,0,0,5409,08/05/20
Telengana,0,650,29,0,0,0,0,1123,08/05/20
Tripura,0,2,0,0,0,0,0,65,08/05/20
Uttarakhand,0,39,1,0,0,0,0,61,08/05/20
Uttar Pradesh,0,1250,62,0,0,0,0,3071,08/05/20
West Bengal,0,364,151,0,0,0,0,1548,08/05/20
Andaman and Nicobar Islands,0,33,0,0,0,0,0,33,09/05/20
Andhra Pradesh,0,842,41,0,0,0,0,1887,09/05/20
Arunachal Pradesh,0,1,0,0,0,0,0,1,09/05/20
Assam,0,34,1,0,0,0,0,59,09/05/20
Bihar,0,297,5,0,0,0,0,571,09/05/20
Chandigarh,0,21,1,0,0,0,0,150,09/05/20
Chhattisgarh,0,38,0,0,0,0,0,59,09/05/20
Dadar Nagar Haveli,0,0,0,0,0,0,0,1,09/05/20
Delhi,0,2020,68,0,0,0,0,6318,09/05/20
Goa,0,7,0,0,0,0,0,7,09/05/20
Gujarat,0,1872,449,0,0,0,0,7402,09/05/20
Haryana,0,279,8,0,0,0,0,647,09/05/20
Himachal Pradesh,0,38,2,0,0,0,0,50,09/05/20
Jammu and Kashmir,0,364,9,0,0,0,0,823,09/05/20
Jharkhand,0,52,3,0,0,0,0,132,09/05/20
Karnataka,0,376,30,0,0,0,0,753,09/05/20
Kerala,0,484,4,0,0,0,0,503,09/05/20
Ladakh,0,17,0,0,0,0,0,42,09/05/20
Madhya Pradesh,0,1349,200,0,0,0,0,3341,09/05/20
Maharashtra,0,3470,731,0,0,0,0,19063,09/05/20
Manipur,0,2,0,0,0,0,0,2,09/05/20
Meghalaya,0,10,1,0,0,0,0,12,09/05/20
Mizoram,0,0,0,0,0,0,0,1,09/05/20
Odisha,0,63,2,0,0,0,0,271,09/05/20
Puducherry,0,6,0,0,0,0,0,9,09/05/20
Punjab,0,152,29,0,0,0,0,1731,09/05/20
Rajasthan,0,1916,101,0,0,0,0,3579,09/05/20
Tamil Nadu,0,1605,40,0,0,0,0,6009,09/05/20
Telengana,0,700,29,0,0,0,0,1133,09/05/20
Tripura,0,2,0,0,0,0,0,118,09/05/20
Uttarakhand,0,46,1,0,0,0,0,63,09/05/20
Uttar Pradesh,0,1387,66,0,0,0,0,3214,09/05/20
West Bengal,0,364,160,0,0,0,0,1678,09/05/20
Andaman and Nicobar Islands,0,33,0,0,0,0,0,33,10/05/20
Andhra Pradesh,0,887,44,0,0,0,0,1930,10/05/20
Arunachal Pradesh,0,1,0,0,0,0,0,1,10/05/20
Assam,0,34,2,0,0,0,0,63,10/05/20
Bihar,0,322,5,0,0,0,0,591,10/05/20
Chandigarh,0,24,2,0,0,0,0,169,10/05/20
Chhattisgarh,0,43,0,0,0,0,0,59,10/05/20
Dadar Nagar Haveli,0,0,0,0,0,0,0,1,10/05/20
Delhi,0,2020,73,0,0,0,0,6542,10/05/20
Goa,0,7,0,0,0,0,0,7,10/05/20
Gujarat,0,2091,472,0,0,0,0,7796,10/05/20
Haryana,0,290,9,0,0,0,0,675,10/05/20
Himachal Pradesh,0,38,2,0,0,0,0,50,10/05/20
Jammu and Kashmir,0,368,9,0,0,0,0,836,10/05/20
Jharkhand,0,78,3,0,0,0,0,156,10/05/20
Karnataka,0,386,30,0,0,0,0,794,10/05/20
Kerala,0,485,4,0,0,0,0,505,10/05/20
Ladakh,0,17,0,0,0,0,0,42,10/05/20
Madhya Pradesh,0,1676,215,0,0,0,0,3614,10/05/20
Maharashtra,0,3800,779,0,0,0,0,20228,10/05/20
Manipur,0,2,0,0,0,0,0,2,10/05/20
Meghalaya,0,10,1,0,0,0,0,13,10/05/20
Mizoram,0,1,0,0,0,0,0,1,10/05/20
Odisha,0,63,2,0,0,0,0,294,10/05/20
Puducherry,0,6,0,0,0,0,0,9,10/05/20
Punjab,0,157,31,0,0,0,0,1762,10/05/20
Rajasthan,0,2026,106,0,0,0,0,3708,10/05/20
Tamil Nadu,0,1824,44,0,0,0,0,6535,10/05/20
Telengana,0,750,30,0,0,0,0,1163,10/05/20
Tripura,0,2,0,0,0,0,0,134,10/05/20
Uttarakhand,0,46,1,0,0,0,0,67,10/05/20
Uttar Pradesh,0,1499,74,0,0,0,0,3373,10/05/20
West Bengal,0,372,171,0,0,0,0,1786,10/05/20
Andaman and Nicobar Islands,0,33,0,0,0,0,0,33,11/05/20
Andhra Pradesh,0,925,45,0,0,0,0,1980,11/05/20
Arunachal Pradesh,0,1,0,0,0,0,0,1,11/05/20
Assam,0,34,2,0,0,0,0,63,11/05/20
Bihar,0,365,6,0,0,0,0,696,11/05/20
Chandigarh,0,24,2,0,0,0,0,169,11/05/20
Chhattisgarh,0,49,0,0,0,0,0,59,11/05/20
Dadar Nagar Haveli,0,0,0,0,0,0,0,1,11/05/20
Delhi,0,2069,73,0,0,0,0,6923,11/05/20
Goa,0,7,0,0,0,0,0,7,11/05/20
Gujarat,0,2545,493,0,0,0,0,8194,11/05/20
Haryana,0,300,10,0,0,0,0,703,11/05/20
Himachal Pradesh,0,39,2,0,0,0,0,55,11/05/20
Jammu and Kashmir,0,383,9,0,0,0,0,861,11/05/20
Jharkhand,0,78,3,0,0,0,0,157,11/05/20
Karnataka,0,424,31,0,0,0,0,848,11/05/20
Kerala,0,489,4,0,0,0,0,512,11/05/20
Ladakh,0,21,0,0,0,0,0,42,11/05/20
Madhya Pradesh,0,1676,215,0,0,0,0,3614,11/05/20
Maharashtra,0,4199,832,0,0,0,0,22171,11/05/20
Manipur,0,2,0,0,0,0,0,2,11/05/20
Meghalaya,0,10,1,0,0,0,0,13,11/05/20
Mizoram,0,1,0,0,0,0,0,1,11/05/20
Odisha,0,68,3,0,0,0,0,377,11/05/20
Puducherry,0,6,0,0,0,0,0,9,11/05/20
Punjab,0,166,31,0,0,0,0,1823,11/05/20
Rajasthan,0,2176,107,0,0,0,0,3814,11/05/20
Tamil Nadu,0,1959,47,0,0,0,0,7204,11/05/20
Telengana,0,750,30,0,0,0,0,1196,11/05/20
Tripura,0,2,0,0,0,0,0,150,11/05/20
Uttarakhand,0,46,1,0,0,0,0,68,11/05/20
Uttar Pradesh,0,1653,74,0,0,0,0,3467,11/05/20
West Bengal,0,417,185,0,0,0,0,1939,11/05/20
Andaman and Nicobar Islands,0,33,0,0,0,0,0,33,12/05/20
Andhra Pradesh,0,975,45,0,0,0,0,2018,12/05/20
Arunachal Pradesh,0,1,0,0,0,0,0,1,12/05/20
Assam,0,34,2,0,0,0,0,65,12/05/20
Bihar,0,377,6,0,0,0,0,747,12/05/20
Chandigarh,0,24,2,0,0,0,0,174,12/05/20
Chhattisgarh,0,53,0,0,0,0,0,59,12/05/20
Dadar Nagar Haveli,0,0,0,0,0,0,0,1,12/05/20
Delhi,0,2129,73,0,0,0,0,7233,12/05/20
Goa,0,7,0,0,0,0,0,7,12/05/20
Gujarat,0,2780,513,0,0,0,0,8541,12/05/20
Haryana,0,337,11,0,0,0,0,730,12/05/20
Himachal Pradesh,0,39,2,0,0,0,0,59,12/05/20
Jammu and Kashmir,0,427,10,0,0,0,0,879,12/05/20
Jharkhand,0,78,3,0,0,0,0,160,12/05/20
Karnataka,0,426,31,0,0,0,0,862,12/05/20
Kerala,0,489,4,0,0,0,0,519,12/05/20
Ladakh,0,21,0,0,0,0,0,42,12/05/20
Madhya Pradesh,0,1747,221,0,0,0,0,3785,12/05/20
Maharashtra,0,4786,868,0,0,0,0,23401,12/05/20
Manipur,0,2,0,0,0,0,0,2,12/05/20
Meghalaya,0,10,1,0,0,0,0,13,12/05/20
Mizoram,0,1,0,0,0,0,0,1,12/05/20
Odisha,0,85,3,0,0,0,0,414,12/05/20
Puducherry,0,6,0,0,0,0,0,12,12/05/20
Punjab,0,168,31,0,0,0,0,1877,12/05/20
Rajasthan,0,2264,113,0,0,0,0,3988,12/05/20
Tamil Nadu,0,2051,53,0,0,0,0,8002,12/05/20
Telengana,0,800,30,0,0,0,0,1275,12/05/20
Tripura,0,2,0,0,0,0,0,152,12/05/20
Uttarakhand,0,46,1,0,0,0,0,68,12/05/20
Uttar Pradesh,0,1758,80,0,0,0,0,3573,12/05/20
West Bengal,0,499,190,0,0,0,0,2063,12/05/20
Andaman and Nicobar Islands,0,33,0,0,0,0,0,33,13/05/20
Andhra Pradesh,0,1056,46,0,0,0,0,2090,13/05/20
Arunachal Pradesh,0,1,0,0,0,0,0,1,13/05/20
Assam,0,39,2,0,0,0,0,65,13/05/20
Bihar,0,383,6,0,0,0,0,831,13/05/20
Chandigarh,0,28,3,0,0,0,0,187,13/05/20
Chhattisgarh,0,54,0,0,0,0,0,59,13/05/20
Dadar Nagar Haveli,0,0,0,0,0,0,0,1,13/05/20
Delhi,0,2512,86,0,0,0,0,7639,13/05/20
Goa,0,7,0,0,0,0,0,7,13/05/20
Gujarat,0,3246,537,0,0,0,0,8903,13/05/20
Haryana,0,342,11,0,0,0,0,780,13/05/20
Himachal Pradesh,0,39,2,0,0,0,0,65,13/05/20
Jammu and Kashmir,0,455,10,0,0,0,0,934,13/05/20
Jharkhand,0,79,3,0,0,0,0,172,13/05/20
Karnataka,0,433,31,0,0,0,0,925,13/05/20
Kerala,0,489,4,0,0,0,0,524,13/05/20
Ladakh,0,21,0,0,0,0,0,42,13/05/20
Madhya Pradesh,0,1860,225,0,0,0,0,3986,13/05/20
Maharashtra,0,5125,921,0,0,0,0,24427,13/05/20
Manipur,0,2,0,0,0,0,0,2,13/05/20
Meghalaya,0,10,1,0,0,0,0,13,13/05/20
Mizoram,0,1,0,0,0,0,0,1,13/05/20
Odisha,0,116,3,0,0,0,0,437,13/05/20
Puducherry,0,9,1,0,0,0,0,13,13/05/20
Punjab,0,171,32,0,0,0,0,1914,13/05/20
Rajasthan,0,2378,117,0,0,0,0,4126,13/05/20
Tamil Nadu,0,2134,61,0,0,0,0,8718,13/05/20
Telengana,0,830,32,0,0,0,0,1326,13/05/20
Tripura,0,2,0,0,0,0,0,154,13/05/20
Uttarakhand,0,46,1,0,0,0,0,69,13/05/20
Uttar Pradesh,0,1873,82,0,0,0,0,3664,13/05/20
West Bengal,0,612,198,0,0,0,0,2173,13/05/20
Andaman and Nicobar Islands,0,33,0,0,0,0,0,33,14/05/20
Andhra Pradesh,0,1142,47,0,0,0,0,2137,14/05/20
Arunachal Pradesh,0,1,0,0,0,0,0,1,14/05/20
Assam,0,39,2,0,0,0,0,80,14/05/20
Bihar,0,388,7,0,0,0,0,940,14/05/20
Chandigarh,0,28,3,0,0,0,0,187,14/05/20
Chhattisgarh,0,55,0,0,0,0,0,59,14/05/20
Dadar Nagar Haveli,0,0,0,0,0,0,0,1,14/05/20
Delhi,0,2858,106,0,0,0,0,7998,14/05/20
Goa,0,7,0,0,0,0,0,7,14/05/20
Gujarat,0,3562,566,0,0,0,0,9267,14/05/20
Haryana,0,418,11,0,0,0,0,793,14/05/20
Himachal Pradesh,0,39,2,0,0,0,0,66,14/05/20
Jammu and Kashmir,0,466,11,0,0,0,0,971,14/05/20
Jharkhand,0,79,3,0,0,0,0,173,14/05/20
Karnataka,0,451,33,0,0,0,0,959,14/05/20
Kerala,0,490,4,0,0,0,0,534,14/05/20
Ladakh,0,22,0,0,0,0,0,43,14/05/20
Madhya Pradesh,0,2004,232,0,0,0,0,4173,14/05/20
Maharashtra,0,5547,975,0,0,0,0,25922,14/05/20
Manipur,0,2,0,0,0,0,0,2,14/05/20
Meghalaya,0,10,1,0,0,0,0,13,14/05/20
Mizoram,0,1,0,0,0,0,0,1,14/05/20
Odisha,0,143,3,0,0,0,0,538,14/05/20
Puducherry,0,9,1,0,0,0,0,13,14/05/20
Punjab,0,200,32,0,0,0,0,1924,14/05/20
Rajasthan,0,2459,121,0,0,0,0,4328,14/05/20
Tamil Nadu,0,2176,64,0,0,0,0,9227,14/05/20
Telengana,0,940,34,0,0,0,0,1367,14/05/20
Tripura,0,16,0,0,0,0,0,155,14/05/20
Uttarakhand,0,46,1,0,0,0,0,72,14/05/20
Uttar Pradesh,0,1902,83,0,0,0,0,3729,14/05/20
West Bengal,0,702,207,0,0,0,0,2290,14/05/20
Andaman and Nicobar Islands,0,33,0,0,0,0,0,33,15/05/20
Andhra Pradesh,0,1192,48,0,0,0,0,2205,15/05/20
Arunachal Pradesh,0,1,0,0,0,0,0,1,15/05/20
Assam,0,39,2,0,0,0,0,87,15/05/20
Bihar,0,411,7,0,0,0,0,994,15/05/20
Chandigarh,0,37,3,0,0,0,0,191,15/05/20
Chhattisgarh,0,56,0,0,0,0,0,60,15/05/20
Dadar Nagar Haveli,0,0,0,0,0,0,0,1,15/05/20
Delhi,0,3045,115,0,0,0,0,8470,15/05/20
Goa,0,7,0,0,0,0,0,14,15/05/20
Gujarat,0,3753,586,0,0,0,0,9591,15/05/20
Haryana,0,439,11,0,0,0,0,818,15/05/20
Himachal Pradesh,0,39,2,0,0,0,0,74,15/05/20
Jammu and Kashmir,0,485,11,0,0,0,0,983,15/05/20
Jharkhand,0,87,3,0,0,0,0,197,15/05/20
Karnataka,0,460,35,0,0,0,0,987,15/05/20
Kerala,0,491,4,0,0,0,0,560,15/05/20
Ladakh,0,22,0,0,0,0,0,43,15/05/20
Madhya Pradesh,0,2171,237,0,0,0,0,4426,15/05/20
Maharashtra,0,6059,1019,0,0,0,0,27524,15/05/20
Manipur,0,2,0,0,0,0,0,3,15/05/20
Meghalaya,0,11,1,0,0,0,0,13,15/05/20
Mizoram,0,1,0,0,0,0,0,1,15/05/20
Odisha,0,158,3,0,0,0,0,611,15/05/20
Puducherry,0,9,1,0,0,0,0,13,15/05/20
Punjab,0,223,32,0,0,0,0,1935,15/05/20
Rajasthan,0,2580,125,0,0,0,0,4534,15/05/20
Tamil Nadu,0,2240,66,0,0,0,0,9674,15/05/20
Telengana,0,950,34,0,0,0,0,1414,15/05/20
Tripura,0,29,0,0,0,0,0,156,15/05/20
Uttarakhand,0,50,1,0,0,0,0,78,15/05/20
Uttar Pradesh,0,2072,88,0,0,0,0,3902,15/05/20
West Bengal,0,768,215,0,0,0,0,2377,15/05/20
Andaman and Nicobar Islands,0,33,0,0,0,0,0,33,16/05/20
Andhra Pradesh,0,1252,48,0,0,0,0,2307,16/05/20
Arunachal Pradesh,0,1,0,0,0,0,0,1,16/05/20
Assam,0,41,2,0,0,0,0,90,16/05/20
Bihar,0,438,7,0,0,0,0,1018,16/05/20
Chandigarh,0,37,3,0,0,0,0,191,16/05/20
Chhattisgarh,0,56,0,0,0,0,0,66,16/05/20
Dadar Nagar Haveli,0,0,0,0,0,0,0,1,16/05/20
Delhi,0,3518,123,0,0,0,0,8895,16/05/20
Goa,0,7,0,0,0,0,0,15,16/05/20
Gujarat,0,4035,606,0,0,0,0,9931,16/05/20
Haryana,0,439,11,0,0,0,0,818,16/05/20
Himachal Pradesh,0,39,3,0,0,0,0,76,16/05/20
Jammu and Kashmir,0,513,11,0,0,0,0,1013,16/05/20
Jharkhand,0,87,3,0,0,0,0,203,16/05/20
Karnataka,0,480,36,0,0,0,0,1056,16/05/20
Kerala,0,492,4,0,0,0,0,576,16/05/20
Ladakh,0,22,0,0,0,0,0,43,16/05/20
Madhya Pradesh,0,2283,239,0,0,0,0,4595,16/05/20
Maharashtra,0,6564,1068,0,0,0,0,29100,16/05/20
Manipur,0,2,0,0,0,0,0,3,16/05/20
Meghalaya,0,11,1,0,0,0,0,13,16/05/20
Mizoram,0,1,0,0,0,0,0,1,16/05/20
Odisha,0,166,3,0,0,0,0,672,16/05/20
Puducherry,0,9,1,0,0,0,0,13,16/05/20
Punjab,0,305,32,0,0,0,0,1935,16/05/20
Rajasthan,0,2677,125,0,0,0,0,4727,16/05/20
Tamil Nadu,0,2599,71,0,0,0,0,10108,16/05/20
Telengana,0,959,34,0,0,0,0,1454,16/05/20
Tripura,0,42,0,0,0,0,0,156,16/05/20
Uttarakhand,0,51,1,0,0,0,0,82,16/05/20
Uttar Pradesh,0,2165,95,0,0,0,0,4057,16/05/20
West Bengal,0,829,225,0,0,0,0,2461,16/05/20
Andaman and Nicobar Islands,0,33,0,0,0,0,0,33,17/05/20
Andhra Pradesh,0,1353,49,0,0,0,0,2355,17/05/20
Arunachal Pradesh,0,1,0,0,0,0,0,1,17/05/20
Assam,0,41,2,0,0,0,0,92,17/05/20
Bihar,0,453,7,0,0,0,0,1179,17/05/20
Chandigarh,0,51,3,0,0,0,0,191,17/05/20
Chhattisgarh,0,56,0,0,0,0,0,67,17/05/20
Dadar Nagar Haveli,0,0,0,0,0,0,0,1,17/05/20
Delhi,0,3926,129,0,0,0,0,9333,17/05/20
Goa,0,7,0,0,0,0,0,17,17/05/20
Gujarat,0,4308,625,0,0,0,0,10988,17/05/20
Haryana,0,514,13,0,0,0,0,887,17/05/20
Himachal Pradesh,0,43,3,0,0,0,0,78,17/05/20
Jammu and Kashmir,0,542,12,0,0,0,0,1121,17/05/20
Jharkhand,0,113,3,0,0,0,0,217,17/05/20
Karnataka,0,496,36,0,0,0,0,1092,17/05/20
Kerala,0,495,4,0,0,0,0,587,17/05/20
Ladakh,0,22,0,0,0,0,0,43,17/05/20
Madhya Pradesh,0,2315,243,0,0,0,0,4789,17/05/20
Maharashtra,0,7088,1135,0,0,0,0,30706,17/05/20
Manipur,0,2,0,0,0,0,0,7,17/05/20
Meghalaya,0,11,1,0,0,0,0,13,17/05/20
Mizoram,0,1,0,0,0,0,0,1,17/05/20
Odisha,0,196,3,0,0,0,0,737,17/05/20
Puducherry,0,9,1,0,0,0,0,13,17/05/20
Punjab,0,1257,32,0,0,0,0,1946,17/05/20
Rajasthan,0,2839,126,0,0,0,0,4960,17/05/20
Tamil Nadu,0,3538,74,0,0,0,0,10585,17/05/20
Telengana,0,971,34,0,0,0,0,1509,17/05/20
Tripura,0,64,0,0,0,0,0,167,17/05/20
Uttarakhand,0,51,1,0,0,0,0,88,17/05/20
Uttar Pradesh,0,2441,104,0,0,0,0,4258,17/05/20
West Bengal,0,872,232,0,0,0,0,2576,17/05/20
Andaman and Nicobar Islands,0,33,0,0,0,0,0,33,18/05/20
Andhra Pradesh,0,1456,50,0,0,0,0,2407,18/05/20
Arunachal Pradesh,0,1,0,0,0,0,0,1,18/05/20
Assam,0,41,2,0,0,0,0,101,18/05/20
Bihar,0,475,8,0,0,0,0,1262,18/05/20
Chandigarh,0,51,3,0,0,0,0,191,18/05/20
Chhattisgarh,0,59,0,0,0,0,0,86,18/05/20
Dadar Nagar Haveli,0,0,0,0,0,0,0,1,18/05/20
Delhi,0,4485,160,0,0,0,0,10054,18/05/20
Goa,0,7,0,0,0,0,0,29,18/05/20
Gujarat,0,4499,659,0,0,0,0,11379,18/05/20
Haryana,0,562,14,0,0,0,0,910,18/05/20
Himachal Pradesh,0,44,3,0,0,0,0,80,18/05/20
Jammu and Kashmir,0,575,13,0,0,0,0,1183,18/05/20
Jharkhand,0,113,3,0,0,0,0,223,18/05/20
Karnataka,0,509,37,0,0,0,0,1147,18/05/20
Kerala,0,497,4,0,0,0,0,601,18/05/20
Ladakh,0,24,0,0,0,0,0,43,18/05/20
Madhya Pradesh,0,2403,248,0,0,0,0,4977,18/05/20
Maharashtra,0,7688,1198,0,0,0,0,33053,18/05/20
Manipur,0,2,0,0,0,0,0,7,18/05/20
Meghalaya,0,11,1,0,0,0,0,13,18/05/20
Mizoram,0,1,0,0,0,0,0,1,18/05/20
Odisha,0,220,4,0,0,0,0,828,18/05/20
Puducherry,0,9,1,0,0,0,0,13,18/05/20
Punjab,0,1366,35,0,0,0,0,1964,18/05/20
Rajasthan,0,2992,131,0,0,0,0,5202,18/05/20
Tamil Nadu,0,4172,78,0,0,0,0,11224,18/05/20
Telengana,0,992,34,0,0,0,0,1551,18/05/20
Tripura,0,85,0,0,0,0,0,167,18/05/20
Uttarakhand,0,52,1,0,0,0,0,92,18/05/20
Uttar Pradesh,0,2441,104,0,0,0,0,4259,18/05/20
West Bengal,0,959,238,0,0,0,0,2677,18/05/20
Andaman and Nicobar Islands,0,33,0,0,0,0,0,33,19/05/20
Andhra Pradesh,0,1552,50,0,0,0,0,2474,19/05/20
Arunachal Pradesh,0,1,0,0,0,0,0,1,19/05/20
Assam,0,41,2,0,0,0,0,107,19/05/20
Bihar,0,494,9,0,0,0,0,1391,19/05/20
Chandigarh,0,54,3,0,0,0,0,196,19/05/20
Chhattisgarh,0,59,0,0,0,0,0,93,19/05/20
Dadar Nagar Haveli,0,0,0,0,0,0,0,1,19/05/20
Delhi,0,4485,168,0,0,0,0,10054,19/05/20
Goa,0,7,0,0,0,0,0,38,19/05/20
Gujarat,0,4804,694,0,0,0,0,11745,19/05/20
Haryana,0,598,14,0,0,0,0,928,19/05/20
Himachal Pradesh,0,44,3,0,0,0,0,90,19/05/20
Jammu and Kashmir,0,609,15,0,0,0,0,1289,19/05/20
Jharkhand,0,113,3,0,0,0,0,223,19/05/20
Karnataka,0,530,37,0,0,0,0,1246,19/05/20
Kerala,0,497,4,0,0,0,0,630,19/05/20
Ladakh,0,41,0,0,0,0,0,43,19/05/20
Madhya Pradesh,0,2435,252,0,0,0,0,5236,19/05/20
Maharashtra,0,8437,1249,0,0,0,0,35058,19/05/20
Manipur,0,2,0,0,0,0,0,7,19/05/20
Meghalaya,0,11,1,0,0,0,0,13,19/05/20
Mizoram,0,1,0,0,0,0,0,1,19/05/20
Odisha,0,220,4,0,0,0,0,876,19/05/20
Puducherry,0,9,1,0,0,0,0,18,19/05/20
Punjab,0,1547,37,0,0,0,0,1980,19/05/20
Rajasthan,0,3218,138,0,0,0,0,5507,19/05/20
Tamil Nadu,0,4406,81,0,0,0,0,11760,19/05/20
Telengana,0,1000,35,0,0,0,0,1597,19/05/20
Tripura,0,85,0,0,0,0,0,167,19/05/20
Uttarakhand,0,52,1,0,0,0,0,93,19/05/20
Uttar Pradesh,0,2783,118,0,0,0,0,4605,19/05/20
West Bengal,0,1006,244,0,0,0,0,2825,19/05/20
Andaman and Nicobar Islands,0,33,0,0,0,0,0,33,20/05/20
Andhra Pradesh,0,1621,52,0,0,0,0,2532,20/05/20
Arunachal Pradesh,0,1,0,0,0,0,0,1,20/05/20
Assam,0,41,4,0,0,0,0,142,20/05/20
Bihar,0,534,9,0,0,0,0,1498,20/05/20
Chandigarh,0,57,3,0,0,0,0,200,20/05/20
Chhattisgarh,0,59,0,0,0,0,0,101,20/05/20
Dadar Nagar Haveli,0,0,0,0,0,0,0,1,20/05/20
Delhi,0,4750,168,0,0,0,0,10554,20/05/20
Goa,0,7,0,0,0,0,0,46,20/05/20
Gujarat,0,5043,719,0,0,0,0,12140,20/05/20
Haryana,0,627,14,0,0,0,0,964,20/05/20
Himachal Pradesh,0,47,3,0,0,0,0,92,20/05/20
Jammu and Kashmir,0,653,17,0,0,0,0,1317,20/05/20
Jharkhand,0,127,3,0,0,0,0,231,20/05/20
Karnataka,0,544,40,0,0,0,0,1397,20/05/20
Kerala,0,497,4,0,0,0,0,642,20/05/20
Ladakh,0,43,0,0,0,0,0,43,20/05/20
Madhya Pradesh,0,2630,258,0,0,0,0,5465,20/05/20
Maharashtra,0,9639,1325,0,0,0,0,37136,20/05/20
Manipur,0,2,0,0,0,0,0,9,20/05/20
Meghalaya,0,12,1,0,0,0,0,13,20/05/20
Mizoram,0,1,0,0,0,0,0,1,20/05/20
Odisha,0,277,5,0,0,0,0,978,20/05/20
Puducherry,0,9,1,0,0,0,0,18,20/05/20
Punjab,0,1642,38,0,0,0,0,2002,20/05/20
Rajasthan,0,3337,143,0,0,0,0,5845,20/05/20
Tamil Nadu,0,4895,84,0,0,0,0,12448,20/05/20
Telengana,0,1010,38,0,0,0,0,1634,20/05/20
Tripura,0,116,0,0,0,0,0,173,20/05/20
Uttarakhand,0,52,1,0,0,0,0,111,20/05/20
Uttar Pradesh,0,2918,123,0,0,0,0,4926,20/05/20
West Bengal,0,1074,250,0,0,0,0,2961,20/05/20
Cases being reassigned to states,0,0,0,0,0,0,0,1096,20/05/20
Andaman and Nicobar Islands,0,33,0,0,0,0,0,33,21/05/20
Andhra Pradesh,0,1640,53,0,0,0,0,2602,21/05/20
Arunachal Pradesh,0,1,0,0,0,0,0,1,21/05/20
Assam,0,48,4,0,0,0,0,170,21/05/20
Bihar,0,571,10,0,0,0,0,1674,21/05/20
Chandigarh,0,57,3,0,0,0,0,202,21/05/20
Chhattisgarh,0,59,0,0,0,0,0,115,21/05/20
Dadar Nagar Haveli,0,0,0,0,0,0,0,1,21/05/20
Delhi,0,5192,176,0,0,0,0,11088,21/05/20
Goa,0,7,0,0,0,0,0,50,21/05/20
Gujarat,0,5219,749,0,0,0,0,12537,21/05/20
Haryana,0,648,14,0,0,0,0,993,21/05/20
Himachal Pradesh,0,54,3,0,0,0,0,110,21/05/20
Jammu and Kashmir,0,678,18,0,0,0,0,1390,21/05/20
Jharkhand,0,127,3,0,0,0,0,231,21/05/20
Karnataka,0,556,41,0,0,0,0,1462,21/05/20
Kerala,0,502,4,0,0,0,0,666,21/05/20
Ladakh,0,43,0,0,0,0,0,44,21/05/20
Madhya Pradesh,0,2733,267,0,0,0,0,5735,21/05/20
Maharashtra,0,10318,1390,0,0,0,0,39297,21/05/20
Manipur,0,2,0,0,0,0,0,25,21/05/20
Meghalaya,0,12,1,0,0,0,0,14,21/05/20
Mizoram,0,1,0,0,0,0,0,1,21/05/20
Odisha,0,307,6,0,0,0,0,1052,21/05/20
Puducherry,0,9,0,0,0,0,0,18,21/05/20
Punjab,0,1794,38,0,0,0,0,2005,21/05/20
Rajasthan,0,3404,147,0,0,0,0,6015,21/05/20
Tamil Nadu,0,5882,87,0,0,0,0,13191,21/05/20
Telengana,0,1015,40,0,0,0,0,1661,21/05/20
Tripura,0,133,0,0,0,0,0,173,21/05/20
Uttarakhand,0,53,1,0,0,0,0,122,21/05/20
Uttar Pradesh,0,3066,127,0,0,0,0,5175,21/05/20
West Bengal,0,1136,253,0,0,0,0,3103,21/05/20
Cases being reassigned to states,0,0,0,0,0,0,0,1403,21/05/20
Andaman and Nicobar Islands,0,33,0,0,0,0,0,33,22/05/20
Andhra Pradesh,0,1709,53,0,0,0,0,2647,22/05/20
Arunachal Pradesh,0,1,0,0,0,0,0,1,22/05/20
Assam,0,54,4,0,0,0,0,203,22/05/20
Bihar,0,593,11,0,0,0,0,1982,22/05/20
Chandigarh,0,139,3,0,0,0,0,217,22/05/20
Chhattisgarh,0,59,0,0,0,0,0,128,22/05/20
Dadar Nagar Haveli,0,0,0,0,0,0,0,1,22/05/20
Delhi,0,5567,194,0,0,0,0,11659,22/05/20
Goa,0,7,0,0,0,0,0,52,22/05/20
Gujarat,0,5488,773,0,0,0,0,12905,22/05/20
Haryana,0,681,15,0,0,0,0,1031,22/05/20
Himachal Pradesh,0,59,3,0,0,0,0,152,22/05/20
Jammu and Kashmir,0,684,20,0,0,0,0,1449,22/05/20
Jharkhand,0,129,3,0,0,0,0,290,22/05/20
Karnataka,0,571,41,0,0,0,0,1605,22/05/20
Kerala,0,510,4,0,0,0,0,690,22/05/20
Ladakh,0,43,0,0,0,0,0,44,22/05/20
Madhya Pradesh,0,2843,270,0,0,0,0,5981,22/05/20
Maharashtra,0,11726,1454,0,0,0,0,41642,22/05/20
Manipur,0,2,0,0,0,0,0,25,22/05/20
Meghalaya,0,12,1,0,0,0,0,14,22/05/20
Mizoram,0,1,0,0,0,0,0,1,22/05/20
Odisha,0,393,7,0,0,0,0,1103,22/05/20
Puducherry,0,10,0,0,0,0,0,20,22/05/20
Punjab,0,1819,39,0,0,0,0,2028,22/05/20
Rajasthan,0,3485,151,0,0,0,0,6227,22/05/20
Tamil Nadu,0,6282,94,0,0,0,0,13967,22/05/20
Telengana,0,1035,45,0,0,0,0,1699,22/05/20
Tripura,0,148,0,0,0,0,0,173,22/05/20
Uttarakhand,0,54,1,0,0,0,0,146,22/05/20
Uttar Pradesh,0,3204,138,0,0,0,0,5515,22/05/20
West Bengal,0,1193,259,0,0,0,0,3197,22/05/20
Cases being reassigned to states,0,0,0,0,0,0,0,1620,22/05/20
Andaman and Nicobar Islands,0,33,0,0,0,0,0,33,23/05/20
Andhra Pradesh,0,1763,55,0,0,0,0,2709,23/05/20
Arunachal Pradesh,0,1,0,0,0,0,0,1,23/05/20
Assam,0,54,4,0,0,0,0,259,23/05/20
Bihar,0,629,11,0,0,0,0,2177,23/05/20
Chandigarh,0,178,3,0,0,0,0,218,23/05/20
Chhattisgarh,0,62,0,0,0,0,0,172,23/05/20
Dadar Nagar Haveli,0,0,0,0,0,0,0,1,23/05/20
Delhi,0,5897,208,0,0,0,0,12319,23/05/20
Goa,0,16,0,0,0,0,0,54,23/05/20
Gujarat,0,5880,802,0,0,0,0,13268,23/05/20
Haryana,0,706,16,0,0,0,0,1067,23/05/20
Himachal Pradesh,0,59,3,0,0,0,0,168,23/05/20
Jammu and Kashmir,0,720,20,0,0,0,0,1489,23/05/20
Jharkhand,0,136,3,0,0,0,0,308,23/05/20
Karnataka,0,597,41,0,0,0,0,1743,23/05/20
Kerala,0,512,4,0,0,0,0,732,23/05/20
Ladakh,0,43,0,0,0,0,0,44,23/05/20
Madhya Pradesh,0,3089,272,0,0,0,0,6170,23/05/20
Maharashtra,0,12583,1517,0,0,0,0,44582,23/05/20
Manipur,0,2,0,0,0,0,0,26,23/05/20
Meghalaya,0,12,1,0,0,0,0,14,23/05/20
Mizoram,0,1,0,0,0,0,0,1,23/05/20
Odisha,0,436,7,0,0,0,0,1189,23/05/20
Puducherry,0,10,0,0,0,0,0,26,23/05/20
Punjab,0,1847,39,0,0,0,0,2029,23/05/20
Rajasthan,0,3680,153,0,0,0,0,6494,23/05/20
Tamil Nadu,0,7128,98,0,0,0,0,14753,23/05/20
Telengana,0,1043,45,0,0,0,0,1761,23/05/20
Tripura,0,152,0,0,0,0,0,175,23/05/20
Uttarakhand,0,56,1,0,0,0,0,153,23/05/20
Uttar Pradesh,0,3238,152,0,0,0,0,5735,23/05/20
West Bengal,0,1221,265,0,0,0,0,3332,23/05/20
Cases being reassigned to states,0,0,0,0,0,0,0,1899,23/05/20
Andaman and Nicobar Islands,0,33,0,0,0,0,0,33,24/05/20
Andhra Pradesh,0,1809,56,0,0,0,0,2757,24/05/20
Arunachal Pradesh,0,1,0,0,0,0,0,1,24/05/20
Assam,0,55,4,0,0,0,0,329,24/05/20
Bihar,0,653,11,0,0,0,0,2380,24/05/20
Chandigarh,0,179,3,0,0,0,0,225,24/05/20
Chhattisgarh,0,64,0,0,0,0,0,214,24/05/20
Dadar Nagar Haveli,0,0,0,0,0,0,0,2,24/05/20
Delhi,0,6267,231,0,0,0,0,12910,24/05/20
Goa,0,16,0,0,0,0,0,55,24/05/20
Gujarat,0,6169,829,0,0,0,0,13664,24/05/20
Haryana,0,750,16,0,0,0,0,1131,24/05/20
Himachal Pradesh,0,61,3,0,0,0,0,185,24/05/20
Jammu and Kashmir,0,774,21,0,0,0,0,1569,24/05/20
Jharkhand,0,141,4,0,0,0,0,350,24/05/20
Karnataka,0,608,42,0,0,0,0,1959,24/05/20
Kerala,0,515,4,0,0,0,0,795,24/05/20
Ladakh,0,43,0,0,0,0,0,49,24/05/20
Madhya Pradesh,0,3267,281,0,0,0,0,6371,24/05/20
Maharashtra,0,13404,1577,0,0,0,0,47190,24/05/20
Manipur,0,4,0,0,0,0,0,29,24/05/20
Meghalaya,0,12,1,0,0,0,0,14,24/05/20
Mizoram,0,1,0,0,0,0,0,1,24/05/20
Odisha,0,497,7,0,0,0,0,1269,24/05/20
Puducherry,0,10,0,0,0,0,0,26,24/05/20
Punjab,0,1870,39,0,0,0,0,2045,24/05/20
Rajasthan,0,3786,160,0,0,0,0,6742,24/05/20
Sikkim,0,0,0,0,0,0,0,1,24/05/20
Tamil Nadu,0,7491,103,0,0,0,0,15512,24/05/20
Telengana,0,1065,49,0,0,0,0,1813,24/05/20
Tripura,0,153,0,0,0,0,0,189,24/05/20
Uttarakhand,0,56,2,0,0,0,0,244,24/05/20
Uttar Pradesh,0,3406,155,0,0,0,0,6017,24/05/20
West Bengal,0,1281,269,0,0,0,0,3459,24/05/20
Cases being reassigned to states,0,0,0,0,0,0,0,2338,24/05/20
Andaman and Nicobar Islands,0,33,0,0,0,0,0,33,25/05/20
Andhra Pradesh,0,1856,56,0,0,0,0,2823,25/05/20
Arunachal Pradesh,0,1,0,0,0,0,0,1,25/05/20
Assam,0,55,4,0,0,0,0,378,25/05/20
Bihar,0,702,13,0,0,0,0,2587,25/05/20
Chandigarh,0,186,3,0,0,0,0,238,25/05/20
Chhattisgarh,0,67,0,0,0,0,0,252,25/05/20
Dadar Nagar Haveli,0,0,0,0,0,0,0,2,25/05/20
Delhi,0,6540,261,0,0,0,0,13418,25/05/20
Goa,0,19,0,0,0,0,0,66,25/05/20
Gujarat,0,6412,858,0,0,0,0,14056,25/05/20
Haryana,0,765,16,0,0,0,0,1184,25/05/20
Himachal Pradesh,0,63,3,0,0,0,0,203,25/05/20
Jammu and Kashmir,0,809,21,0,0,0,0,1621,25/05/20
Jharkhand,0,148,4,0,0,0,0,370,25/05/20
Karnataka,0,654,42,0,0,0,0,2089,25/05/20
Kerala,0,521,4,0,0,0,0,847,25/05/20
Ladakh,0,43,0,0,0,0,0,52,25/05/20
Madhya Pradesh,0,3408,290,0,0,0,0,6665,25/05/20
Maharashtra,0,14600,1635,0,0,0,0,50231,25/05/20
Manipur,0,4,0,0,0,0,0,32,25/05/20
Meghalaya,0,12,1,0,0,0,0,14,25/05/20
Mizoram,0,1,0,0,0,0,0,1,25/05/20
Odisha,0,550,7,0,0,0,0,1336,25/05/20
Puducherry,0,12,0,0,0,0,0,41,25/05/20
Punjab,0,1898,40,0,0,0,0,2060,25/05/20
Rajasthan,0,3848,163,0,0,0,0,7028,25/05/20
Sikkim,0,0,0,0,0,0,0,1,25/05/20
Tamil Nadu,0,8324,111,0,0,0,0,16277,25/05/20
Telengana,0,1090,53,0,0,0,0,1854,25/05/20
Tripura,0,165,0,0,0,0,0,191,25/05/20
Uttarakhand,0,58,3,0,0,0,0,317,25/05/20
Uttar Pradesh,0,3538,161,0,0,0,0,6268,25/05/20
West Bengal,0,1339,272,0,0,0,0,3667,25/05/20
Cases being reassigned to states,0,0,0,0,0,0,0,2642,25/05/20
Andaman and Nicobar Islands,0,33,0,0,0,0,0,33,26/05/20
Andhra Pradesh,0,1896,56,0,0,0,0,3110,26/05/20
Arunachal Pradesh,0,1,0,0,0,0,0,2,26/05/20
Assam,0,62,4,0,0,0,0,526,26/05/20
Bihar,0,749,13,0,0,0,0,2730,26/05/20
Chandigarh,0,186,3,0,0,0,0,238,26/05/20
Chhattisgarh,0,72,0,0,0,0,0,291,26/05/20
Dadar Nagar Haveli,0,0,0,0,0,0,0,2,26/05/20
Delhi,0,6771,276,0,0,0,0,14053,26/05/20
Goa,0,19,0,0,0,0,0,67,26/05/20
Gujarat,0,6636,888,0,0,0,0,14460,26/05/20
Haryana,0,765,16,0,0,0,0,1184,26/05/20
Himachal Pradesh,0,67,5,0,0,0,0,223,26/05/20
Jammu and Kashmir,0,809,23,0,0,0,0,1668,26/05/20
Jharkhand,0,148,4,0,0,0,0,377,26/05/20
Karnataka,0,705,44,0,0,0,0,2182,26/05/20
Kerala,0,532,5,0,0,0,0,896,26/05/20
Ladakh,0,43,0,0,0,0,0,52,26/05/20
Madhya Pradesh,0,3571,300,0,0,0,0,6859,26/05/20
Maharashtra,0,15786,1695,0,0,0,0,52667,26/05/20
Manipur,0,4,0,0,0,0,0,39,26/05/20
Meghalaya,0,12,1,0,0,0,0,14,26/05/20
Mizoram,0,1,0,0,0,0,0,1,26/05/20
Nagaland,0,0,0,0,0,0,0,3,26/05/20
Odisha,0,649,7,0,0,0,0,1438,26/05/20
Puducherry,0,12,0,0,0,0,0,41,26/05/20
Punjab,0,1898,40,0,0,0,0,2060,26/05/20
Rajasthan,0,3951,167,0,0,0,0,7300,26/05/20
Sikkim,0,0,0,0,0,0,0,1,26/05/20
Tamil Nadu,0,8731,118,0,0,0,0,17082,26/05/20
Telengana,0,1164,56,0,0,0,0,1920,26/05/20
Tripura,0,165,0,0,0,0,0,194,26/05/20
Uttarakhand,0,58,3,0,0,0,0,349,26/05/20
Uttar Pradesh,0,3581,165,0,0,0,0,6532,26/05/20
West Bengal,0,1414,278,0,0,0,0,3816,26/05/20
Cases being reassigned to states,0,0,0,0,0,0,0,2970,26/05/20
Andaman and Nicobar Islands,0,33,0,0,0,0,0,33,27/05/20
Andhra Pradesh,0,2009,57,0,0,0,0,3171,27/05/20
Arunachal Pradesh,0,1,0,0,0,0,0,2,27/05/20
Assam,0,62,4,0,0,0,0,616,27/05/20
Bihar,0,900,13,0,0,0,0,2983,27/05/20
Chandigarh,0,187,4,0,0,0,0,266,27/05/20
Chhattisgarh,0,79,0,0,0,0,0,361,27/05/20
Dadar Nagar Haveli,0,0,0,0,0,0,0,2,27/05/20
Delhi,0,7223,288,0,0,0,0,14465,27/05/20
Goa,0,28,0,0,0,0,0,67,27/05/20
Gujarat,0,7139,915,0,0,0,0,14821,27/05/20
Haryana,0,824,17,0,0,0,0,1305,27/05/20
Himachal Pradesh,0,67,5,0,0,0,0,247,27/05/20
Jammu and Kashmir,0,833,24,0,0,0,0,1759,27/05/20
Jharkhand,0,175,4,0,0,0,0,426,27/05/20
Karnataka,0,748,44,0,0,0,0,2283,27/05/20
Kerala,0,542,6,0,0,0,0,963,27/05/20
Ladakh,0,43,0,0,0,0,0,53,27/05/20
Madhya Pradesh,0,3689,305,0,0,0,0,7024,27/05/20
Maharashtra,0,16954,1792,0,0,0,0,54758,27/05/20
Manipur,0,4,0,0,0,0,0,39,27/05/20
Meghalaya,0,12,1,0,0,0,0,15,27/05/20
Mizoram,0,1,0,0,0,0,0,1,27/05/20
Nagaland,0,0,0,0,0,0,0,4,27/05/20
Odisha,0,733,7,0,0,0,0,1517,27/05/20
Puducherry,0,12,0,0,0,0,0,46,27/05/20
Punjab,0,1918,40,0,0,0,0,2106,27/05/20
Rajasthan,0,4171,170,0,0,0,0,7536,27/05/20
Sikkim,0,0,0,0,0,0,0,1,27/05/20
Tamil Nadu,0,9342,127,0,0,0,0,17728,27/05/20
Telengana,0,1284,57,0,0,0,0,1991,27/05/20
Tripura,0,165,0,0,0,0,0,207,27/05/20
Uttarakhand,0,64,4,0,0,0,0,401,27/05/20
Uttar Pradesh,0,3698,170,0,0,0,0,6548,27/05/20
West Bengal,0,1486,283,0,0,0,0,4009,27/05/20
Cases being reassigned to states,0,0,0,0,0,0,0,4013,27/05/20
Andaman and Nicobar Islands,0,33,0,0,0,0,0,33,28/05/20
Andhra Pradesh,0,2057,58,0,0,0,0,3171,28/05/20
Arunachal Pradesh,0,1,0,0,0,0,0,2,28/05/20
Assam,0,87,4,0,0,0,0,781,28/05/20
Bihar,0,1083,15,0,0,0,0,3061,28/05/20
Chandigarh,0,187,4,0,0,0,0,279,28/05/20
Chhattisgarh,0,83,0,0,0,0,0,369,28/05/20
Dadar Nagar Haveli,0,0,0,0,0,0,0,2,28/05/20
Delhi,0,7264,303,0,0,0,0,15257,28/05/20
Goa,0,37,0,0,0,0,0,68,28/05/20
Gujarat,0,7549,938,0,0,0,0,15195,28/05/20
Haryana,0,838,18,0,0,0,0,1381,28/05/20
Himachal Pradesh,0,70,5,0,0,0,0,273,28/05/20
Jammu and Kashmir,0,854,26,0,0,0,0,1921,28/05/20
Jharkhand,0,185,4,0,0,0,0,448,28/05/20
Karnataka,0,781,47,0,0,0,0,2418,28/05/20
Kerala,0,552,7,0,0,0,0,1004,28/05/20
Ladakh,0,43,0,0,0,0,0,53,28/05/20
Madhya Pradesh,0,3927,313,0,0,0,0,7261,28/05/20
Maharashtra,0,17918,1897,0,0,0,0,56948,28/05/20
Manipur,0,4,0,0,0,0,0,44,28/05/20
Meghalaya,0,12,1,0,0,0,0,20,28/05/20
Mizoram,0,1,0,0,0,0,0,1,28/05/20
Nagaland,0,0,0,0,0,0,0,4,28/05/20
Odisha,0,733,7,0,0,0,0,1593,28/05/20
Puducherry,0,12,0,0,0,0,0,46,28/05/20
Punjab,0,1918,40,0,0,0,0,2139,28/05/20
Rajasthan,0,4457,173,0,0,0,0,7703,28/05/20
Sikkim,0,0,0,0,0,0,0,1,28/05/20
Tamil Nadu,0,9909,133,0,0,0,0,18545,28/05/20
Telengana,0,1284,63,0,0,0,0,2098,28/05/20
Tripura,0,165,0,0,0,0,0,230,28/05/20
Uttarakhand,0,79,4,0,0,0,0,469,28/05/20
Uttar Pradesh,0,3991,182,0,0,0,0,6991,28/05/20
West Bengal,0,1578,289,0,0,0,0,4192,28/05/20
Cases being reassigned to states,0,0,0,0,0,0,0,4332,28/05/20
Andaman and Nicobar Islands,0,33,0,0,0,0,0,33,29/05/20
Andhra Pradesh,0,2125,59,0,0,0,0,3251,29/05/20
Arunachal Pradesh,0,1,0,0,0,0,0,3,29/05/20
Assam,0,104,4,0,0,0,0,856,29/05/20
Bihar,0,1211,15,0,0,0,0,3296,29/05/20
Chandigarh,0,189,4,0,0,0,0,288,29/05/20
Chhattisgarh,0,83,0,0,0,0,0,399,29/05/20
Dadar Nagar Haveli,0,0,0,0,0,0,0,2,29/05/20
Delhi,0,7495,316,0,0,0,0,16281,29/05/20
Goa,0,38,0,0,0,0,0,69,29/05/20
Gujarat,0,8003,960,0,0,0,0,15562,29/05/20
Haryana,0,881,19,0,0,0,0,1504,29/05/20
Himachal Pradesh,0,70,5,0,0,0,0,276,29/05/20
Jammu and Kashmir,0,859,27,0,0,0,0,2036,29/05/20
Jharkhand,0,212,4,0,0,0,0,469,29/05/20
Karnataka,0,834,47,0,0,0,0,2533,29/05/20
Kerala,0,555,7,0,0,0,0,1088,29/05/20
Ladakh,0,43,0,0,0,0,0,73,29/05/20
Madhya Pradesh,0,4050,321,0,0,0,0,7453,29/05/20
Maharashtra,0,18616,1982,0,0,0,0,59546,29/05/20
Manipur,0,5,0,0,0,0,0,55,29/05/20
Meghalaya,0,12,1,0,0,0,0,21,29/05/20
Mizoram,0,1,0,0,0,0,0,1,29/05/20
Nagaland,0,0,0,0,0,0,0,18,29/05/20
Odisha,0,887,7,0,0,0,0,1660,29/05/20
Puducherry,0,14,0,0,0,0,0,51,29/05/20
Punjab,0,1946,40,0,0,0,0,2158,29/05/20
Rajasthan,0,4817,180,0,0,0,0,8067,29/05/20
Sikkim,0,0,0,0,0,0,0,1,29/05/20
Tamil Nadu,0,10548,145,0,0,0,0,19372,29/05/20
Telengana,0,1345,67,0,0,0,0,2256,29/05/20
Tripura,0,167,0,0,0,0,0,242,29/05/20
Uttarakhand,0,79,4,0,0,0,0,500,29/05/20
Uttar Pradesh,0,4215,197,0,0,0,0,7170,29/05/20
West Bengal,0,1668,295,0,0,0,0,4536,29/05/20
Cases being reassigned to states,0,0,0,0,0,0,0,4673,29/05/20
Andaman and Nicobar Islands,0,33,0,0,0,0,0,33,30/05/20
Andhra Pradesh,0,2226,60,0,0,0,0,3436,30/05/20
Arunachal Pradesh,0,1,0,0,0,0,0,3,30/05/20
Assam,0,125,4,0,0,0,0,1024,30/05/20
Bihar,0,1211,15,0,0,0,0,3376,30/05/20
Chandigarh,0,189,4,0,0,0,0,289,30/05/20
Chhattisgarh,0,100,1,0,0,0,0,415,30/05/20
Dadar Nagar Haveli,0,0,0,0,0,0,0,2,30/05/20
Delhi,0,7846,398,0,0,0,0,17386,30/05/20
Goa,0,41,0,0,0,0,0,69,30/05/20
Gujarat,0,8611,980,0,0,0,0,15934,30/05/20
Haryana,0,940,19,0,0,0,0,1721,30/05/20
Himachal Pradesh,0,87,5,0,0,0,0,295,30/05/20
Jammu and Kashmir,0,875,28,0,0,0,0,2164,30/05/20
Jharkhand,0,216,5,0,0,0,0,511,30/05/20
Karnataka,0,894,48,0,0,0,0,2781,30/05/20
Kerala,0,565,8,0,0,0,0,1150,30/05/20
Ladakh,0,43,0,0,0,0,0,74,30/05/20
Madhya Pradesh,0,4269,334,0,0,0,0,7645,30/05/20
Maharashtra,0,26997,2098,0,0,0,0,62228,30/05/20
Manipur,0,8,0,0,0,0,0,59,30/05/20
Meghalaya,0,12,1,0,0,0,0,27,30/05/20
Mizoram,0,1,0,0,0,0,0,1,30/05/20
Nagaland,0,0,0,0,0,0,0,25,30/05/20
Odisha,0,887,7,0,0,0,0,1723,30/05/20
Puducherry,0,14,0,0,0,0,0,51,30/05/20
Punjab,0,1949,42,0,0,0,0,2197,30/05/20
Rajasthan,0,5244,184,0,0,0,0,8365,30/05/20
Sikkim,0,0,0,0,0,0,0,1,30/05/20
Tamil Nadu,0,11313,154,0,0,0,0,20246,30/05/20
Telengana,0,1381,71,0,0,0,0,2425,30/05/20
Tripura,0,171,0,0,0,0,0,251,30/05/20
Uttarakhand,0,102,5,0,0,0,0,716,30/05/20
Uttar Pradesh,0,4244,198,0,0,0,0,7284,30/05/20
West Bengal,0,1775,302,0,0,0,0,4813,30/05/20
Cases being reassigned to states,0,0,0,0,0,0,0,5043,30/05/20
Andaman and Nicobar Islands,0,33,0,0,0,0,0,33,31/05/20
Andhra Pradesh,0,2289,60,0,0,0,0,3569,31/05/20
Arunachal Pradesh,0,1,0,0,0,0,0,4,31/05/20
Assam,0,163,4,0,0,0,0,1185,31/05/20
Bihar,0,1618,20,0,0,0,0,3636,31/05/20
Chandigarh,0,189,4,0,0,0,0,289,31/05/20
Chhattisgarh,0,102,1,0,0,0,0,447,31/05/20
Dadar Nagar Haveli,0,0,0,0,0,0,0,2,31/05/20
Delhi,0,8075,416,0,0,0,0,18549,31/05/20
Goa,0,41,0,0,0,0,0,70,31/05/20
Gujarat,0,9230,1007,0,0,0,0,16343,31/05/20
Haryana,0,971,20,0,0,0,0,1923,31/05/20
Himachal Pradesh,0,111,5,0,0,0,0,313,31/05/20
Jammu and Kashmir,0,908,28,0,0,0,0,2341,31/05/20
Jharkhand,0,256,5,0,0,0,0,563,31/05/20
Karnataka,0,997,48,0,0,0,0,2922,31/05/20
Kerala,0,575,9,0,0,0,0,1208,31/05/20
Ladakh,0,43,0,0,0,0,0,74,31/05/20
Madhya Pradesh,0,4444,343,0,0,0,0,7891,31/05/20
Maharashtra,0,28081,2197,0,0,0,0,65168,31/05/20
Manipur,0,8,0,0,0,0,0,62,31/05/20
Meghalaya,0,12,1,0,0,0,0,27,31/05/20
Mizoram,0,1,0,0,0,0,0,1,31/05/20
Nagaland,0,0,0,0,0,0,0,36,31/05/20
Odisha,0,1050,7,0,0,0,0,1819,31/05/20
Puducherry,0,14,0,0,0,0,0,51,31/05/20
Punjab,0,1967,44,0,0,0,0,2233,31/05/20
Rajasthan,0,5739,193,0,0,0,0,8617,31/05/20
Sikkim,0,0,0,0,0,0,0,1,31/05/20
Tamil Nadu,0,12000,160,0,0,0,0,21184,31/05/20
Telengana,0,1412,77,0,0,0,0,2499,31/05/20
Tripura,0,172,0,0,0,0,0,268,31/05/20
Uttarakhand,0,102,5,0,0,0,0,749,31/05/20
Uttar Pradesh,0,4410,201,0,0,0,0,7445,31/05/20
West Bengal,0,1970,309,0,0,0,0,5130,31/05/20
Cases being reassigned to states,0,0,0,0,0,0,0,5491,31/05/20
Andaman and Nicobar Islands,0,33,0,0,0,0,0,33,01/06/20
Andhra Pradesh,0,2349,62,0,0,0,0,3679,01/06/20
Arunachal Pradesh,0,1,0,0,0,0,0,4,01/06/20
Assam,0,185,4,0,0,0,0,1272,01/06/20
Bihar,0,1710,21,0,0,0,0,3815,01/06/20
Chandigarh,0,199,4,0,0,0,0,293,01/06/20
Chhattisgarh,0,115,1,0,0,0,0,498,01/06/20
Dadar Nagar Haveli,0,0,0,0,0,0,0,2,01/06/20
Delhi,0,8478,473,0,0,0,0,19844,01/06/20
Goa,0,42,0,0,0,0,0,70,01/06/20
Gujarat,0,9919,1038,0,0,0,0,16779,01/06/20
Haryana,0,1048,20,0,0,0,0,2091,01/06/20
Himachal Pradesh,0,120,5,0,0,0,0,331,01/06/20
Jammu and Kashmir,0,927,28,0,0,0,0,2446,01/06/20
Jharkhand,0,256,5,0,0,0,0,610,01/06/20
Karnataka,0,1218,51,0,0,0,0,3221,01/06/20
Kerala,0,590,9,0,0,0,0,1269,01/06/20
Ladakh,0,43,0,0,0,0,0,74,01/06/20
Madhya Pradesh,0,4842,350,0,0,0,0,8089,01/06/20
Maharashtra,0,29329,2286,0,0,0,0,67655,01/06/20
Manipur,0,11,0,0,0,0,0,71,01/06/20
Meghalaya,0,12,1,0,0,0,0,27,01/06/20
Mizoram,0,1,0,0,0,0,0,1,01/06/20
Nagaland,0,0,0,0,0,0,0,43,01/06/20
Odisha,0,1126,7,0,0,0,0,1948,01/06/20
Puducherry,0,25,0,0,0,0,0,70,01/06/20
Punjab,0,1987,45,0,0,0,0,2263,01/06/20
Rajasthan,0,5927,194,0,0,0,0,8831,01/06/20
Sikkim,0,0,0,0,0,0,0,1,01/06/20
Tamil Nadu,0,12757,173,0,0,0,0,22333,01/06/20
Telengana,0,1428,82,0,0,0,0,2698,01/06/20
Tripura,0,173,0,0,0,0,0,313,01/06/20
Uttarakhand,0,102,5,0,0,0,0,907,01/06/20
Uttar Pradesh,0,4709,213,0,0,0,0,7823,01/06/20
West Bengal,0,2157,317,0,0,0,0,5501,01/06/20
Cases being reassigned to states,0,0,0,0,0,0,0,5630,01/06/20
Andaman and Nicobar Islands,0,33,0,0,0,0,0,33,02/06/20
Andhra Pradesh,0,2378,64,0,0,0,0,3783,02/06/20
Arunachal Pradesh,0,1,0,0,0,0,0,22,02/06/20
Assam,0,277,4,0,0,0,0,1390,02/06/20
Bihar,0,1900,24,0,0,0,0,3926,02/06/20
Chandigarh,0,199,4,0,0,0,0,294,02/06/20
Chhattisgarh,0,122,1,0,0,0,0,547,02/06/20
Dadar Nagar Haveli,0,1,0,0,0,0,0,3,02/06/20
Delhi,0,8746,523,0,0,0,0,20834,02/06/20
Goa,0,42,0,0,0,0,0,71,02/06/20
Gujarat,0,10780,1063,0,0,0,0,17200,02/06/20
Haryana,0,1055,21,0,0,0,0,2356,02/06/20
Himachal Pradesh,0,122,5,0,0,0,0,340,02/06/20
Jammu and Kashmir,0,946,31,0,0,0,0,2601,02/06/20
Jharkhand,0,296,5,0,0,0,0,659,02/06/20
Karnataka,0,1328,52,0,0,0,0,3408,02/06/20
Kerala,0,608,10,0,0,0,0,1326,02/06/20
Ladakh,0,43,0,0,0,0,0,77,02/06/20
Madhya Pradesh,0,5003,358,0,0,0,0,8283,02/06/20
Maharashtra,0,30108,2362,0,0,0,0,70013,02/06/20
Manipur,0,11,0,0,0,0,0,83,02/06/20
Meghalaya,0,12,1,0,0,0,0,27,02/06/20
Mizoram,0,1,0,0,0,0,0,1,02/06/20
Nagaland,0,0,0,0,0,0,0,43,02/06/20
Odisha,0,1245,7,0,0,0,0,2104,02/06/20
Puducherry,0,25,0,0,0,0,0,74,02/06/20
Punjab,0,2000,45,0,0,0,0,2301,02/06/20
Rajasthan,0,6040,198,0,0,0,0,8980,02/06/20
Sikkim,0,0,0,0,0,0,0,1,02/06/20
Tamil Nadu,0,13170,184,0,0,0,0,23495,02/06/20
Telengana,0,1491,88,0,0,0,0,2792,02/06/20
Tripura,0,173,0,0,0,0,0,420,02/06/20
Uttarakhand,0,222,6,0,0,0,0,958,02/06/20
Uttar Pradesh,0,4843,217,0,0,0,0,8075,02/06/20
West Bengal,0,2306,325,0,0,0,0,5772,02/06/20
Cases being reassigned to states,0,0,0,0,0,0,0,6414,02/06/20
Andaman and Nicobar Islands,0,33,0,0,0,0,0,33,03/06/20
Andhra Pradesh,0,2421,64,0,0,0,0,3898,03/06/20
Arunachal Pradesh,0,1,0,0,0,0,0,22,03/06/20
Assam,0,324,4,0,0,0,0,1513,03/06/20
Bihar,0,1946,24,0,0,0,0,4155,03/06/20
Chandigarh,0,214,5,0,0,0,0,301,03/06/20
Chhattisgarh,0,130,1,0,0,0,0,564,03/06/20
Dadar Nagar Haveli,0,1,0,0,0,0,0,4,03/06/20
Delhi,0,9243,556,0,0,0,0,22132,03/06/20
Goa,0,57,0,0,0,0,0,79,03/06/20
Gujarat,0,11894,1092,0,0,0,0,17617,03/06/20
Haryana,0,1069,23,0,0,0,0,2652,03/06/20
Himachal Pradesh,0,140,5,0,0,0,0,345,03/06/20
Jammu and Kashmir,0,953,33,0,0,0,0,2718,03/06/20
Jharkhand,0,320,5,0,0,0,0,712,03/06/20
Karnataka,0,1403,52,0,0,0,0,3796,03/06/20
Kerala,0,627,11,0,0,0,0,1412,03/06/20
Ladakh,0,47,1,0,0,0,0,81,03/06/20
Madhya Pradesh,0,5221,364,0,0,0,0,8420,03/06/20
Maharashtra,0,31333,2465,0,0,0,0,72300,03/06/20
Manipur,0,14,0,0,0,0,0,89,03/06/20
Meghalaya,0,12,1,0,0,0,0,27,03/06/20
Mizoram,0,1,0,0,0,0,0,13,03/06/20
Nagaland,0,0,0,0,0,0,0,49,03/06/20
Odisha,0,1325,7,0,0,0,0,2245,03/06/20
Puducherry,0,25,0,0,0,0,0,82,03/06/20
Punjab,0,2017,46,0,0,0,0,2342,03/06/20
Rajasthan,0,6435,203,0,0,0,0,9373,03/06/20
Sikkim,0,0,0,0,0,0,0,1,03/06/20
Tamil Nadu,0,13706,197,0,0,0,0,24586,03/06/20
Telengana,0,1526,92,0,0,0,0,2891,03/06/20
Tripura,0,173,0,0,0,0,0,468,03/06/20
Uttarakhand,0,252,7,0,0,0,0,1043,03/06/20
Uttar Pradesh,0,5030,222,0,0,0,0,8361,03/06/20
West Bengal,0,2410,335,0,0,0,0,6168,03/06/20
Cases being reassigned to states,0,0,0,0,0,0,0,7123,03/06/20
Andaman and Nicobar Islands,0,33,0,0,0,0,0,33,04/06/20
Andhra Pradesh,0,2466,68,0,0,0,0,4080,04/06/20
Arunachal Pradesh,0,1,0,0,0,0,0,38,04/06/20
Assam,0,413,4,0,0,0,0,1672,04/06/20
Bihar,0,2077,25,0,0,0,0,4390,04/06/20
Chandigarh,0,214,5,0,0,0,0,301,04/06/20
Chhattisgarh,0,188,2,0,0,0,0,668,04/06/20
Dadar Nagar Haveli,0,1,0,0,0,0,0,8,04/06/20
Delhi,0,9542,606,0,0,0,0,23645,04/06/20
Goa,0,57,0,0,0,0,0,79,04/06/20
Gujarat,0,12212,1122,0,0,0,0,18100,04/06/20
Haryana,0,1089,23,0,0,0,0,2954,04/06/20
Himachal Pradesh,0,150,5,0,0,0,0,359,04/06/20
Jammu and Kashmir,0,1007,34,0,0,0,0,2857,04/06/20
Jharkhand,0,321,5,0,0,0,0,752,04/06/20
Karnataka,0,1514,53,0,0,0,0,4063,04/06/20
Kerala,0,651,11,0,0,0,0,1494,04/06/20
Ladakh,0,48,1,0,0,0,0,90,04/06/20
Madhya Pradesh,0,5445,371,0,0,0,0,8588,04/06/20
Maharashtra,0,32329,2587,0,0,0,0,74860,04/06/20
Manipur,0,38,0,0,0,0,0,118,04/06/20
Meghalaya,0,13,1,0,0,0,0,33,04/06/20
Mizoram,0,1,0,0,0,0,0,14,04/06/20
Nagaland,0,0,0,0,0,0,0,58,04/06/20
Odisha,0,1416,7,0,0,0,0,2388,04/06/20
Puducherry,0,25,0,0,0,0,0,82,04/06/20
Punjab,0,2029,47,0,0,0,0,2376,04/06/20
Rajasthan,0,6744,209,0,0,0,0,9652,04/06/20
Sikkim,0,0,0,0,0,0,0,2,04/06/20
Tamil Nadu,0,14316,208,0,0,0,0,25872,04/06/20
Telengana,0,1556,99,0,0,0,0,3020,04/06/20
Tripura,0,173,0,0,0,0,0,468,04/06/20
Uttarakhand,0,282,8,0,0,0,0,1085,04/06/20
Uttar Pradesh,0,5176,229,0,0,0,0,8729,04/06/20
West Bengal,0,2580,345,0,0,0,0,6508,04/06/20
Cases being reassigned to states,0,0,0,0,0,0,0,7483,04/06/20
Andaman and Nicobar Islands,0,33,0,0,0,0,0,33,05/06/20
Andhra Pradesh,0,2539,71,0,0,0,0,4223,05/06/20
Arunachal Pradesh,0,1,0,0,0,0,0,42,05/06/20
Assam,0,442,4,0,0,0,0,1988,05/06/20
Bihar,0,2210,29,0,0,0,0,4493,05/06/20
Chandigarh,0,214,5,0,0,0,0,301,05/06/20
Chhattisgarh,0,213,2,0,0,0,0,756,05/06/20
Dadar Nagar Haveli,0,1,0,0,0,0,0,12,05/06/20
Delhi,0,9898,650,0,0,0,0,25004,05/06/20
Goa,0,57,0,0,0,0,0,166,05/06/20
Gujarat,0,12667,1155,0,0,0,0,18584,05/06/20
Haryana,0,2134,24,0,0,0,0,3281,05/06/20
Himachal Pradesh,0,179,5,0,0,0,0,383,05/06/20
Jammu and Kashmir,0,1048,35,0,0,0,0,3142,05/06/20
Jharkhand,0,354,6,0,0,0,0,793,05/06/20
Karnataka,0,1610,57,0,0,0,0,4320,05/06/20
Kerala,0,690,14,0,0,0,0,1588,05/06/20
Ladakh,0,48,1,0,0,0,0,90,05/06/20
Madhya Pradesh,0,5637,377,0,0,0,0,8762,05/06/20
Maharashtra,0,33681,2710,0,0,0,0,77793,05/06/20
Manipur,0,38,0,0,0,0,0,124,05/06/20
Meghalaya,0,13,1,0,0,0,0,33,05/06/20
Mizoram,0,1,0,0,0,0,0,17,05/06/20
Nagaland,0,0,0,0,0,0,0,80,05/06/20
Odisha,0,1416,7,0,0,0,0,2478,05/06/20
Puducherry,0,25,0,0,0,0,0,82,05/06/20
Punjab,0,2043,47,0,0,0,0,2415,05/06/20
Rajasthan,0,7104,213,0,0,0,0,9862,05/06/20
Sikkim,0,0,0,0,0,0,0,2,05/06/20
Tamil Nadu,0,14902,220,0,0,0,0,27256,05/06/20
Telengana,0,1587,105,0,0,0,0,3147,05/06/20
Tripura,0,173,0,0,0,0,0,644,05/06/20
Uttarakhand,0,297,10,0,0,0,0,1153,05/06/20
Uttar Pradesh,0,5439,245,0,0,0,0,9237,05/06/20
West Bengal,0,2768,355,0,0,0,0,6876,05/06/20
Cases being reassigned to states,0,0,0,0,0,0,0,7610,05/06/20
Andaman and Nicobar Islands,0,33,0,0,0,0,0,33,06/06/20
Andhra Pradesh,0,2576,73,0,0,0,0,4303,06/06/20
Arunachal Pradesh,0,1,0,0,0,0,0,45,06/06/20
Assam,0,498,4,0,0,0,0,2153,06/06/20
Bihar,0,2225,29,0,0,0,0,4596,06/06/20
Chandigarh,0,222,5,0,0,0,0,304,06/06/20
Chhattisgarh,0,244,2,0,0,0,0,879,06/06/20
Dadar Nagar Haveli,0,1,0,0,0,0,0,14,06/06/20
Delhi,0,10315,708,0,0,0,0,26334,06/06/20
Goa,0,65,0,0,0,0,0,196,06/06/20
Gujarat,0,13003,1190,0,0,0,0,19094,06/06/20
Haryana,0,2134,24,0,0,0,0,3597,06/06/20
Himachal Pradesh,0,189,5,0,0,0,0,393,06/06/20
Jammu and Kashmir,0,1086,36,0,0,0,0,3324,06/06/20
Jharkhand,0,410,7,0,0,0,0,881,06/06/20
Karnataka,0,1688,57,0,0,0,0,4835,06/06/20
Kerala,0,712,14,0,0,0,0,1699,06/06/20
Ladakh,0,48,1,0,0,0,0,97,06/06/20
Madhya Pradesh,0,5878,384,0,0,0,0,8996,06/06/20
Maharashtra,0,35156,2849,0,0,0,0,80229,06/06/20
Manipur,0,41,0,0,0,0,0,132,06/06/20
Meghalaya,0,13,1,0,0,0,0,33,06/06/20
Mizoram,0,1,0,0,0,0,0,22,06/06/20
Nagaland,0,0,0,0,0,0,0,94,06/06/20
Odisha,0,1604,8,0,0,0,0,2608,06/06/20
Puducherry,0,36,0,0,0,0,0,99,06/06/20
Punjab,0,2069,48,0,0,0,0,2461,06/06/20
Rajasthan,0,7359,218,0,0,0,0,10084,06/06/20
Sikkim,0,0,0,0,0,0,0,3,06/06/20
Tamil Nadu,0,15762,232,0,0,0,0,28694,06/06/20
Telengana,0,1627,113,0,0,0,0,3290,06/06/20
Tripura,0,173,0,0,0,0,0,692,06/06/20
Uttarakhand,0,344,11,0,0,0,0,1215,06/06/20
Uttar Pradesh,0,5648,257,0,0,0,0,9733,06/06/20
West Bengal,0,2912,366,0,0,0,0,7303,06/06/20
Cases being reassigned to states,0,0,0,0,0,0,0,8192,06/06/20
Andaman and Nicobar Islands,0,33,0,0,0,0,0,33,07/06/20
Andhra Pradesh,0,2620,73,0,0,0,0,4510,07/06/20
Arunachal Pradesh,0,1,0,0,0,0,0,47,07/06/20
Assam,0,547,4,0,0,0,0,2397,07/06/20
Bihar,0,2425,30,0,0,0,0,4915,07/06/20
Chandigarh,0,273,5,0,0,0,0,309,07/06/20
Chhattisgarh,0,266,4,0,0,0,0,923,07/06/20
Dadar Nagar Haveli,0,1,0,0,0,0,0,19,07/06/20
Delhi,0,10664,761,0,0,0,0,27654,07/06/20
Goa,0,65,0,0,0,0,0,267,07/06/20
Gujarat,0,13316,1219,0,0,0,0,19592,07/06/20
Haryana,0,2134,24,0,0,0,0,3952,07/06/20
Himachal Pradesh,0,194,5,0,0,0,0,400,07/06/20
Jammu and Kashmir,0,1126,39,0,0,0,0,3467,07/06/20
Jharkhand,0,473,7,0,0,0,0,1000,07/06/20
Karnataka,0,1968,59,0,0,0,0,5213,07/06/20
Kerala,0,762,15,0,0,0,0,1807,07/06/20
Ladakh,0,48,1,0,0,0,0,99,07/06/20
Madhya Pradesh,0,6108,399,0,0,0,0,9228,07/06/20
Maharashtra,0,37390,2969,0,0,0,0,82968,07/06/20
Manipur,0,52,0,0,0,0,0,157,07/06/20
Meghalaya,0,13,1,0,0,0,0,33,07/06/20
Mizoram,0,1,0,0,0,0,0,24,07/06/20
Nagaland,0,0,0,0,0,0,0,107,07/06/20
Odisha,0,1716,8,0,0,0,0,2781,07/06/20
Puducherry,0,36,0,0,0,0,0,99,07/06/20
Punjab,0,2092,50,0,0,0,0,2515,07/06/20
Rajasthan,0,7501,231,0,0,0,0,10331,07/06/20
Sikkim,0,0,0,0,0,0,0,7,07/06/20
Tamil Nadu,0,16395,251,0,0,0,0,30152,07/06/20
Telengana,0,1710,123,0,0,0,0,3496,07/06/20
Tripura,0,173,0,0,0,0,0,747,07/06/20
Uttarakhand,0,423,11,0,0,0,0,1303,07/06/20
Uttar Pradesh,0,5648,257,0,0,0,0,9733,07/06/20
West Bengal,0,3119,383,0,0,0,0,7738,07/06/20
Cases being reassigned to states,0,0,0,0,0,0,0,8605,07/06/20
Andaman and Nicobar Islands,0,33,0,0,0,0,0,33,08/06/20
Andhra Pradesh,0,2682,75,0,0,0,0,4708,08/06/20
Arunachal Pradesh,0,1,0,0,0,0,0,51,08/06/20
Assam,0,615,4,0,0,0,0,2565,08/06/20
Bihar,0,2480,30,0,0,0,0,5088,08/06/20
Chandigarh,0,273,5,0,0,0,0,314,08/06/20
Chhattisgarh,0,283,4,0,0,0,0,1073,08/06/20
Dadar Nagar Haveli,0,2,0,0,0,0,0,20,08/06/20
Delhi,0,10664,761,0,0,0,0,27654,08/06/20
Goa,0,65,0,0,0,0,0,300,08/06/20
Gujarat,0,13635,1249,0,0,0,0,20070,08/06/20
Haryana,0,2134,28,0,0,0,0,4448,08/06/20
Himachal Pradesh,0,224,5,0,0,0,0,413,08/06/20
Jammu and Kashmir,0,1216,41,0,0,0,0,4087,08/06/20
Jharkhand,0,490,7,0,0,0,0,1099,08/06/20
Karnataka,0,2132,61,0,0,0,0,5452,08/06/20
Kerala,0,803,15,0,0,0,0,1914,08/06/20
Ladakh,0,50,1,0,0,0,0,103,08/06/20
Madhya Pradesh,0,6331,412,0,0,0,0,9401,08/06/20
Maharashtra,0,39314,3060,0,0,0,0,85975,08/06/20
Manipur,0,52,0,0,0,0,0,172,08/06/20
Meghalaya,0,13,1,0,0,0,0,36,08/06/20
Mizoram,0,1,0,0,0,0,0,34,08/06/20
Nagaland,0,8,0,0,0,0,0,118,08/06/20
Odisha,0,1894,9,0,0,0,0,2856,08/06/20
Puducherry,0,36,0,0,0,0,0,99,08/06/20
Punjab,0,2106,51,0,0,0,0,2608,08/06/20
Rajasthan,0,7641,240,0,0,0,0,10599,08/06/20
Sikkim,0,0,0,0,0,0,0,7,08/06/20
Tamil Nadu,0,16999,269,0,0,0,0,31667,08/06/20
Telengana,0,1710,123,0,0,0,0,3580,08/06/20
Tripura,0,192,0,0,0,0,0,800,08/06/20
Uttarakhand,0,528,13,0,0,0,0,1355,08/06/20
Uttar Pradesh,0,6185,275,0,0,0,0,10536,08/06/20
West Bengal,0,3303,396,0,0,0,0,8187,08/06/20
Cases being reassigned to states,0,0,0,0,0,0,0,9189,08/06/20
Andaman and Nicobar Islands,0,33,0,0,0,0,0,33,09/06/20
Andhra Pradesh,0,2745,75,0,0,0,0,4851,09/06/20
Arunachal Pradesh,0,1,0,0,0,0,0,51,09/06/20
Assam,0,665,4,0,0,0,0,2776,09/06/20
Bihar,0,2499,31,0,0,0,0,5202,09/06/20
Chandigarh,0,273,5,0,0,0,0,317,09/06/20
Chhattisgarh,0,308,4,0,0,0,0,1160,09/06/20
Dadar Nagar Haveli,0,2,0,0,0,0,0,22,09/06/20
Delhi,0,11357,874,0,0,0,0,29943,09/06/20
Goa,0,67,0,0,0,0,0,330,09/06/20
Gujarat,0,13956,1280,0,0,0,0,20545,09/06/20
Haryana,0,2134,39,0,0,0,0,4854,09/06/20
Himachal Pradesh,0,227,5,0,0,0,0,421,09/06/20
Jammu and Kashmir,0,1324,45,0,0,0,0,4285,09/06/20
Jharkhand,0,519,7,0,0,0,0,1256,09/06/20
Karnataka,0,2519,64,0,0,0,0,5760,09/06/20
Kerala,0,814,16,0,0,0,0,2005,09/06/20
Ladakh,0,52,1,0,0,0,0,103,09/06/20
Madhya Pradesh,0,6536,414,0,0,0,0,9638,09/06/20
Maharashtra,0,40975,3169,0,0,0,0,88528,09/06/20
Manipur,0,58,0,0,0,0,0,272,09/06/20
Meghalaya,0,13,1,0,0,0,0,36,09/06/20
Mizoram,0,1,0,0,0,0,0,42,09/06/20
Nagaland,0,8,0,0,0,0,0,123,09/06/20
Odisha,0,1993,9,0,0,0,0,2994,09/06/20
Puducherry,0,52,0,0,0,0,0,127,09/06/20
Punjab,0,2128,53,0,0,0,0,2663,09/06/20
Rajasthan,0,8004,246,0,0,0,0,10763,09/06/20
Sikkim,0,0,0,0,0,0,0,7,09/06/20
Tamil Nadu,0,17527,286,0,0,0,0,33229,09/06/20
Telengana,0,1710,137,0,0,0,0,3650,09/06/20
Tripura,0,192,0,0,0,0,0,838,09/06/20
Uttarakhand,0,714,13,0,0,0,0,1411,09/06/20
Uttar Pradesh,0,6344,283,0,0,0,0,10947,09/06/20
West Bengal,0,3465,405,0,0,0,0,8613,09/06/20
Cases being reassigned to states,0,0,0,0,0,0,0,8803,09/06/20
Andaman and Nicobar Islands,0,33,0,0,0,0,0,33,10/06/20
Andhra Pradesh,0,2802,77,0,0,0,0,5070,10/06/20
Arunachal Pradesh,0,1,0,0,0,0,0,57,10/06/20
Assam,0,1085,4,0,0,0,0,2937,10/06/20
Bihar,0,2864,32,0,0,0,0,5459,10/06/20
Chandigarh,0,286,5,0,0,0,0,323,10/06/20
Chhattisgarh,0,386,6,0,0,0,0,1240,10/06/20
Dadar Nagar Haveli,0,2,0,0,0,0,0,22,10/06/20
Delhi,0,11861,905,0,0,0,0,31309,10/06/20
Goa,0,67,0,0,0,0,0,359,10/06/20
Gujarat,0,14365,1313,0,0,0,0,21014,10/06/20
Haryana,0,2134,45,0,0,0,0,5209,10/06/20
Himachal Pradesh,0,249,5,0,0,0,0,445,10/06/20
Jammu and Kashmir,0,1506,48,0,0,0,0,4346,10/06/20
Jharkhand,0,559,8,0,0,0,0,1411,10/06/20
Karnataka,0,2604,66,0,0,0,0,5921,10/06/20
Kerala,0,848,16,0,0,0,0,2096,10/06/20
Ladakh,0,52,1,0,0,0,0,108,10/06/20
Madhya Pradesh,0,6729,420,0,0,0,0,9849,10/06/20
Maharashtra,0,42638,3289,0,0,0,0,90787,10/06/20
Manipur,0,61,0,0,0,0,0,304,10/06/20
Meghalaya,0,13,1,0,0,0,0,43,10/06/20
Mizoram,0,1,0,0,0,0,0,88,10/06/20
Nagaland,0,10,0,0,0,0,0,127,10/06/20
Odisha,0,2133,9,0,0,0,0,3140,10/06/20
Puducherry,0,52,0,0,0,0,0,127,10/06/20
Punjab,0,2167,55,0,0,0,0,2719,10/06/20
Rajasthan,0,8328,255,0,0,0,0,11245,10/06/20
Sikkim,0,0,0,0,0,0,0,13,10/06/20
Tamil Nadu,0,18325,307,0,0,0,0,34914,10/06/20
Telengana,0,1809,148,0,0,0,0,3920,10/06/20
Tripura,0,192,1,0,0,0,0,864,10/06/20
Uttarakhand,0,755,13,0,0,0,0,1537,10/06/20
Uttar Pradesh,0,6669,301,0,0,0,0,11335,10/06/20
West Bengal,0,3620,415,0,0,0,0,8985,10/06/20
Cases being reassigned to states,0,0,0,0,0,0,0,9227,10/06/20
Andaman and Nicobar Islands,0,33,0,0,0,0,0,34,11/06/20
Andhra Pradesh,0,2899,78,0,0,0,0,5269,11/06/20
Arunachal Pradesh,0,2,0,0,0,0,0,57,11/06/20
Assam,0,1249,4,0,0,0,0,3092,11/06/20
Bihar,0,3071,33,0,0,0,0,5710,11/06/20
Chandigarh,0,286,5,0,0,0,0,327,11/06/20
Chhattisgarh,0,402,6,0,0,0,0,1262,11/06/20
Dadar Nagar Haveli,0,2,0,0,0,0,0,26,11/06/20
Daman & Diu,0,0,0,0,0,0,0,2,11/06/20
Delhi,0,12245,984,0,0,0,0,32810,11/06/20
Goa,0,67,0,0,0,0,0,387,11/06/20
Gujarat,0,14735,1347,0,0,0,0,21521,11/06/20
Haryana,0,2188,52,0,0,0,0,5579,11/06/20
Himachal Pradesh,0,254,6,0,0,0,0,451,11/06/20
Jammu and Kashmir,0,1671,51,0,0,0,0,4507,11/06/20
Jharkhand,0,592,8,0,0,0,0,1489,11/06/20
Karnataka,0,2862,69,0,0,0,0,6041,11/06/20
Kerala,0,905,18,0,0,0,0,2161,11/06/20
Ladakh,0,52,1,0,0,0,0,115,11/06/20
Madhya Pradesh,0,6892,427,0,0,0,0,10049,11/06/20
Maharashtra,0,44517,3438,0,0,0,0,94041,11/06/20
Manipur,0,63,0,0,0,0,0,311,11/06/20
Meghalaya,0,13,1,0,0,0,0,44,11/06/20
Mizoram,0,1,0,0,0,0,0,93,11/06/20
Nagaland,0,22,0,0,0,0,0,128,11/06/20
Odisha,0,2282,9,0,0,0,0,3250,11/06/20
Puducherry,0,53,0,0,0,0,0,127,11/06/20
Punjab,0,2232,55,0,0,0,0,2805,11/06/20
Rajasthan,0,8569,259,0,0,0,0,11600,11/06/20
Sikkim,0,0,0,0,0,0,0,13,11/06/20
Tamil Nadu,0,19333,326,0,0,0,0,36841,11/06/20
Telengana,0,1817,156,0,0,0,0,4111,11/06/20
Tripura,0,239,1,0,0,0,0,895,11/06/20
Uttarakhand,0,831,15,0,0,0,0,1562,11/06/20
Uttar Pradesh,0,6871,321,0,0,0,0,11610,11/06/20
West Bengal,0,3779,432,0,0,0,0,9328,11/06/20
Cases being reassigned to states,0,0,0,0,0,0,0,8931,11/06/20
Andaman and Nicobar Islands,0,33,0,0,0,0,0,38,12/06/20
Andhra Pradesh,0,3048,80,0,0,0,0,5429,12/06/20
Arunachal Pradesh,0,4,0,0,0,0,0,61,12/06/20
Assam,0,1432,6,0,0,0,0,3319,12/06/20
Bihar,0,3266,36,0,0,0,0,5983,12/06/20
Chandigarh,0,286,5,0,0,0,0,332,12/06/20
Chhattisgarh,0,447,6,0,0,0,0,1398,12/06/20
Dadra and Nagar Haveli and Daman and Diu,0,2,0,0,0,0,0,30,12/06/20
Delhi,0,12731,1085,0,0,0,0,34687,12/06/20
Goa,0,67,0,0,0,0,0,417,12/06/20
Gujarat,0,15101,1385,0,0,0,0,22032,12/06/20
Haryana,0,2260,64,0,0,0,0,5968,12/06/20
Himachal Pradesh,0,280,6,0,0,0,0,470,12/06/20
Jammu and Kashmir,0,1820,52,0,0,0,0,4574,12/06/20
Jharkhand,0,630,8,0,0,0,0,1599,12/06/20
Karnataka,0,2977,72,0,0,0,0,6245,12/06/20
Kerala,0,968,18,0,0,0,0,2244,12/06/20
Ladakh,0,54,1,0,0,0,0,135,12/06/20
Madhya Pradesh,0,7042,431,0,0,0,0,10241,12/06/20
Maharashtra,0,46078,3590,0,0,0,0,97648,12/06/20
Manipur,0,73,0,0,0,0,0,366,12/06/20
Meghalaya,0,18,1,0,0,0,0,44,12/06/20
Mizoram,0,1,0,0,0,0,0,102,12/06/20
Nagaland,0,22,0,0,0,0,0,128,12/06/20
Odisha,0,2354,9,0,0,0,0,3386,12/06/20
Puducherry,0,67,2,0,0,0,0,157,12/06/20
Punjab,0,2259,59,0,0,0,0,2887,12/06/20
Rajasthan,0,8775,265,0,0,0,0,11838,12/06/20
Sikkim,0,2,0,0,0,0,0,14,12/06/20
Tamil Nadu,0,20705,349,0,0,0,0,38716,12/06/20
Telangana,0,1993,165,0,0,0,0,4320,12/06/20
Tripura,0,278,1,0,0,0,0,913,12/06/20
Uttarakhand,0,842,15,0,0,0,0,1643,12/06/20
Uttar Pradesh,0,7292,345,0,0,0,0,12088,12/06/20
West Bengal,0,3988,442,0,0,0,0,9768,12/06/20
Cases being reassigned to states,0,0,0,0,0,0,0,8315,12/06/20
Andaman and Nicobar Islands,0,33,0,0,0,0,0,38,13/06/20
Andhra Pradesh,0,3105,80,0,0,0,0,5680,13/06/20
Arunachal Pradesh,0,4,0,0,0,0,0,67,13/06/20
Assam,0,1537,8,0,0,0,0,3498,13/06/20
Bihar,0,3587,36,0,0,0,0,6103,13/06/20
Chandigarh,0,286,5,0,0,0,0,334,13/06/20
Chhattisgarh,0,550,6,0,0,0,0,1429,13/06/20
Dadra and Nagar Haveli and Daman and Diu,0,2,0,0,0,0,0,30,13/06/20
Delhi,0,13398,1214,0,0,0,0,36824,13/06/20
Goa,0,69,0,0,0,0,0,463,13/06/20
Gujarat,0,15493,1415,0,0,0,0,22527,13/06/20
Haryana,0,2475,70,0,0,0,0,6334,13/06/20
Himachal Pradesh,0,297,6,0,0,0,0,486,13/06/20
Jammu and Kashmir,0,2086,53,0,0,0,0,4730,13/06/20
Jharkhand,0,672,8,0,0,0,0,1617,13/06/20
Karnataka,0,3440,79,0,0,0,0,6516,13/06/20
Kerala,0,1000,19,0,0,0,0,2322,13/06/20
Ladakh,0,62,1,0,0,0,0,239,13/06/20
Madhya Pradesh,0,7201,440,0,0,0,0,10443,13/06/20
Maharashtra,0,47796,3717,0,0,0,0,101141,13/06/20
Manipur,0,77,0,0,0,0,0,385,13/06/20
Meghalaya,0,22,1,0,0,0,0,44,13/06/20
Mizoram,0,1,0,0,0,0,0,104,13/06/20
Nagaland,0,49,0,0,0,0,0,156,13/06/20
Odisha,0,2474,10,0,0,0,0,3498,13/06/20
Puducherry,0,67,2,0,0,0,0,157,13/06/20
Punjab,0,2282,63,0,0,0,0,2986,13/06/20
Rajasthan,0,8898,272,0,0,0,0,12068,13/06/20
Sikkim,0,2,0,0,0,0,0,63,13/06/20
Tamil Nadu,0,22047,367,0,0,0,0,40698,13/06/20
Telangana,0,2278,174,0,0,0,0,4484,13/06/20
Tripura,0,278,1,0,0,0,0,961,13/06/20
Uttarakhand,0,947,21,0,0,0,0,1724,13/06/20
Uttar Pradesh,0,7609,365,0,0,0,0,12616,13/06/20
West Bengal,0,4206,451,0,0,0,0,10244,13/06/20
Cases being reassigned to states,0,0,0,0,0,0,0,7984,13/06/20
Andaman and Nicobar Islands,0,33,0,0,0,0,0,38,14/06/20
Andhra Pradesh,0,3195,82,0,0,0,0,5965,14/06/20
Arunachal Pradesh,0,4,0,0,0,0,0,87,14/06/20
Assam,0,1584,8,0,0,0,0,3718,14/06/20
Bihar,0,3956,39,0,0,0,0,6290,14/06/20
Chandigarh,0,286,5,0,0,0,0,345,14/06/20
Chhattisgarh,0,631,6,0,0,0,0,1512,14/06/20
Dadra and Nagar Haveli and Daman and Diu,0,2,0,0,0,0,0,35,14/06/20
Delhi,0,14945,1271,0,0,0,0,38958,14/06/20
Goa,0,70,0,0,0,0,0,523,14/06/20
Gujarat,0,15883,1448,0,0,0,0,23038,14/06/20
Haryana,0,2803,78,0,0,0,0,6749,14/06/20
Himachal Pradesh,0,313,6,0,0,0,0,502,14/06/20
Jammu and Kashmir,0,2269,55,0,0,0,0,4878,14/06/20
Jharkhand,0,816,8,0,0,0,0,1711,14/06/20
Karnataka,0,3648,81,0,0,0,0,6824,14/06/20
Kerala,0,1046,19,0,0,0,0,2407,14/06/20
Ladakh,0,68,1,0,0,0,0,437,14/06/20
Madhya Pradesh,0,7377,447,0,0,0,0,10641,14/06/20
Maharashtra,0,49346,3830,0,0,0,0,104568,14/06/20
Manipur,0,91,0,0,0,0,0,449,14/06/20
Meghalaya,0,22,1,0,0,0,0,44,14/06/20
Mizoram,0,1,0,0,0,0,0,107,14/06/20
Nagaland,0,76,0,0,0,0,0,163,14/06/20
Odisha,0,2594,10,0,0,0,0,3723,14/06/20
Puducherry,0,82,2,0,0,0,0,176,14/06/20
Punjab,0,2327,65,0,0,0,0,3063,14/06/20
Rajasthan,0,9337,282,0,0,0,0,12401,14/06/20
Sikkim,0,4,0,0,0,0,0,63,14/06/20
Tamil Nadu,0,23409,397,0,0,0,0,42687,14/06/20
Telangana,0,2352,182,0,0,0,0,4737,14/06/20
Tripura,0,315,1,0,0,0,0,1046,14/06/20
Uttarakhand,0,1077,23,0,0,0,0,1785,14/06/20
Uttar Pradesh,0,7875,385,0,0,0,0,13118,14/06/20
West Bengal,0,4542,463,0,0,0,0,10698,14/06/20
Cases being reassigned to states,0,0,0,0,0,0,0,7436,14/06/20
Andaman and Nicobar Islands,0,33,0,0,0,0,0,38,15/06/20
Andhra Pradesh,0,3314,84,0,0,0,0,6163,15/06/20
Arunachal Pradesh,0,7,0,0,0,0,0,91,15/06/20
Assam,0,1960,8,0,0,0,0,4049,15/06/20
Bihar,0,4170,39,0,0,0,0,6470,15/06/20
Chandigarh,0,293,5,0,0,0,0,352,15/06/20
Chhattisgarh,0,763,8,0,0,0,0,1662,15/06/20
Dadra and Nagar Haveli and Daman and Diu,0,2,0,0,0,0,0,36,15/06/20
Delhi,0,15823,1327,0,0,0,0,41182,15/06/20
Goa,0,74,0,0,0,0,0,564,15/06/20
Gujarat,0,16325,1477,0,0,0,0,23544,15/06/20
Haryana,0,3003,88,0,0,0,0,7208,15/06/20
Himachal Pradesh,0,337,7,0,0,0,0,518,15/06/20
Jammu and Kashmir,0,2389,59,0,0,0,0,5041,15/06/20
Jharkhand,0,905,8,0,0,0,0,1745,15/06/20
Karnataka,0,3955,86,0,0,0,0,7000,15/06/20
Kerala,0,1102,19,0,0,0,0,2461,15/06/20
Ladakh,0,80,1,0,0,0,0,549,15/06/20
Madhya Pradesh,0,7677,459,0,0,0,0,10802,15/06/20
Maharashtra,0,50978,3950,0,0,0,0,107958,15/06/20
Manipur,0,91,0,0,0,0,0,458,15/06/20
Meghalaya,0,25,1,0,0,0,0,44,15/06/20
Mizoram,0,1,0,0,0,0,0,112,15/06/20
Nagaland,0,88,0,0,0,0,0,168,15/06/20
Odisha,0,2708,11,0,0,0,0,3909,15/06/20
Puducherry,0,91,5,0,0,0,0,194,15/06/20
Punjab,0,2356,67,0,0,0,0,3140,15/06/20
Rajasthan,0,9566,292,0,0,0,0,12694,15/06/20
Sikkim,0,4,0,0,0,0,0,68,15/06/20
Tamil Nadu,0,24547,435,0,0,0,0,44661,15/06/20
Telangana,0,2377,185,0,0,0,0,4974,15/06/20
Tripura,0,315,1,0,0,0,0,1076,15/06/20
Uttarakhand,0,1111,24,0,0,0,0,1819,15/06/20
Uttar Pradesh,0,8268,399,0,0,0,0,13615,15/06/20
West Bengal,0,5060,475,0,0,0,0,11087,15/06/20
Cases being reassigned to states,0,0,0,0,0,0,0,6972,15/06/20
Andaman and Nicobar Islands,0,33,0,0,0,0,0,41,16/06/20
Andhra Pradesh,0,3316,88,0,0,0,0,6456,16/06/20
Arunachal Pradesh,0,7,0,0,0,0,0,91,16/06/20
Assam,0,2166,8,0,0,0,0,4158,16/06/20
Bihar,0,4409,40,0,0,0,0,6650,16/06/20
Chandigarh,0,296,6,0,0,0,0,354,16/06/20
Chhattisgarh,0,890,8,0,0,0,0,1756,16/06/20
Dadra and Nagar Haveli and Daman and Diu,0,5,0,0,0,0,0,36,16/06/20
Delhi,0,16427,1400,0,0,0,0,42829,16/06/20
Goa,0,85,0,0,0,0,0,592,16/06/20
Gujarat,0,16664,1505,0,0,0,0,24055,16/06/20
Haryana,0,3565,100,0,0,0,0,7722,16/06/20
Himachal Pradesh,0,353,8,0,0,0,0,556,16/06/20
Jammu and Kashmir,0,2604,62,0,0,0,0,5220,16/06/20
Jharkhand,0,905,8,0,0,0,0,1763,16/06/20
Karnataka,0,4135,89,0,0,0,0,7213,16/06/20
Kerala,0,1175,20,0,0,0,0,2543,16/06/20
Ladakh,0,82,1,0,0,0,0,555,16/06/20
Madhya Pradesh,0,7903,465,0,0,0,0,10935,16/06/20
Maharashtra,0,56049,4128,0,0,0,0,110744,16/06/20
Manipur,0,151,0,0,0,0,0,490,16/06/20
Meghalaya,0,25,1,0,0,0,0,44,16/06/20
Mizoram,0,1,0,0,0,0,0,117,16/06/20
Nagaland,0,92,0,0,0,0,0,177,16/06/20
Odisha,0,2854,11,0,0,0,0,4055,16/06/20
Puducherry,0,95,5,0,0,0,0,202,16/06/20
Punjab,0,2443,71,0,0,0,0,3267,16/06/20
Rajasthan,0,9785,301,0,0,0,0,12981,16/06/20
Sikkim,0,4,0,0,0,0,0,68,16/06/20
Tamil Nadu,0,25344,479,0,0,0,0,46504,16/06/20
Telangana,0,2766,187,0,0,0,0,5193,16/06/20
Tripura,0,433,1,0,0,0,0,1086,16/06/20
Uttarakhand,0,1189,24,0,0,0,0,1845,16/06/20
Uttar Pradesh,0,8268,399,0,0,0,0,13615,16/06/20
West Bengal,0,5494,485,0,0,0,0,11494,16/06/20
Cases being reassigned to states,0,0,0,0,0,0,0,7684,16/06/20
Andaman and Nicobar Islands,0,33,0,0,0,0,0,44,17/06/20
Andhra Pradesh,0,3509,88,0,0,0,0,6841,17/06/20
Arunachal Pradesh,0,7,0,0,0,0,0,95,17/06/20
Assam,0,2166,8,0,0,0,0,4319,17/06/20
Bihar,0,4644,41,0,0,0,0,6778,17/06/20
Chandigarh,0,302,6,0,0,0,0,358,17/06/20
Chhattisgarh,0,1036,9,0,0,0,0,1781,17/06/20
Dadra and Nagar Haveli and Daman and Diu,0,9,0,0,0,0,0,45,17/06/20
Delhi,0,16500,1837,0,0,0,0,44688,17/06/20
Goa,0,85,0,0,0,0,0,629,17/06/20
Gujarat,0,17082,1533,0,0,0,0,24577,17/06/20
Haryana,0,3748,118,0,0,0,0,8272,17/06/20
Himachal Pradesh,0,372,8,0,0,0,0,560,17/06/20
Jammu and Kashmir,0,2781,63,0,0,0,0,5298,17/06/20
Jharkhand,0,1121,9,0,0,0,0,1839,17/06/20
Karnataka,0,4456,94,0,0,0,0,7530,17/06/20
Kerala,0,1236,20,0,0,0,0,2622,17/06/20
Ladakh,0,85,1,0,0,0,0,649,17/06/20
Madhya Pradesh,0,8152,476,0,0,0,0,11083,17/06/20
Maharashtra,0,57851,5537,0,0,0,0,113445,17/06/20
Manipur,0,159,0,0,0,0,0,500,17/06/20
Meghalaya,0,25,1,0,0,0,0,44,17/06/20
Mizoram,0,1,0,0,0,0,0,121,17/06/20
Nagaland,0,92,0,0,0,0,0,179,17/06/20
Odisha,0,2974,11,0,0,0,0,4163,17/06/20
Puducherry,0,99,6,0,0,0,0,216,17/06/20
Punjab,0,2461,72,0,0,0,0,3371,17/06/20
Rajasthan,0,9849,308,0,0,0,0,13216,17/06/20
Sikkim,0,4,0,0,0,0,0,70,17/06/20
Tamil Nadu,0,26782,528,0,0,0,0,48019,17/06/20
Telangana,0,3027,191,0,0,0,0,5406,17/06/20
Tripura,0,433,1,0,0,0,0,1092,17/06/20
Uttarakhand,0,1216,25,0,0,0,0,1942,17/06/20
Uttar Pradesh,0,8610,417,0,0,0,0,14091,17/06/20
West Bengal,0,6028,495,0,0,0,0,11909,17/06/20
Cases being reassigned to states,0,0,0,0,0,0,0,8273,17/06/20
Andaman and Nicobar Islands,0,33,0,0,0,0,0,44,18/06/20
Andhra Pradesh,0,3641,90,0,0,0,0,7071,18/06/20
Arunachal Pradesh,0,7,0,0,0,0,0,99,18/06/20
Assam,0,2642,8,0,0,0,0,4605,18/06/20
Bihar,0,4926,44,0,0,0,0,6942,18/06/20
Chandigarh,0,303,6,0,0,0,0,368,18/06/20
Chhattisgarh,0,1180,10,0,0,0,0,1864,18/06/20
Dadra and Nagar Haveli and Daman and Diu,0,12,0,0,0,0,0,57,18/06/20
Delhi,0,17457,1904,0,0,0,0,47102,18/06/20
Goa,0,96,0,0,0,0,0,656,18/06/20
Gujarat,0,17430,1560,0,0,0,0,25093,18/06/20
Haryana,0,3952,130,0,0,0,0,8832,18/06/20
Himachal Pradesh,0,372,8,0,0,0,0,569,18/06/20
Jammu and Kashmir,0,2914,65,0,0,0,0,5406,18/06/20
Jharkhand,0,1151,10,0,0,0,0,1895,18/06/20
Karnataka,0,4804,102,0,0,0,0,7734,18/06/20
Kerala,0,1326,20,0,0,0,0,2697,18/06/20
Ladakh,0,92,1,0,0,0,0,687,18/06/20
Madhya Pradesh,0,8388,482,0,0,0,0,11244,18/06/20
Maharashtra,0,59166,5651,0,0,0,0,116752,18/06/20
Manipur,0,192,0,0,0,0,0,552,18/06/20
Meghalaya,0,30,1,0,0,0,0,44,18/06/20
Mizoram,0,1,0,0,0,0,0,121,18/06/20
Nagaland,0,103,0,0,0,0,0,193,18/06/20
Odisha,0,3047,11,0,0,0,0,4338,18/06/20
Puducherry,0,109,7,0,0,0,0,245,18/06/20
Punjab,0,2538,78,0,0,0,0,3497,18/06/20
Rajasthan,0,10467,313,0,0,0,0,13542,18/06/20
Sikkim,0,4,0,0,0,0,0,70,18/06/20
Tamil Nadu,0,27624,576,0,0,0,0,50193,18/06/20
Telangana,0,3071,192,0,0,0,0,5675,18/06/20
Tripura,0,556,1,0,0,0,0,1135,18/06/20
Uttarakhand,0,1254,26,0,0,0,0,2023,18/06/20
Uttar Pradesh,0,8904,435,0,0,0,0,14598,18/06/20
West Bengal,0,6533,506,0,0,0,0,12300,18/06/20
Cases being reassigned to states,0,0,0,0,0,0,0,8703,18/06/20
Andaman and Nicobar Islands,0,33,0,0,0,0,0,44,19/06/20
Andhra Pradesh,0,3789,92,0,0,0,0,7518,19/06/20
Arunachal Pradesh,0,10,0,0,0,0,0,103,19/06/20
Assam,0,2654,9,0,0,0,0,4777,19/06/20
Bihar,0,5056,44,0,0,0,0,7025,19/06/20
Chandigarh,0,306,6,0,0,0,0,374,19/06/20
Chhattisgarh,0,1228,10,0,0,0,0,1946,19/06/20
Dadra and Nagar Haveli and Daman and Diu,0,13,0,0,0,0,0,58,19/06/20
Delhi,0,21341,1969,0,0,0,0,49979,19/06/20
Goa,0,109,0,0,0,0,0,705,19/06/20
Gujarat,0,17819,1591,0,0,0,0,25601,19/06/20
Haryana,0,4556,134,0,0,0,0,9218,19/06/20
Himachal Pradesh,0,382,8,0,0,0,0,595,19/06/20
Jammu and Kashmir,0,3144,71,0,0,0,0,5555,19/06/20
Jharkhand,0,1198,11,0,0,0,0,1920,19/06/20
Karnataka,0,4983,114,0,0,0,0,7944,19/06/20
Kerala,0,1415,21,0,0,0,0,2794,19/06/20
Ladakh,0,95,1,0,0,0,0,687,19/06/20
Madhya Pradesh,0,8632,486,0,0,0,0,11426,19/06/20
Maharashtra,0,60838,5751,0,0,0,0,120504,19/06/20
Manipur,0,199,0,0,0,0,0,606,19/06/20
Meghalaya,0,30,1,0,0,0,0,44,19/06/20
Mizoram,0,1,0,0,0,0,0,130,19/06/20
Nagaland,0,103,0,0,0,0,0,193,19/06/20
Odisha,0,3144,11,0,0,0,0,4512,19/06/20
Puducherry,0,109,7,0,0,0,0,271,19/06/20
Punjab,0,2570,83,0,0,0,0,3615,19/06/20
Rajasthan,0,10742,323,0,0,0,0,13857,19/06/20
Sikkim,0,5,0,0,0,0,0,70,19/06/20
Tamil Nadu,0,28641,625,0,0,0,0,52334,19/06/20
Telangana,0,3301,195,0,0,0,0,6027,19/06/20
Tripura,0,639,1,0,0,0,0,1155,19/06/20
Uttarakhand,0,1386,26,0,0,0,0,2102,19/06/20
Uttar Pradesh,0,9239,465,0,0,0,0,15181,19/06/20
West Bengal,0,7001,518,0,0,0,0,12735,19/06/20
Cases being reassigned to states,0,0,0,0,0,0,0,8927,19/06/20
Andaman and Nicobar Islands,0,35,0,0,0,0,0,45,20/06/20
Andhra Pradesh,0,3917,96,0,0,0,0,7961,20/06/20
Arunachal Pradesh,0,11,0,0,0,0,0,103,20/06/20
Assam,0,3039,9,0,0,0,0,4904,20/06/20
Bihar,0,5098,50,0,0,0,0,7181,20/06/20
Chandigarh,0,315,6,0,0,0,0,381,20/06/20
Chhattisgarh,0,1331,10,0,0,0,0,2028,20/06/20
Dadra and Nagar Haveli and Daman and Diu,0,14,0,0,0,0,0,62,20/06/20
Delhi,0,23569,2035,0,0,0,0,53116,20/06/20
Goa,0,118,0,0,0,0,0,725,20/06/20
Gujarat,0,18159,1618,0,0,0,0,26141,20/06/20
Haryana,0,4889,144,0,0,0,0,9743,20/06/20
Himachal Pradesh,0,388,8,0,0,0,0,619,20/06/20
Jammu and Kashmir,0,3194,75,0,0,0,0,5680,20/06/20
Jharkhand,0,1332,11,0,0,0,0,1965,20/06/20
Karnataka,0,5210,124,0,0,0,0,8281,20/06/20
Kerala,0,1511,21,0,0,0,0,2912,20/06/20
Ladakh,0,95,1,0,0,0,0,744,20/06/20
Madhya Pradesh,0,8748,495,0,0,0,0,11582,20/06/20
Maharashtra,0,62773,5893,0,0,0,0,124331,20/06/20
Manipur,0,218,0,0,0,0,0,681,20/06/20
Meghalaya,0,33,1,0,0,0,0,44,20/06/20
Mizoram,0,1,0,0,0,0,0,130,20/06/20
Nagaland,0,125,0,0,0,0,0,198,20/06/20
Odisha,0,3297,11,0,0,0,0,4677,20/06/20
Puducherry,0,118,7,0,0,0,0,286,20/06/20
Punjab,0,2636,92,0,0,0,0,3832,20/06/20
Rajasthan,0,10997,333,0,0,0,0,14156,20/06/20
Sikkim,0,5,0,0,0,0,0,70,20/06/20
Tamil Nadu,0,30271,666,0,0,0,0,54449,20/06/20
Telangana,0,3353,198,0,0,0,0,6526,20/06/20
Tripura,0,657,1,0,0,0,0,1178,20/06/20
Uttarakhand,0,1433,26,0,0,0,0,2177,20/06/20
Uttar Pradesh,0,9638,488,0,0,0,0,15785,20/06/20
West Bengal,0,7303,529,0,0,0,0,13090,20/06/20
Cases being reassigned to states,0,0,0,0,0,0,0,9265,20/06/20
Andaman and Nicobar Islands,0,36,0,0,0,0,0,47,21/06/20
Andhra Pradesh,0,4111,101,0,0,0,0,8452,21/06/20
Arunachal Pradesh,0,14,0,0,0,0,0,135,21/06/20
Assam,0,3039,9,0,0,0,0,4904,21/06/20
Bihar,0,5529,52,0,0,0,0,7533,21/06/20
Chandigarh,0,316,6,0,0,0,0,404,21/06/20
Chhattisgarh,0,1394,11,0,0,0,0,2041,21/06/20
Dadra and Nagar Haveli and Daman and Diu,0,26,0,0,0,0,0,68,21/06/20
Delhi,0,31294,2112,0,0,0,0,56746,21/06/20
Goa,0,129,0,0,0,0,0,754,21/06/20
Gujarat,0,18694,1638,0,0,0,0,26680,21/06/20
Haryana,0,5128,149,0,0,0,0,10223,21/06/20
Himachal Pradesh,0,413,8,0,0,0,0,656,21/06/20
Jammu and Kashmir,0,3336,81,0,0,0,0,5834,21/06/20
Jharkhand,0,1335,11,0,0,0,0,1965,21/06/20
Karnataka,0,5391,132,0,0,0,0,8697,21/06/20
Kerala,0,1568,21,0,0,0,0,3039,21/06/20
Ladakh,0,117,1,0,0,0,0,836,21/06/20
Madhya Pradesh,0,8880,501,0,0,0,0,11724,21/06/20
Maharashtra,0,64153,5984,0,0,0,0,128205,21/06/20
Manipur,0,232,0,0,0,0,0,777,21/06/20
Meghalaya,0,33,1,0,0,0,0,44,21/06/20
Mizoram,0,9,0,0,0,0,0,140,21/06/20
Nagaland,0,138,0,0,0,0,0,201,21/06/20
Odisha,0,3534,12,0,0,0,0,4856,21/06/20
Puducherry,0,118,7,0,0,0,0,286,21/06/20
Punjab,0,2678,98,0,0,0,0,3952,21/06/20
Rajasthan,0,11274,337,0,0,0,0,14536,21/06/20
Sikkim,0,25,0,0,0,0,0,70,21/06/20
Tamil Nadu,0,31316,704,0,0,0,0,56845,21/06/20
Telangana,0,3506,203,0,0,0,0,7072,21/06/20
Tripura,0,680,1,0,0,0,0,1186,21/06/20
Uttarakhand,0,1450,27,0,0,0,0,2301,21/06/20
Uttar Pradesh,0,9995,507,0,0,0,0,16594,21/06/20
West Bengal,0,7865,540,0,0,0,0,13531,21/06/20
Cases being reassigned to states,0,0,0,0,0,0,0,9127,21/06/20
Andaman and Nicobar Islands,0,37,0,0,0,0,0,48,22/06/20
Andhra Pradesh,0,4331,106,0,0,0,0,8999,22/06/20
Arunachal Pradesh,0,15,0,0,0,0,0,135,22/06/20
Assam,0,3360,9,0,0,0,0,5388,22/06/20
Bihar,0,5580,53,0,0,0,0,7612,22/06/20
Chandigarh,0,316,6,0,0,0,0,406,22/06/20
Chhattisgarh,0,1447,11,0,0,0,0,2275,22/06/20
Dadra and Nagar Haveli and Daman and Diu,0,26,0,0,0,0,0,88,22/06/20
Delhi,0,33013,2175,0,0,0,0,59746,22/06/20
Goa,0,129,0,0,0,0,0,754,22/06/20
Gujarat,0,19349,1663,0,0,0,0,27260,22/06/20
Haryana,0,5557,160,0,0,0,0,10635,22/06/20
Himachal Pradesh,0,425,8,0,0,0,0,673,22/06/20
Jammu and Kashmir,0,3382,82,0,0,0,0,5956,22/06/20
Jharkhand,0,1406,11,0,0,0,0,2073,22/06/20
Karnataka,0,5618,137,0,0,0,0,9150,22/06/20
Kerala,0,1661,21,0,0,0,0,3172,22/06/20
Ladakh,0,134,1,0,0,0,0,837,22/06/20
Madhya Pradesh,0,9015,515,0,0,0,0,11903,22/06/20
Maharashtra,0,65744,6170,0,0,0,0,132075,22/06/20
Manipur,0,250,0,0,0,0,0,841,22/06/20
Meghalaya,0,33,1,0,0,0,0,44,22/06/20
Mizoram,0,9,0,0,0,0,0,141,22/06/20
Nagaland,0,141,0,0,0,0,0,211,22/06/20
Odisha,0,3720,14,0,0,0,0,5160,22/06/20
Puducherry,0,140,8,0,0,0,0,366,22/06/20
Punjab,0,2700,99,0,0,0,0,4074,22/06/20
Rajasthan,0,11597,349,0,0,0,0,14930,22/06/20
Sikkim,0,25,0,0,0,0,0,78,22/06/20
Tamil Nadu,0,32754,757,0,0,0,0,59377,22/06/20
Telangana,0,3731,210,0,0,0,0,7802,22/06/20
Tripura,0,759,1,0,0,0,0,1221,22/06/20
Uttarakhand,0,1500,27,0,0,0,0,2344,22/06/20
Uttar Pradesh,0,10995,550,0,0,0,0,17731,22/06/20
West Bengal,0,8297,555,0,0,0,0,13945,22/06/20
Cases being reassigned to states,0,0,0,0,0,0,0,7832,22/06/20
Andaman and Nicobar Islands,0,37,0,0,0,0,0,48,23/06/20
Andhra Pradesh,0,4495,111,0,0,0,0,9372,23/06/20
Arunachal Pradesh,0,21,0,0,0,0,0,139,23/06/20
Assam,0,3521,9,0,0,0,0,5586,23/06/20
Bihar,0,5781,55,0,0,0,0,7825,23/06/20
Chandigarh,0,322,6,0,0,0,0,411,23/06/20
Chhattisgarh,0,1513,12,0,0,0,0,2303,23/06/20
Dadra and Nagar Haveli and Daman and Diu,0,27,0,0,0,0,0,91,23/06/20
Delhi,0,36602,2233,0,0,0,0,62655,23/06/20
Goa,0,152,1,0,0,0,0,864,23/06/20
Gujarat,0,19909,1684,0,0,0,0,27825,23/06/20
Haryana,0,5916,169,0,0,0,0,11025,23/06/20
Himachal Pradesh,0,437,8,0,0,0,0,727,23/06/20
Jammu and Kashmir,0,3531,85,0,0,0,0,6088,23/06/20
Jharkhand,0,1469,11,0,0,0,0,2137,23/06/20
Karnataka,0,5730,142,0,0,0,0,9399,23/06/20
Kerala,0,1749,21,0,0,0,0,3310,23/06/20
Ladakh,0,136,1,0,0,0,0,847,23/06/20
Madhya Pradesh,0,9215,521,0,0,0,0,12078,23/06/20
Maharashtra,0,67706,6283,0,0,0,0,135796,23/06/20
Manipur,0,250,0,0,0,0,0,898,23/06/20
Meghalaya,0,37,1,0,0,0,0,44,23/06/20
Mizoram,0,9,0,0,0,0,0,141,23/06/20
Nagaland,0,141,0,0,0,0,0,280,23/06/20
Odisha,0,3863,15,0,0,0,0,5303,23/06/20
Puducherry,0,149,8,0,0,0,0,383,23/06/20
Punjab,0,2825,101,0,0,0,0,4235,23/06/20
Rajasthan,0,11910,356,0,0,0,0,15232,23/06/20
Sikkim,0,29,0,0,0,0,0,78,23/06/20
Tamil Nadu,0,34112,794,0,0,0,0,62087,23/06/20
Telangana,0,4005,217,0,0,0,0,8674,23/06/20
Tripura,0,782,1,0,0,0,0,1237,23/06/20
Uttarakhand,0,1521,28,0,0,0,0,2402,23/06/20
Uttar Pradesh,0,11601,569,0,0,0,0,18322,23/06/20
West Bengal,0,8687,569,0,0,0,0,14358,23/06/20
Cases being reassigned to states,0,0,0,0,0,0,0,8015,23/06/20
Andaman and Nicobar Islands,0,40,0,0,0,0,0,50,24/06/20
Andhra Pradesh,0,4599,119,0,0,0,0,10002,24/06/20
Arunachal Pradesh,0,22,0,0,0,0,0,148,24/06/20
Assam,0,3762,9,0,0,0,0,5831,24/06/20
Bihar,0,6104,56,0,0,0,0,8153,24/06/20
Chandigarh,0,322,6,0,0,0,0,418,24/06/20
Chhattisgarh,0,1553,12,0,0,0,0,2362,24/06/20
Dadra and Nagar Haveli and Daman and Diu,0,29,0,0,0,0,0,120,24/06/20
Delhi,0,39313,2301,0,0,0,0,66602,24/06/20
Goa,0,205,1,0,0,0,0,909,24/06/20
Gujarat,0,20513,1710,0,0,0,0,28371,24/06/20
Haryana,0,6498,178,0,0,0,0,11520,24/06/20
Himachal Pradesh,0,443,8,0,0,0,0,775,24/06/20
Jammu and Kashmir,0,3642,87,0,0,0,0,6236,24/06/20
Jharkhand,0,1520,11,0,0,0,0,2185,24/06/20
Karnataka,0,6004,150,0,0,0,0,9721,24/06/20
Kerala,0,1809,22,0,0,0,0,3451,24/06/20
Ladakh,0,148,1,0,0,0,0,932,24/06/20
Madhya Pradesh,0,9335,525,0,0,0,0,12261,24/06/20
Maharashtra,0,69631,6531,0,0,0,0,139010,24/06/20
Manipur,0,258,0,0,0,0,0,921,24/06/20
Meghalaya,0,37,1,0,0,0,0,46,24/06/20
Mizoram,0,9,0,0,0,0,0,142,24/06/20
Nagaland,0,141,0,0,0,0,0,330,24/06/20
Odisha,0,3988,17,0,0,0,0,5470,24/06/20
Puducherry,0,165,9,0,0,0,0,402,24/06/20
Punjab,0,3047,105,0,0,0,0,4397,24/06/20
Rajasthan,0,12213,365,0,0,0,0,15627,24/06/20
Sikkim,0,29,0,0,0,0,0,79,24/06/20
Tamil Nadu,0,35339,833,0,0,0,0,64603,24/06/20
Telangana,0,4224,220,0,0,0,0,9553,24/06/20
Tripura,0,807,1,0,0,0,0,1259,24/06/20
Uttarakhand,0,1602,30,0,0,0,0,2535,24/06/20
Uttar Pradesh,0,12116,588,0,0,0,0,18893,24/06/20
West Bengal,0,9218,580,0,0,0,0,14728,24/06/20
Cases being reassigned to states,0,0,0,0,0,0,0,8141,24/06/20
Andaman and Nicobar Islands,0,43,0,0,0,0,0,56,25/06/20
Andhra Pradesh,0,4779,124,0,0,0,0,10331,25/06/20
Arunachal Pradesh,0,38,0,0,0,0,0,158,25/06/20
Assam,0,3958,9,0,0,0,0,6198,25/06/20
Bihar,0,6113,57,0,0,0,0,8209,25/06/20
Chandigarh,0,323,6,0,0,0,0,420,25/06/20
Chhattisgarh,0,1627,12,0,0,0,0,2419,25/06/20
Dadra and Nagar Haveli and Daman and Diu,0,30,0,0,0,0,0,120,25/06/20
Delhi,0,41437,2365,0,0,0,0,70390,25/06/20
Goa,0,289,2,0,0,0,0,951,25/06/20
Gujarat,0,21088,1735,0,0,0,0,28943,25/06/20
Haryana,0,6925,188,0,0,0,0,12010,25/06/20
Himachal Pradesh,0,466,8,0,0,0,0,806,25/06/20
Jammu and Kashmir,0,3818,88,0,0,0,0,6422,25/06/20
Jharkhand,0,1570,11,0,0,0,0,2207,25/06/20
Karnataka,0,6151,164,0,0,0,0,10118,25/06/20
Kerala,0,1888,22,0,0,0,0,3603,25/06/20
Ladakh,0,274,1,0,0,0,0,941,25/06/20
Madhya Pradesh,0,9473,534,0,0,0,0,12448,25/06/20
Maharashtra,0,73792,6739,0,0,0,0,142900,25/06/20
Manipur,0,328,0,0,0,0,0,970,25/06/20
Meghalaya,0,42,1,0,0,0,0,46,25/06/20
Mizoram,0,19,0,0,0,0,0,142,25/06/20
Nagaland,0,148,0,0,0,0,0,347,25/06/20
Odisha,0,4123,17,0,0,0,0,5752,25/06/20
Puducherry,0,176,9,0,0,0,0,461,25/06/20
Punjab,0,3099,113,0,0,0,0,4627,25/06/20
Rajasthan,0,12611,375,0,0,0,0,16009,25/06/20
Sikkim,0,39,0,0,0,0,0,84,25/06/20
Tamil Nadu,0,37763,866,0,0,0,0,67468,25/06/20
Telangana,0,4361,225,0,0,0,0,10444,25/06/20
Tripura,0,897,1,0,0,0,0,1259,25/06/20
Uttarakhand,0,1721,35,0,0,0,0,2623,25/06/20
Uttar Pradesh,0,12586,596,0,0,0,0,19557,25/06/20
West Bengal,0,9702,591,0,0,0,0,15173,25/06/20
Cases being reassigned to states,0,0,0,0,0,0,0,8493,25/06/20
Andaman and Nicobar Islands,0,43,0,0,0,0,0,59,26/06/20
Andhra Pradesh,0,4988,136,0,0,0,0,10884,26/06/20
Arunachal Pradesh,0,38,1,0,0,0,0,160,26/06/20
Assam,0,4033,9,0,0,0,0,6321,26/06/20
Bihar,0,6441,57,0,0,0,0,8473,26/06/20
Chandigarh,0,329,6,0,0,0,0,423,26/06/20
Chhattisgarh,0,1755,12,0,0,0,0,2452,26/06/20
Dadra and Nagar Haveli and Daman and Diu,0,32,0,0,0,0,0,155,26/06/20
Delhi,0,44765,2429,0,0,0,0,73780,26/06/20
Goa,0,335,2,0,0,0,0,995,26/06/20
Gujarat,0,21498,1753,0,0,0,0,29520,26/06/20
Haryana,0,7380,198,0,0,0,0,12463,26/06/20
Himachal Pradesh,0,477,9,0,0,0,0,839,26/06/20
Jammu and Kashmir,0,3967,90,0,0,0,0,6549,26/06/20
Jharkhand,0,1605,12,0,0,0,0,2262,26/06/20
Karnataka,0,6670,170,0,0,0,0,10560,26/06/20
Kerala,0,1943,22,0,0,0,0,3726,26/06/20
Ladakh,0,358,1,0,0,0,0,941,26/06/20
Madhya Pradesh,0,9619,542,0,0,0,0,12596,26/06/20
Maharashtra,0,77453,6931,0,0,0,0,147741,26/06/20
Manipur,0,354,0,0,0,0,0,1056,26/06/20
Meghalaya,0,42,1,0,0,0,0,46,26/06/20
Mizoram,0,30,0,0,0,0,0,145,26/06/20
Nagaland,0,160,0,0,0,0,0,355,26/06/20
Odisha,0,4291,17,0,0,0,0,5962,26/06/20
Puducherry,0,187,9,0,0,0,0,502,26/06/20
Punjab,0,3192,120,0,0,0,0,4769,26/06/20
Rajasthan,0,12840,379,0,0,0,0,16296,26/06/20
Sikkim,0,39,0,0,0,0,0,85,26/06/20
Tamil Nadu,0,39999,911,0,0,0,0,70977,26/06/20
Telangana,0,4688,230,0,0,0,0,11364,26/06/20
Tripura,0,1019,1,0,0,0,0,1290,26/06/20
Uttarakhand,0,1758,36,0,0,0,0,2691,26/06/20
Uttar Pradesh,0,13119,611,0,0,0,0,20193,26/06/20
West Bengal,0,10190,606,0,0,0,0,15648,26/06/20
Cases being reassigned to states,0,0,0,0,0,0,0,8123,26/06/20
Andaman and Nicobar Islands,0,43,0,0,0,0,0,72,27/06/20
Andhra Pradesh,0,5196,148,0,0,0,0,11489,27/06/20
Arunachal Pradesh,0,42,1,0,0,0,0,172,27/06/20
Assam,0,4259,9,0,0,0,0,6607,27/06/20
Bihar,0,6762,58,0,0,0,0,8716,27/06/20
Chandigarh,0,335,6,0,0,0,0,425,27/06/20
Chhattisgarh,0,1914,13,0,0,0,0,2545,27/06/20
Dadra and Nagar Haveli and Daman and Diu,0,41,0,0,0,0,0,163,27/06/20
Delhi,0,47091,2492,0,0,0,0,77240,27/06/20
Goa,0,370,2,0,0,0,0,1039,27/06/20
Gujarat,0,22030,1771,0,0,0,0,30095,27/06/20
Haryana,0,8016,211,0,0,0,0,12884,27/06/20
Himachal Pradesh,0,502,9,0,0,0,0,864,27/06/20
Jammu and Kashmir,0,4080,91,0,0,0,0,6762,27/06/20
Jharkhand,0,1643,12,0,0,0,0,2290,27/06/20
Karnataka,0,6916,180,0,0,0,0,11005,27/06/20
Kerala,0,2008,22,0,0,0,0,3876,27/06/20
Ladakh,0,358,1,0,0,0,0,946,27/06/20
Madhya Pradesh,0,9804,546,0,0,0,0,12798,27/06/20
Maharashtra,0,79815,7106,0,0,0,0,152765,27/06/20
Manipur,0,393,0,0,0,0,0,1075,27/06/20
Meghalaya,0,42,1,0,0,0,0,47,27/06/20
Mizoram,0,30,0,0,0,0,0,145,27/06/20
Nagaland,0,162,0,0,0,0,0,371,27/06/20
Odisha,0,4422,17,0,0,0,0,6180,27/06/20
Puducherry,0,187,9,0,0,0,0,502,27/06/20
Punjab,0,3201,122,0,0,0,0,4957,27/06/20
Rajasthan,0,13062,380,0,0,0,0,16660,27/06/20
Sikkim,0,39,0,0,0,0,0,86,27/06/20
Tamil Nadu,0,41357,957,0,0,0,0,74622,27/06/20
Telangana,0,4766,237,0,0,0,0,12349,27/06/20
Tripura,0,1055,1,0,0,0,0,1325,27/06/20
Uttarakhand,0,1822,37,0,0,0,0,2725,27/06/20
Uttar Pradesh,0,13583,630,0,0,0,0,20943,27/06/20
West Bengal,0,10535,616,0,0,0,0,16190,27/06/20
Cases being reassigned to states,0,0,0,0,0,0,0,8023,27/06/20
Andaman and Nicobar Islands,0,43,0,0,0,0,0,72,28/06/20
Andhra Pradesh,0,5480,157,0,0,0,0,12285,28/06/20
Arunachal Pradesh,0,54,1,0,0,0,0,177,28/06/20
Assam,0,4500,9,0,0,0,0,6816,28/06/20
Bihar,0,6843,59,0,0,0,0,8931,28/06/20
Chandigarh,0,335,6,0,0,0,0,428,28/06/20
Chhattisgarh,0,1914,13,0,0,0,0,2545,28/06/20
Dadra and Nagar Haveli and Daman and Diu,0,55,0,0,0,0,0,177,28/06/20
Delhi,0,49301,2558,0,0,0,0,80188,28/06/20
Goa,0,420,2,0,0,0,0,1128,28/06/20
Gujarat,0,22409,1789,0,0,0,0,30709,28/06/20
Haryana,0,8472,218,0,0,0,0,13427,28/06/20
Himachal Pradesh,0,509,9,0,0,0,0,894,28/06/20
Jammu and Kashmir,0,4225,93,0,0,0,0,6966,28/06/20
Jharkhand,0,1724,12,0,0,0,0,2339,28/06/20
Karnataka,0,7287,191,0,0,0,0,11923,28/06/20
Kerala,0,2110,22,0,0,0,0,4071,28/06/20
Ladakh,0,554,1,0,0,0,0,960,28/06/20
Madhya Pradesh,0,9971,550,0,0,0,0,12965,28/06/20
Maharashtra,0,84245,7273,0,0,0,0,159133,28/06/20
Manipur,0,432,0,0,0,0,0,1092,28/06/20
Meghalaya,0,42,1,0,0,0,0,47,28/06/20
Mizoram,0,55,0,0,0,0,0,148,28/06/20
Nagaland,0,164,0,0,0,0,0,387,28/06/20
Odisha,0,4606,18,0,0,0,0,6350,28/06/20
Puducherry,0,221,10,0,0,0,0,619,28/06/20
Punjab,0,3320,128,0,0,0,0,5056,28/06/20
Rajasthan,0,13367,391,0,0,0,0,16944,28/06/20
Sikkim,0,46,0,0,0,0,0,87,28/06/20
Tamil Nadu,0,44094,1025,0,0,0,0,78335,28/06/20
Telangana,0,4928,243,0,0,0,0,13436,28/06/20
Tripura,0,1071,1,0,0,0,0,1334,28/06/20
Uttarakhand,0,1912,37,0,0,0,0,2791,28/06/20
Uttar Pradesh,0,14215,649,0,0,0,0,21549,28/06/20
West Bengal,0,10789,629,0,0,0,0,16711,28/06/20
Cases being reassigned to states,0,0,0,0,0,0,0,7839,28/06/20
Andaman and Nicobar Islands,0,45,0,0,0,0,0,76,29/06/20
Andhra Pradesh,0,5908,169,0,0,0,0,13241,29/06/20
Arunachal Pradesh,0,60,1,0,0,0,0,182,29/06/20
Assam,0,5088,10,0,0,0,0,7206,29/06/20
Bihar,0,7118,60,0,0,0,0,9212,29/06/20
Chandigarh,0,336,6,0,0,0,0,429,29/06/20
Chhattisgarh,0,2091,13,0,0,0,0,2662,29/06/20
Dadra and Nagar Haveli and Daman and Diu,0,60,0,0,0,0,0,178,29/06/20
Delhi,0,52607,2623,0,0,0,0,83077,29/06/20
Goa,0,478,3,0,0,0,0,1198,29/06/20
Gujarat,0,22800,1808,0,0,0,0,31320,29/06/20
Haryana,0,8917,223,0,0,0,0,13829,29/06/20
Himachal Pradesh,0,529,9,0,0,0,0,916,29/06/20
Jammu and Kashmir,0,4316,94,0,0,0,0,7093,29/06/20
Jharkhand,0,1793,12,0,0,0,0,2364,29/06/20
Karnataka,0,7507,207,0,0,0,0,13190,29/06/20
Kerala,0,2152,22,0,0,0,0,4189,29/06/20
Ladakh,0,586,1,0,0,0,0,963,29/06/20
Madhya Pradesh,0,10084,557,0,0,0,0,13186,29/06/20
Maharashtra,0,86575,7429,0,0,0,0,164626,29/06/20
Manipur,0,455,0,0,0,0,0,1185,29/06/20
Meghalaya,0,42,1,0,0,0,0,47,29/06/20
Mizoram,0,55,0,0,0,0,0,148,29/06/20
Nagaland,0,164,0,0,0,0,0,415,29/06/20
Odisha,0,4743,21,0,0,0,0,6614,29/06/20
Puducherry,0,221,10,0,0,0,0,619,29/06/20
Punjab,0,3526,133,0,0,0,0,5216,29/06/20
Rajasthan,0,13611,399,0,0,0,0,17271,29/06/20
Sikkim,0,49,0,0,0,0,0,88,29/06/20
Tamil Nadu,0,45537,1079,0,0,0,0,82275,29/06/20
Telangana,0,5172,247,0,0,0,0,14419,29/06/20
Tripura,0,1079,1,0,0,0,0,1346,29/06/20
Uttarakhand,0,2018,38,0,0,0,0,2823,29/06/20
Uttar Pradesh,0,14808,660,0,0,0,0,22147,29/06/20
West Bengal,0,11193,639,0,0,0,0,17283,29/06/20
Cases being reassigned to states,0,0,0,0,0,0,0,7285,29/06/20
Andaman and Nicobar Islands,0,46,0,0,0,0,0,90,30/06/20
Andhra Pradesh,0,6232,180,0,0,0,0,13891,30/06/20
Arunachal Pradesh,0,61,1,0,0,0,0,187,30/06/20
Assam,0,5333,11,0,0,0,0,7752,30/06/20
Bihar,0,7390,62,0,0,0,0,9640,30/06/20
Chandigarh,0,349,6,0,0,0,0,435,30/06/20
Chhattisgarh,0,2173,13,0,0,0,0,2761,30/06/20
Dadra and Nagar Haveli and Daman and Diu,0,77,0,0,0,0,0,203,30/06/20
Delhi,0,56235,2680,0,0,0,0,85161,30/06/20
Goa,0,478,3,0,0,0,0,1198,30/06/20
Gujarat,0,23240,1827,0,0,0,0,31938,30/06/20
Haryana,0,9502,232,0,0,0,0,14210,30/06/20
Himachal Pradesh,0,556,9,0,0,0,0,942,30/06/20
Jammu and Kashmir,0,4585,95,0,0,0,0,7237,30/06/20
Jharkhand,0,1845,15,0,0,0,0,2426,30/06/20
Karnataka,0,7683,226,0,0,0,0,14295,30/06/20
Kerala,0,2152,22,0,0,0,0,4189,30/06/20
Ladakh,0,616,1,0,0,0,0,964,30/06/20
Madhya Pradesh,0,10199,564,0,0,0,0,13370,30/06/20
Maharashtra,0,88960,7610,0,0,0,0,169883,30/06/20
Manipur,0,494,0,0,0,0,0,1227,30/06/20
Meghalaya,0,42,1,0,0,0,0,47,30/06/20
Mizoram,0,55,0,0,0,0,0,148,30/06/20
Nagaland,0,168,0,0,0,0,0,434,30/06/20
Odisha,0,4946,23,0,0,0,0,6859,30/06/20
Puducherry,0,221,10,0,0,0,0,619,30/06/20
Punjab,0,3764,138,0,0,0,0,5418,30/06/20
Rajasthan,0,13618,405,0,0,0,0,17660,30/06/20
Sikkim,0,50,0,0,0,0,0,88,30/06/20
Tamil Nadu,0,47749,1141,0,0,0,0,86224,30/06/20
Telangana,0,5582,253,0,0,0,0,15394,30/06/20
Tripura,0,1085,1,0,0,0,0,1380,30/06/20
Uttarakhand,0,2111,39,0,0,0,0,2831,30/06/20
Uttar Pradesh,0,15506,672,0,0,0,0,22828,30/06/20
West Bengal,0,11719,653,0,0,0,0,17907,30/06/20
Cases being reassigned to states,0,0,0,0,0,0,0,7004,30/06/20
Andaman and Nicobar Islands,0,50,0,0,0,0,0,97,01/07/20
Andhra Pradesh,0,6511,187,0,0,0,0,14595,01/07/20
Arunachal Pradesh,0,62,1,0,0,0,0,191,01/07/20
Assam,0,5647,12,0,0,0,0,8227,01/07/20
Bihar,0,7687,67,0,0,0,0,10043,01/07/20
Chandigarh,0,364,6,0,0,0,0,440,01/07/20
Chhattisgarh,0,2250,13,0,0,0,0,2860,01/07/20
Dadra and Nagar Haveli and Daman and Diu,0,82,0,0,0,0,0,213,01/07/20
Delhi,0,58348,2742,0,0,0,0,87360,01/07/20
Goa,0,596,3,0,0,0,0,1315,01/07/20
Gujarat,0,23662,1846,0,0,0,0,32557,01/07/20
Haryana,0,9972,236,0,0,0,0,14548,01/07/20
Himachal Pradesh,0,580,10,0,0,0,0,953,01/07/20
Jammu and Kashmir,0,4722,101,0,0,0,0,7497,01/07/20
Jharkhand,0,1884,15,0,0,0,0,2490,01/07/20
Karnataka,0,7918,246,0,0,0,0,15242,01/07/20
Kerala,0,2306,24,0,0,0,0,4442,01/07/20
Ladakh,0,648,1,0,0,0,0,973,01/07/20
Madhya Pradesh,0,10395,572,0,0,0,0,13593,01/07/20
Maharashtra,0,90911,7855,0,0,0,0,174761,01/07/20
Manipur,0,553,0,0,0,0,0,1234,01/07/20
Meghalaya,0,42,1,0,0,0,0,52,01/07/20
Mizoram,0,122,0,0,0,0,0,160,01/07/20
Nagaland,0,168,0,0,0,0,0,459,01/07/20
Odisha,0,5189,25,0,0,0,0,7065,01/07/20
Puducherry,0,272,12,0,0,0,0,714,01/07/20
Punjab,0,3867,144,0,0,0,0,5568,01/07/20
Rajasthan,0,14220,413,0,0,0,0,18014,01/07/20
Sikkim,0,52,0,0,0,0,0,89,01/07/20
Tamil Nadu,0,50074,1201,0,0,0,0,90167,01/07/20
Telangana,0,7294,260,0,0,0,0,16339,01/07/20
Tripura,0,1086,1,0,0,0,0,1388,01/07/20
Uttarakhand,0,2231,41,0,0,0,0,2881,01/07/20
Uttar Pradesh,0,16084,697,0,0,0,0,23492,01/07/20
West Bengal,0,12130,668,0,0,0,0,18559,01/07/20
Cases being reassigned to states,0,0,0,0,0,0,0,6915,01/07/20
Andaman and Nicobar Islands,0,50,0,0,0,0,0,100,02/07/20
Andhra Pradesh,0,6988,193,0,0,0,0,15252,02/07/20
Arunachal Pradesh,0,66,1,0,0,0,0,195,02/07/20
Assam,0,5851,12,0,0,0,0,8582,02/07/20
Bihar,0,7946,70,0,0,0,0,10249,02/07/20
Chandigarh,0,367,6,0,0,0,0,446,02/07/20
Chhattisgarh,0,2303,14,0,0,0,0,2940,02/07/20
Dadra and Nagar Haveli and Daman and Diu,0,86,0,0,0,0,0,215,02/07/20
Delhi,0,59992,2803,0,0,0,0,89802,02/07/20
Goa,0,670,4,0,0,0,0,1387,02/07/20
Gujarat,0,24030,1867,0,0,0,0,33232,02/07/20
Haryana,0,10499,240,0,0,0,0,14941,02/07/20
Himachal Pradesh,0,614,10,0,0,0,0,979,02/07/20
Jammu and Kashmir,0,4856,105,0,0,0,0,7695,02/07/20
Jharkhand,0,1931,15,0,0,0,0,2521,02/07/20
Karnataka,0,8063,253,0,0,0,0,16514,02/07/20
Kerala,0,2439,24,0,0,0,0,4593,02/07/20
Ladakh,0,694,1,0,0,0,0,990,02/07/20
Madhya Pradesh,0,10655,581,0,0,0,0,13861,02/07/20
Maharashtra,0,93154,8053,0,0,0,0,180298,02/07/20
Manipur,0,579,0,0,0,0,0,1260,02/07/20
Meghalaya,0,42,1,0,0,0,0,52,02/07/20
Mizoram,0,123,0,0,0,0,0,160,02/07/20
Nagaland,0,168,0,0,0,0,0,459,02/07/20
Odisha,0,5353,25,0,0,0,0,7316,02/07/20
Puducherry,0,272,12,0,0,0,0,714,02/07/20
Punjab,0,3867,149,0,0,0,0,5668,02/07/20
Rajasthan,0,14574,421,0,0,0,0,18312,02/07/20
Sikkim,0,53,0,0,0,0,0,101,02/07/20
Tamil Nadu,0,52926,1264,0,0,0,0,94049,02/07/20
Telangana,0,8082,267,0,0,0,0,17357,02/07/20
Tripura,0,1093,1,0,0,0,0,1396,02/07/20
Uttarakhand,0,2317,41,0,0,0,0,2947,02/07/20
Uttar Pradesh,0,16629,718,0,0,0,0,24056,02/07/20
West Bengal,0,12528,683,0,0,0,0,19170,02/07/20
Cases being reassigned to states,0,0,0,0,0,0,0,6832,02/07/20
Andaman and Nicobar Islands,0,51,0,0,0,0,0,109,03/07/20
Andhra Pradesh,0,7313,198,0,0,0,0,16097,03/07/20
Arunachal Pradesh,0,66,1,0,0,0,0,195,03/07/20
Assam,0,6106,12,0,0,0,0,9013,03/07/20
Bihar,0,8020,77,0,0,0,0,10471,03/07/20
Chandigarh,0,389,6,0,0,0,0,450,03/07/20
Chhattisgarh,0,2385,14,0,0,0,0,3013,03/07/20
Dadra and Nagar Haveli and Daman and Diu,0,89,0,0,0,0,0,230,03/07/20
Delhi,0,63007,2864,0,0,0,0,92175,03/07/20
Goa,0,734,4,0,0,0,0,1482,03/07/20
Gujarat,0,24593,1886,0,0,0,0,33913,03/07/20
Haryana,0,11019,251,0,0,0,0,15509,03/07/20
Himachal Pradesh,0,628,10,0,0,0,0,1014,03/07/20
Jammu and Kashmir,0,4974,115,0,0,0,0,7849,03/07/20
Jharkhand,0,1983,15,0,0,0,0,2584,03/07/20
Karnataka,0,8334,272,0,0,0,0,18016,03/07/20
Kerala,0,2640,25,0,0,0,0,4753,03/07/20
Ladakh,0,730,1,0,0,0,0,990,03/07/20
Madhya Pradesh,0,10815,589,0,0,0,0,14106,03/07/20
Maharashtra,0,101172,8178,0,0,0,0,186626,03/07/20
Manipur,0,617,0,0,0,0,0,1279,03/07/20
Meghalaya,0,42,1,0,0,0,0,56,03/07/20
Mizoram,0,126,0,0,0,0,0,162,03/07/20
Nagaland,0,182,0,0,0,0,0,501,03/07/20
Odisha,0,5502,27,0,0,0,0,7545,03/07/20
Puducherry,0,331,12,0,0,0,0,802,03/07/20
Punjab,0,4144,152,0,0,0,0,5784,03/07/20
Rajasthan,0,14948,430,0,0,0,0,18662,03/07/20
Sikkim,0,53,0,0,0,0,0,102,03/07/20
Tamil Nadu,0,56021,1321,0,0,0,0,98392,03/07/20
Telangana,0,9069,275,0,0,0,0,18570,03/07/20
Tripura,0,1146,1,0,0,0,0,1435,03/07/20
Uttarakhand,0,2405,42,0,0,0,0,2984,03/07/20
Uttar Pradesh,0,17221,735,0,0,0,0,24825,03/07/20
West Bengal,0,13037,699,0,0,0,0,19819,03/07/20
Cases being reassigned to states,0,0,0,0,0,0,0,6031,03/07/20
Andaman and Nicobar Islands,0,54,0,0,0,0,0,116,04/07/20
Andhra Pradesh,0,7632,206,0,0,0,0,16934,04/07/20
Arunachal Pradesh,0,75,1,0,0,0,0,252,04/07/20
Assam,0,6349,14,0,0,0,0,9673,04/07/20
Bihar,0,8214,80,0,0,0,0,10954,04/07/20
Chandigarh,0,393,6,0,0,0,0,457,04/07/20
Chhattisgarh,0,2437,14,0,0,0,0,3065,04/07/20
Dadra and Nagar Haveli and Daman and Diu,0,96,0,0,0,0,0,257,04/07/20
Delhi,0,65624,2923,0,0,0,0,94695,04/07/20
Goa,0,734,4,0,0,0,0,1482,04/07/20
Gujarat,0,24933,1904,0,0,0,0,34600,04/07/20
Haryana,0,11691,255,0,0,0,0,16003,04/07/20
Himachal Pradesh,0,667,10,0,0,0,0,1033,04/07/20
Jammu and Kashmir,0,5075,119,0,0,0,0,8019,04/07/20
Jharkhand,0,2001,15,0,0,0,0,2695,04/07/20
Karnataka,0,8805,293,0,0,0,0,19710,04/07/20
Kerala,0,2841,25,0,0,0,0,4964,04/07/20
Ladakh,0,777,1,0,0,0,0,1001,04/07/20
Madhya Pradesh,0,11049,593,0,0,0,0,14297,04/07/20
Maharashtra,0,104687,8376,0,0,0,0,192990,04/07/20
Manipur,0,639,0,0,0,0,0,1316,04/07/20
Meghalaya,0,43,1,0,0,0,0,62,04/07/20
Mizoram,0,126,0,0,0,0,0,162,04/07/20
Nagaland,0,228,0,0,0,0,0,539,04/07/20
Odisha,0,5705,29,0,0,0,0,8106,04/07/20
Puducherry,0,331,12,0,0,0,0,802,04/07/20
Punjab,0,4266,157,0,0,0,0,5937,04/07/20
Rajasthan,0,15281,440,0,0,0,0,19052,04/07/20
Sikkim,0,53,0,0,0,0,0,102,04/07/20
Tamil Nadu,0,58378,1385,0,0,0,0,102721,04/07/20
Telangana,0,10195,283,0,0,0,0,20462,04/07/20
Tripura,0,1199,1,0,0,0,0,1525,04/07/20
Uttarakhand,0,2481,42,0,0,0,0,3048,04/07/20
Uttar Pradesh,0,17597,749,0,0,0,0,25797,04/07/20
West Bengal,0,13571,717,0,0,0,0,20488,04/07/20
Cases being reassigned to states,0,0,0,0,0,0,0,4999,04/07/20
Andaman and Nicobar Islands,0,66,0,0,0,0,0,119,05/07/20
Andhra Pradesh,0,8008,218,0,0,0,0,17699,05/07/20
Arunachal Pradesh,0,76,1,0,0,0,0,259,05/07/20
Assam,0,6657,14,0,0,0,0,10668,05/07/20
Bihar,0,8686,89,0,0,0,0,11700,05/07/20
Chandigarh,0,395,6,0,0,0,0,460,05/07/20
Chhattisgarh,0,2549,14,0,0,0,0,3161,05/07/20
Dadra and Nagar Haveli and Daman and Diu,0,96,0,0,0,0,0,271,05/07/20
Delhi,0,68256,3004,0,0,0,0,97200,05/07/20
Goa,0,825,6,0,0,0,0,1684,05/07/20
Gujarat,0,25406,1925,0,0,0,0,35312,05/07/20
Haryana,0,12257,260,0,0,0,0,16548,05/07/20
Himachal Pradesh,0,704,11,0,0,0,0,1046,05/07/20
Jammu and Kashmir,0,5143,127,0,0,0,0,8246,05/07/20
Jharkhand,0,2035,17,0,0,0,0,2739,05/07/20
Karnataka,0,9244,335,0,0,0,0,21549,05/07/20
Kerala,0,3048,25,0,0,0,0,5204,05/07/20
Ladakh,0,826,1,0,0,0,0,1005,05/07/20
Madhya Pradesh,0,11234,598,0,0,0,0,14604,05/07/20
Maharashtra,0,108082,8671,0,0,0,0,200064,05/07/20
Manipur,0,667,0,0,0,0,0,1325,05/07/20
Meghalaya,0,43,1,0,0,0,0,62,05/07/20
Mizoram,0,130,0,0,0,0,0,164,05/07/20
Nagaland,0,228,0,0,0,0,0,563,05/07/20
Odisha,0,5934,34,0,0,0,0,8601,05/07/20
Puducherry,0,331,12,0,0,0,0,802,05/07/20
Punjab,0,4306,162,0,0,0,0,6109,05/07/20
Rajasthan,0,15640,447,0,0,0,0,19532,05/07/20
Sikkim,0,58,0,0,0,0,0,103,05/07/20
Tamil Nadu,0,60592,1450,0,0,0,0,107001,05/07/20
Telangana,0,11537,288,0,0,0,0,22312,05/07/20
Tripura,0,1202,1,0,0,0,0,1546,05/07/20
Uttarakhand,0,2502,42,0,0,0,0,3093,05/07/20
Uttar Pradesh,0,18154,773,0,0,0,0,26554,05/07/20
West Bengal,0,14166,736,0,0,0,0,21231,05/07/20
Cases being reassigned to states,0,0,0,0,0,0,0,4629,05/07/20
Andaman and Nicobar Islands,0,72,0,0,0,0,0,125,06/07/20
Andhra Pradesh,0,8422,232,0,0,0,0,18697,06/07/20
Arunachal Pradesh,0,78,1,0,0,0,0,269,06/07/20
Assam,0,7125,14,0,0,0,0,11388,06/07/20
Bihar,0,8765,95,0,0,0,0,11876,06/07/20
Chandigarh,0,395,6,0,0,0,0,466,06/07/20
Chhattisgarh,0,2601,14,0,0,0,0,3207,06/07/20
Dadra and Nagar Haveli and Daman and Diu,0,106,0,0,0,0,0,271,06/07/20
Delhi,0,71339,3067,0,0,0,0,99444,06/07/20
Goa,0,936,7,0,0,0,0,1761,06/07/20
Gujarat,0,25892,1943,0,0,0,0,36037,06/07/20
Haryana,0,12944,265,0,0,0,0,17005,06/07/20
Himachal Pradesh,0,737,11,0,0,0,0,1063,06/07/20
Jammu and Kashmir,0,5255,132,0,0,0,0,8429,06/07/20
Jharkhand,0,2045,19,0,0,0,0,2781,06/07/20
Karnataka,0,9847,372,0,0,0,0,23474,06/07/20
Kerala,0,3174,25,0,0,0,0,5429,06/07/20
Ladakh,0,826,1,0,0,0,0,1005,06/07/20
Madhya Pradesh,0,11411,608,0,0,0,0,14930,06/07/20
Maharashtra,0,111740,8822,0,0,0,0,206619,06/07/20
Manipur,0,688,0,0,0,0,0,1366,06/07/20
Meghalaya,0,43,1,0,0,0,0,62,06/07/20
Mizoram,0,130,0,0,0,0,0,186,06/07/20
Nagaland,0,231,0,0,0,0,0,590,06/07/20
Odisha,0,6224,36,0,0,0,0,9070,06/07/20
Puducherry,0,331,12,0,0,0,0,802,06/07/20
Punjab,0,4408,164,0,0,0,0,6283,06/07/20
Rajasthan,0,15928,456,0,0,0,0,20164,06/07/20
Sikkim,0,61,0,0,0,0,0,123,06/07/20
Tamil Nadu,0,62778,1510,0,0,0,0,111151,06/07/20
Telangana,0,12703,295,0,0,0,0,23902,06/07/20
Tripura,0,1202,1,0,0,0,0,1568,06/07/20
Uttarakhand,0,2524,42,0,0,0,0,3124,06/07/20
Uttar Pradesh,0,18761,785,0,0,0,0,27707,06/07/20
West Bengal,0,14711,757,0,0,0,0,22126,06/07/20
Cases being reassigned to states,0,0,0,0,0,0,0,4913,06/07/20
Andaman and Nicobar Islands,0,74,0,0,0,0,0,141,07/07/20
Andhra Pradesh,0,8920,239,0,0,0,0,20019,07/07/20
Arunachal Pradesh,0,92,2,0,0,0,0,270,07/07/20
Assam,0,7882,14,0,0,0,0,12160,07/07/20
Bihar,0,8997,97,0,0,0,0,12125,07/07/20
Chandigarh,0,401,6,0,0,0,0,489,07/07/20
Chhattisgarh,0,2667,14,0,0,0,0,3305,07/07/20
Dadra and Nagar Haveli and Daman and Diu,0,114,0,0,0,0,0,297,07/07/20
Delhi,0,72088,3115,0,0,0,0,100823,07/07/20
Goa,0,1061,7,0,0,0,0,1813,07/07/20
Gujarat,0,26315,1960,0,0,0,0,36772,07/07/20
Haryana,0,13335,276,0,0,0,0,17504,07/07/20
Himachal Pradesh,0,763,11,0,0,0,0,1077,07/07/20
Jammu and Kashmir,0,5318,138,0,0,0,0,8675,07/07/20
Jharkhand,0,2068,20,0,0,0,0,2847,07/07/20
Karnataka,0,10527,401,0,0,0,0,25317,07/07/20
Kerala,0,3341,27,0,0,0,0,5622,07/07/20
Ladakh,0,836,1,0,0,0,0,1005,07/07/20
Madhya Pradesh,0,11579,617,0,0,0,0,15284,07/07/20
Maharashtra,0,115262,9026,0,0,0,0,211987,07/07/20
Manipur,0,734,0,0,0,0,0,1390,07/07/20
Meghalaya,0,43,1,0,0,0,0,80,07/07/20
Mizoram,0,133,0,0,0,0,0,197,07/07/20
Nagaland,0,243,0,0,0,0,0,625,07/07/20
Odisha,0,6486,38,0,0,0,0,9526,07/07/20
Puducherry,0,331,12,0,0,0,0,802,07/07/20
Punjab,0,4494,169,0,0,0,0,6491,07/07/20
Rajasthan,0,16278,461,0,0,0,0,20688,07/07/20
Sikkim,0,65,0,0,0,0,0,125,07/07/20
Tamil Nadu,0,66571,1571,0,0,0,0,114978,07/07/20
Telangana,0,14781,306,0,0,0,0,25733,07/07/20
Tripura,0,1219,1,0,0,0,0,1680,07/07/20
Uttarakhand,0,2586,42,0,0,0,0,3161,07/07/20
Uttar Pradesh,0,19109,809,0,0,0,0,28636,07/07/20
West Bengal,0,15235,779,0,0,0,0,22987,07/07/20
Cases being reassigned to states,0,0,0,0,0,0,0,5034,07/07/20
Andaman and Nicobar Islands,0,75,0,0,0,0,0,147,08/07/20
Andhra Pradesh,0,9745,252,0,0,0,0,21197,08/07/20
Arunachal Pradesh,0,105,2,0,0,0,0,276,08/07/20
Assam,0,8329,14,0,0,0,0,12522,08/07/20
Bihar,0,9284,104,0,0,0,0,12570,08/07/20
Chandigarh,0,401,7,0,0,0,0,494,08/07/20
Chhattisgarh,0,2751,14,0,0,0,0,3415,08/07/20
Dadra and Nagar Haveli and Daman and Diu,0,183,0,0,0,0,0,405,08/07/20
Delhi,0,74217,3165,0,0,0,0,102831,08/07/20
Goa,0,1156,8,0,0,0,0,1903,08/07/20
Gujarat,0,26720,1977,0,0,0,0,37550,08/07/20
Haryana,0,13645,279,0,0,0,0,17999,08/07/20
Himachal Pradesh,0,790,11,0,0,0,0,1083,08/07/20
Jammu and Kashmir,0,5399,143,0,0,0,0,8931,08/07/20
Jharkhand,0,2104,22,0,0,0,0,2996,08/07/20
Karnataka,0,11098,416,0,0,0,0,26815,08/07/20
Kerala,0,3452,27,0,0,0,0,5894,08/07/20
Ladakh,0,836,1,0,0,0,0,1041,08/07/20
Madhya Pradesh,0,11768,622,0,0,0,0,15627,08/07/20
Maharashtra,0,118558,9250,0,0,0,0,217121,08/07/20
Manipur,0,771,0,0,0,0,0,1430,08/07/20
Meghalaya,0,43,1,0,0,0,0,80,08/07/20
Mizoram,0,133,0,0,0,0,0,197,08/07/20
Nagaland,0,243,0,0,0,0,0,625,08/07/20
Odisha,0,6703,42,0,0,0,0,10097,08/07/20
Puducherry,0,434,14,0,0,0,0,930,08/07/20
Punjab,0,4554,175,0,0,0,0,6749,08/07/20
Rajasthan,0,16575,472,0,0,0,0,21404,08/07/20
Sikkim,0,70,0,0,0,0,0,125,08/07/20
Tamil Nadu,0,71116,1636,0,0,0,0,118594,08/07/20
Telangana,0,16287,313,0,0,0,0,27612,08/07/20
Tripura,0,1248,1,0,0,0,0,1704,08/07/20
Uttarakhand,0,2621,43,0,0,0,0,3230,08/07/20
Uttar Pradesh,0,19627,827,0,0,0,0,29968,08/07/20
West Bengal,0,15790,804,0,0,0,0,23837,08/07/20
Cases being reassigned to states,0,0,0,0,0,0,0,5018,08/07/20
Andaman and Nicobar Islands,0,77,0,0,0,0,0,149,09/07/20
Andhra Pradesh,0,11101,264,0,0,0,0,22259,09/07/20
Arunachal Pradesh,0,109,2,0,0,0,0,287,09/07/20
Assam,0,8729,16,0,0,0,0,13336,09/07/20
Bihar,0,9554,107,0,0,0,0,13189,09/07/20
Chandigarh,0,402,7,0,0,0,0,513,09/07/20
Chhattisgarh,0,2835,14,0,0,0,0,3525,09/07/20
Dadra and Nagar Haveli and Daman and Diu,0,184,0,0,0,0,0,408,09/07/20
Delhi,0,78199,3213,0,0,0,0,104864,09/07/20
Goa,0,1207,8,0,0,0,0,2039,09/07/20
Gujarat,0,27289,1993,0,0,0,0,38333,09/07/20
Haryana,0,14106,282,0,0,0,0,18690,09/07/20
Himachal Pradesh,0,833,11,0,0,0,0,1101,09/07/20
Jammu and Kashmir,0,5567,149,0,0,0,0,9261,09/07/20
Jharkhand,0,2170,22,0,0,0,0,3096,09/07/20
Karnataka,0,11876,470,0,0,0,0,28877,09/07/20
Kerala,0,3559,27,0,0,0,0,6195,09/07/20
Ladakh,0,836,1,0,0,0,0,1041,09/07/20
Madhya Pradesh,0,11987,629,0,0,0,0,16036,09/07/20
Maharashtra,0,123192,9448,0,0,0,0,223724,09/07/20
Manipur,0,793,0,0,0,0,0,1435,09/07/20
Meghalaya,0,43,1,0,0,0,0,80,09/07/20
Mizoram,0,133,0,0,0,0,0,197,09/07/20
Nagaland,0,304,0,0,0,0,0,657,09/07/20
Odisha,0,7006,48,0,0,0,0,10624,09/07/20
Puducherry,0,480,14,0,0,0,0,1008,09/07/20
Punjab,0,4828,178,0,0,0,0,6907,09/07/20
Rajasthan,0,16866,482,0,0,0,0,22063,09/07/20
Sikkim,0,71,0,0,0,0,0,133,09/07/20
Tamil Nadu,0,74167,1700,0,0,0,0,122350,09/07/20
Telangana,0,17279,324,0,0,0,0,29536,09/07/20
Tripura,0,1324,1,0,0,0,0,1761,09/07/20
Uttarakhand,0,2650,46,0,0,0,0,3258,09/07/20
Uttar Pradesh,0,20331,845,0,0,0,0,31156,09/07/20
West Bengal,0,16291,827,0,0,0,0,24823,09/07/20
Cases being reassigned to states,0,0,0,0,0,0,0,4385,09/07/20
Andaman and Nicobar Islands,0,83,0,0,0,0,0,151,10/07/20
Andhra Pradesh,0,12154,277,0,0,0,0,23814,10/07/20
Arunachal Pradesh,0,120,2,0,0,0,0,302,10/07/20
Assam,0,8729,22,0,0,0,0,14032,10/07/20
Bihar,0,9816,115,0,0,0,0,13944,10/07/20
Chandigarh,0,403,7,0,0,0,0,523,10/07/20
Chhattisgarh,0,2903,15,0,0,0,0,3675,10/07/20
Dadra and Nagar Haveli and Daman and Diu,0,189,0,0,0,0,0,411,10/07/20
Delhi,0,82226,3258,0,0,0,0,107051,10/07/20
Goa,0,1273,9,0,0,0,0,2151,10/07/20
Gujarat,0,27718,2008,0,0,0,0,39194,10/07/20
Haryana,0,14510,287,0,0,0,0,19369,10/07/20
Himachal Pradesh,0,846,11,0,0,0,0,1140,10/07/20
Jammu and Kashmir,0,5695,154,0,0,0,0,9501,10/07/20
Jharkhand,0,2208,23,0,0,0,0,3246,10/07/20
Karnataka,0,12833,486,0,0,0,0,31105,10/07/20
Kerala,0,3708,27,0,0,0,0,6534,10/07/20
Ladakh,0,915,1,0,0,0,0,1055,10/07/20
Madhya Pradesh,0,12232,634,0,0,0,0,16341,10/07/20
Maharashtra,0,127259,9667,0,0,0,0,230599,10/07/20
Manipur,0,799,0,0,0,0,0,1450,10/07/20
Meghalaya,0,66,2,0,0,0,0,113,10/07/20
Mizoram,0,133,0,0,0,0,0,197,10/07/20
Nagaland,0,304,0,0,0,0,0,673,10/07/20
Odisha,0,7407,52,0,0,0,0,11201,10/07/20
Puducherry,0,584,14,0,0,0,0,1151,10/07/20
Punjab,0,4945,183,0,0,0,0,7140,10/07/20
Rajasthan,0,17070,491,0,0,0,0,22563,10/07/20
Sikkim,0,72,0,0,0,0,0,134,10/07/20
Tamil Nadu,0,78161,1765,0,0,0,0,126581,10/07/20
Telangana,0,18192,331,0,0,0,0,30946,10/07/20
Tripura,0,1338,1,0,0,0,0,1776,10/07/20
Uttarakhand,0,2672,46,0,0,0,0,3305,10/07/20
Uttar Pradesh,0,21127,862,0,0,0,0,32362,10/07/20
West Bengal,0,16826,854,0,0,0,0,25911,10/07/20
Cases being reassigned to states,0,0,0,0,0,0,0,4161,10/07/20
Andaman and Nicobar Islands,0,92,0,0,0,0,0,156,11/07/20
Andhra Pradesh,0,13194,292,0,0,0,0,25422,11/07/20
Arunachal Pradesh,0,120,2,0,0,0,0,335,11/07/20
Assam,0,9147,27,0,0,0,0,14600,11/07/20
Bihar,0,10109,119,0,0,0,0,14575,11/07/20
Chandigarh,0,408,7,0,0,0,0,539,11/07/20
Chhattisgarh,0,3028,17,0,0,0,0,3767,11/07/20
Dadra and Nagar Haveli and Daman and Diu,0,211,0,0,0,0,0,459,11/07/20
Delhi,0,84694,3300,0,0,0,0,109140,11/07/20
Goa,0,1347,9,0,0,0,0,2251,11/07/20
Gujarat,0,28147,2022,0,0,0,0,40069,11/07/20
Haryana,0,14904,290,0,0,0,0,19934,11/07/20
Himachal Pradesh,0,883,11,0,0,0,0,1171,11/07/20
Jammu and Kashmir,0,5786,159,0,0,0,0,9888,11/07/20
Jharkhand,0,2224,23,0,0,0,0,3419,11/07/20
Karnataka,0,13836,543,0,0,0,0,33418,11/07/20
Kerala,0,3820,27,0,0,0,0,6950,11/07/20
Ladakh,0,917,1,0,0,0,0,1064,11/07/20
Madhya Pradesh,0,12481,638,0,0,0,0,16657,11/07/20
Maharashtra,0,132625,9893,0,0,0,0,238461,11/07/20
Manipur,0,832,0,0,0,0,0,1582,11/07/20
Meghalaya,0,66,2,0,0,0,0,207,11/07/20
Mizoram,0,143,0,0,0,0,0,226,11/07/20
Nagaland,0,304,0,0,0,0,0,732,11/07/20
Odisha,0,7972,56,0,0,0,0,11956,11/07/20
Puducherry,0,637,17,0,0,0,0,1272,11/07/20
Punjab,0,5017,187,0,0,0,0,7357,11/07/20
Rajasthan,0,17620,497,0,0,0,0,23174,11/07/20
Sikkim,0,80,0,0,0,0,0,134,11/07/20
Tamil Nadu,0,82324,1829,0,0,0,0,130261,11/07/20
Telangana,0,19205,339,0,0,0,0,32224,11/07/20
Tripura,0,1372,1,0,0,0,0,1918,11/07/20
Uttarakhand,0,2706,46,0,0,0,0,3373,11/07/20
Uttar Pradesh,0,21787,889,0,0,0,0,33700,11/07/20
West Bengal,0,17348,880,0,0,0,0,27109,11/07/20
Cases being reassigned to states,0,0,0,0,0,0,0,3416,11/07/20
Andaman and Nicobar Islands,0,93,0,0,0,0,0,163,12/07/20
Andhra Pradesh,0,14393,309,0,0,0,0,27235,12/07/20
Arunachal Pradesh,0,125,2,0,0,0,0,341,12/07/20
Assam,0,9150,35,0,0,0,0,15536,12/07/20
Bihar,0,10685,131,0,0,0,0,15373,12/07/20
Chandigarh,0,413,7,0,0,0,0,555,12/07/20
Chhattisgarh,0,3070,17,0,0,0,0,3897,12/07/20
Dadra and Nagar Haveli and Daman and Diu,0,226,0,0,0,0,0,471,12/07/20
Delhi,0,87692,3334,0,0,0,0,110921,12/07/20
Goa,0,1428,12,0,0,0,0,2368,12/07/20
Gujarat,0,28649,2032,0,0,0,0,40941,12/07/20
Haryana,0,15394,297,0,0,0,0,20582,12/07/20
Himachal Pradesh,0,908,11,0,0,0,0,1182,12/07/20
Jammu and Kashmir,0,5895,169,0,0,0,0,10156,12/07/20
Jharkhand,0,2243,23,0,0,0,0,3613,12/07/20
Karnataka,0,14716,613,0,0,0,0,36216,12/07/20
Kerala,0,3963,29,0,0,0,0,7438,12/07/20
Ladakh,0,928,1,0,0,0,0,1077,12/07/20
Madhya Pradesh,0,12679,644,0,0,0,0,17201,12/07/20
Maharashtra,0,136985,10116,0,0,0,0,246600,12/07/20
Manipur,0,843,0,0,0,0,0,1593,12/07/20
Meghalaya,0,66,2,0,0,0,0,207,12/07/20
Mizoram,0,150,0,0,0,0,0,227,12/07/20
Nagaland,0,313,0,0,0,0,0,748,12/07/20
Odisha,0,8360,61,0,0,0,0,12526,12/07/20
Puducherry,0,690,18,0,0,0,0,1337,12/07/20
Punjab,0,5040,195,0,0,0,0,7587,12/07/20
Rajasthan,0,17869,503,0,0,0,0,23748,12/07/20
Sikkim,0,80,0,0,0,0,0,151,12/07/20
Tamil Nadu,0,85915,1898,0,0,0,0,134226,12/07/20
Telangana,0,20919,348,0,0,0,0,33402,12/07/20
Tripura,0,1375,2,0,0,0,0,1949,12/07/20
Uttarakhand,0,2718,46,0,0,0,0,3417,12/07/20
Uttar Pradesh,0,22689,913,0,0,0,0,35092,12/07/20
West Bengal,0,17959,906,0,0,0,0,28453,12/07/20
Cases being reassigned to states,0,0,0,0,0,0,0,3024,12/07/20
Andaman and Nicobar Islands,0,93,0,0,0,0,0,163,13/07/20
Andhra Pradesh,0,15412,328,0,0,0,0,29168,13/07/20
Arunachal Pradesh,0,138,2,0,0,0,0,359,13/07/20
Assam,0,10426,35,0,0,0,0,16071,13/07/20
Bihar,0,11498,143,0,0,0,0,16642,13/07/20
Chandigarh,0,417,8,0,0,0,0,559,13/07/20
Chhattisgarh,0,3153,19,0,0,0,0,4059,13/07/20
Dadra and Nagar Haveli and Daman and Diu,0,245,0,0,0,0,0,479,13/07/20
Delhi,0,89968,3371,0,0,0,0,112494,13/07/20
Goa,0,1487,14,0,0,0,0,2453,13/07/20
Gujarat,0,29162,2045,0,0,0,0,41820,13/07/20
Haryana,0,15983,301,0,0,0,0,21240,13/07/20
Himachal Pradesh,0,929,11,0,0,0,0,1213,13/07/20
Jammu and Kashmir,0,5979,179,0,0,0,0,10513,13/07/20
Jharkhand,0,2308,30,0,0,0,0,3756,13/07/20
Karnataka,0,15409,684,0,0,0,0,38843,13/07/20
Kerala,0,4095,31,0,0,0,0,7873,13/07/20
Ladakh,0,928,1,0,0,0,0,1086,13/07/20
Madhya Pradesh,0,12876,653,0,0,0,0,17632,13/07/20
Maharashtra,0,140325,10289,0,0,0,0,254427,13/07/20
Manipur,0,896,0,0,0,0,0,1609,13/07/20
Meghalaya,0,66,2,0,0,0,0,306,13/07/20
Mizoram,0,150,0,0,0,0,0,231,13/07/20
Nagaland,0,327,0,0,0,0,0,774,13/07/20
Odisha,0,8750,64,0,0,0,0,13121,13/07/20
Puducherry,0,739,18,0,0,0,0,1418,13/07/20
Punjab,0,5392,199,0,0,0,0,7821,13/07/20
Rajasthan,0,18103,510,0,0,0,0,24392,13/07/20
Sikkim,0,81,0,0,0,0,0,153,13/07/20
Tamil Nadu,0,89532,1966,0,0,0,0,138470,13/07/20
Telangana,0,22482,356,0,0,0,0,34671,13/07/20
Tripura,0,1421,2,0,0,0,0,2054,13/07/20
Uttarakhand,0,2786,47,0,0,0,0,3537,13/07/20
Uttar Pradesh,0,23334,934,0,0,0,0,36476,13/07/20
West Bengal,0,18581,932,0,0,0,0,30013,13/07/20
Cases being reassigned to states,0,0,0,0,0,0,0,2358,13/07/20
Andaman and Nicobar Islands,0,109,0,0,0,0,0,166,14/07/20
Andhra Pradesh,0,16464,365,0,0,0,0,31103,14/07/20
Arunachal Pradesh,0,145,2,0,0,0,0,387,14/07/20
Assam,0,10894,36,0,0,0,0,16806,14/07/20
Bihar,0,12317,160,0,0,0,0,17959,14/07/20
Chandigarh,0,423,8,0,0,0,0,588,14/07/20
Chhattisgarh,0,3202,19,0,0,0,0,4217,14/07/20
Dadra and Nagar Haveli and Daman and Diu,0,268,1,0,0,0,0,495,14/07/20
Delhi,0,91312,3411,0,0,0,0,113740,14/07/20
Goa,0,1540,17,0,0,0,0,2583,14/07/20
Gujarat,0,29770,2055,0,0,0,0,42722,14/07/20
Haryana,0,16602,308,0,0,0,0,21894,14/07/20
Himachal Pradesh,0,940,11,0,0,0,0,1243,14/07/20
Jammu and Kashmir,0,6095,187,0,0,0,0,10827,14/07/20
Jharkhand,0,2351,33,0,0,0,0,3898,14/07/20
Karnataka,0,16248,757,0,0,0,0,41581,14/07/20
Kerala,0,4257,33,0,0,0,0,8322,14/07/20
Ladakh,0,946,1,0,0,0,0,1093,14/07/20
Madhya Pradesh,0,13208,663,0,0,0,0,18207,14/07/20
Maharashtra,0,144507,10482,0,0,0,0,260924,14/07/20
Manipur,0,970,0,0,0,0,0,1626,14/07/20
Meghalaya,0,66,2,0,0,0,0,318,14/07/20
Mizoram,0,151,0,0,0,0,0,233,14/07/20
Nagaland,0,340,0,0,0,0,0,845,14/07/20
Odisha,0,9255,70,0,0,0,0,13737,14/07/20
Puducherry,0,785,18,0,0,0,0,1468,14/07/20
Punjab,0,5586,204,0,0,0,0,8178,14/07/20
Rajasthan,0,18630,525,0,0,0,0,24936,14/07/20
Sikkim,0,86,0,0,0,0,0,192,14/07/20
Tamil Nadu,0,92567,2032,0,0,0,0,142798,14/07/20
Telangana,0,23679,365,0,0,0,0,36221,14/07/20
Tripura,0,1475,2,0,0,0,0,2080,14/07/20
Uttarakhand,0,2856,49,0,0,0,0,3608,14/07/20
Uttar Pradesh,0,24203,955,0,0,0,0,38130,14/07/20
West Bengal,0,19213,956,0,0,0,0,31448,14/07/20
Cases being reassigned to states,0,0,0,0,0,0,0,2179,14/07/20
Andaman and Nicobar Islands,0,109,0,0,0,0,0,166,15/07/20
Andhra Pradesh,0,17467,408,0,0,0,0,33019,15/07/20
Arunachal Pradesh,0,153,3,0,0,0,0,462,15/07/20
Assam,0,11416,40,0,0,0,0,17807,15/07/20
Bihar,0,12849,174,0,0,0,0,19284,15/07/20
Chandigarh,0,446,10,0,0,0,0,600,15/07/20
Chhattisgarh,0,3275,20,0,0,0,0,4379,15/07/20
Dadra and Nagar Haveli and Daman and Diu,0,310,1,0,0,0,0,520,15/07/20
Delhi,0,93236,3446,0,0,0,0,115346,15/07/20
Goa,0,1607,18,0,0,0,0,2753,15/07/20
Gujarat,0,30503,2069,0,0,0,0,43637,15/07/20
Haryana,0,17090,312,0,0,0,0,22628,15/07/20
Himachal Pradesh,0,951,11,0,0,0,0,1309,15/07/20
Jammu and Kashmir,0,6223,195,0,0,0,0,11173,15/07/20
Jharkhand,0,2427,36,0,0,0,0,4091,15/07/20
Karnataka,0,17390,842,0,0,0,0,44077,15/07/20
Kerala,0,4438,34,0,0,0,0,8930,15/07/20
Ladakh,0,946,1,0,0,0,0,1093,15/07/20
Madhya Pradesh,0,13575,673,0,0,0,0,19005,15/07/20
Maharashtra,0,149007,10695,0,0,0,0,267665,15/07/20
Manipur,0,970,0,0,0,0,0,1672,15/07/20
Meghalaya,0,66,2,0,0,0,0,318,15/07/20
Mizoram,0,159,0,0,0,0,0,238,15/07/20
Nagaland,0,346,0,0,0,0,0,896,15/07/20
Odisha,0,9864,74,0,0,0,0,14280,15/07/20
Puducherry,0,829,18,0,0,0,0,1531,15/07/20
Punjab,0,5663,213,0,0,0,0,8511,15/07/20
Rajasthan,0,19161,525,0,0,0,0,25571,15/07/20
Sikkim,0,87,0,0,0,0,0,209,15/07/20
Tamil Nadu,0,97310,2099,0,0,0,0,147324,15/07/20
Telangana,0,24840,375,0,0,0,0,37745,15/07/20
Tripura,0,1538,2,0,0,0,0,2170,15/07/20
Uttarakhand,0,2867,50,0,0,0,0,3686,15/07/20
Uttar Pradesh,0,24983,983,0,0,0,0,39724,15/07/20
West Bengal,0,19931,980,0,0,0,0,32838,15/07/20
Cases being reassigned to states,0,0,0,0,0,0,0,1524,15/07/20
Andaman and Nicobar Islands,0,130,0,0,0,0,0,176,16/07/20
Andhra Pradesh,0,18378,452,0,0,0,0,35451,16/07/20
Arunachal Pradesh,0,153,3,0,0,0,0,462,16/07/20
Assam,0,12173,46,0,0,0,0,18666,16/07/20
Bihar,0,13462,180,0,0,0,0,20612,16/07/20
Chandigarh,0,459,11,0,0,0,0,625,16/07/20
Chhattisgarh,0,3324,20,0,0,0,0,4539,16/07/20
Dadra and Nagar Haveli and Daman and Diu,0,357,2,0,0,0,0,539,16/07/20
Delhi,0,95699,3487,0,0,0,0,116993,16/07/20
Goa,0,1674,18,0,0,0,0,2951,16/07/20
Gujarat,0,31286,2079,0,0,0,0,44552,16/07/20
Haryana,0,17667,319,0,0,0,0,23306,16/07/20
Himachal Pradesh,0,979,11,0,0,0,0,1341,16/07/20
Jammu and Kashmir,0,6337,206,0,0,0,0,11666,16/07/20
Jharkhand,0,2485,38,0,0,0,0,4320,16/07/20
Karnataka,0,18466,928,0,0,0,0,47253,16/07/20
Kerala,0,4634,35,0,0,0,0,9553,16/07/20
Ladakh,0,964,1,0,0,0,0,1142,16/07/20
Madhya Pradesh,0,13908,682,0,0,0,0,19643,16/07/20
Maharashtra,0,152613,10928,0,0,0,0,275640,16/07/20
Manipur,0,989,0,0,0,0,0,1700,16/07/20
Meghalaya,0,66,2,0,0,0,0,346,16/07/20
Mizoram,0,159,0,0,0,0,0,238,16/07/20
Nagaland,0,348,0,0,0,0,0,902,16/07/20
Odisha,0,10476,77,0,0,0,0,14898,16/07/20
Puducherry,0,889,21,0,0,0,0,1596,16/07/20
Punjab,0,5867,221,0,0,0,0,8799,16/07/20
Rajasthan,0,19502,530,0,0,0,0,26437,16/07/20
Sikkim,0,87,0,0,0,0,0,220,16/07/20
Tamil Nadu,0,102310,2167,0,0,0,0,151820,16/07/20
Telangana,0,25999,386,0,0,0,0,39342,16/07/20
Tripura,0,1604,3,0,0,0,0,2268,16/07/20
Uttarakhand,0,2948,50,0,0,0,0,3785,16/07/20
Uttar Pradesh,0,25743,1012,0,0,0,0,41383,16/07/20
West Bengal,0,20680,1000,0,0,0,0,34427,16/07/20
Cases being reassigned to states,0,0,0,0,0,0,0,1285,16/07/20
Andaman and Nicobar Islands,0,133,0,0,0,0,0,180,17/07/20
Andhra Pradesh,0,19393,492,0,0,0,0,38044,17/07/20
Arunachal Pradesh,0,153,3,0,0,0,0,543,17/07/20
Assam,0,12888,48,0,0,0,0,19754,17/07/20
Bihar,0,14018,197,0,0,0,0,21764,17/07/20
Chandigarh,0,476,11,0,0,0,0,651,17/07/20
Chhattisgarh,0,3451,21,0,0,0,0,4732,17/07/20
Dadra and Nagar Haveli and Daman and Diu,0,371,2,0,0,0,0,552,17/07/20
Delhi,0,97693,3545,0,0,0,0,118645,17/07/20
Goa,0,1817,19,0,0,0,0,3108,17/07/20
Gujarat,0,32103,2089,0,0,0,0,45481,17/07/20
Haryana,0,18185,322,0,0,0,0,24002,17/07/20
Himachal Pradesh,0,984,11,0,0,0,0,1377,17/07/20
Jammu and Kashmir,0,6446,222,0,0,0,0,12156,17/07/20
Jharkhand,0,2513,42,0,0,0,0,4624,17/07/20
Karnataka,0,19729,1032,0,0,0,0,51422,17/07/20
Kerala,0,4862,37,0,0,0,0,10275,17/07/20
Ladakh,0,970,1,0,0,0,0,1147,17/07/20
Madhya Pradesh,0,14127,689,0,0,0,0,20378,17/07/20
Maharashtra,0,158140,11194,0,0,0,0,284281,17/07/20
Manipur,0,1129,0,0,0,0,0,1764,17/07/20
Meghalaya,0,66,2,0,0,0,0,377,17/07/20
Mizoram,0,160,0,0,0,0,0,272,17/07/20
Nagaland,0,391,0,0,0,0,0,916,17/07/20
Odisha,0,10877,79,0,0,0,0,15392,17/07/20
Puducherry,0,947,22,0,0,0,0,1743,17/07/20
Punjab,0,6277,230,0,0,0,0,9094,17/07/20
Rajasthan,0,19970,538,0,0,0,0,27174,17/07/20
Sikkim,0,88,0,0,0,0,0,243,17/07/20
Tamil Nadu,0,107416,2236,0,0,0,0,156369,17/07/20
Telangana,0,27295,396,0,0,0,0,41018,17/07/20
Tripura,0,1604,3,0,0,0,0,2283,17/07/20
Uttarakhand,0,2995,50,0,0,0,0,3982,17/07/20
Uttar Pradesh,0,26675,1046,0,0,0,0,43441,17/07/20
West Bengal,0,21415,1023,0,0,0,0,36117,17/07/20
Cases being reassigned to states,0,0,0,0,0,0,0,531,17/07/20
Andaman and Nicobar Islands,0,142,0,0,0,0,0,194,18/07/20
Andhra Pradesh,0,20298,534,0,0,0,0,40646,18/07/20
Arunachal Pradesh,0,175,3,0,0,0,0,609,18/07/20
Assam,0,14105,51,0,0,0,0,20646,18/07/20
Bihar,0,14621,201,0,0,0,0,23589,18/07/20
Chandigarh,0,480,11,0,0,0,0,660,18/07/20
Chhattisgarh,0,3512,23,0,0,0,0,4964,18/07/20
Dadra and Nagar Haveli and Daman and Diu,0,401,2,0,0,0,0,585,18/07/20
Delhi,0,99301,3571,0,0,0,0,120107,18/07/20
Goa,0,1946,21,0,0,0,0,3304,18/07/20
Gujarat,0,32973,2106,0,0,0,0,46430,18/07/20
Haryana,0,18718,327,0,0,0,0,24797,18/07/20
Himachal Pradesh,0,1024,11,0,0,0,0,1417,18/07/20
Jammu and Kashmir,0,6558,231,0,0,0,0,12757,18/07/20
Jharkhand,0,2570,46,0,0,0,0,4921,18/07/20
Karnataka,0,20757,1147,0,0,0,0,55115,18/07/20
Kerala,0,4995,38,0,0,0,0,11066,18/07/20
Ladakh,0,973,1,0,0,0,0,1151,18/07/20
Madhya Pradesh,0,14514,697,0,0,0,0,21081,18/07/20
Maharashtra,0,160357,11452,0,0,0,0,292589,18/07/20
Manipur,0,1163,0,0,0,0,0,1800,18/07/20
Meghalaya,0,66,2,0,0,0,0,403,18/07/20
Mizoram,0,160,0,0,0,0,0,282,18/07/20
Nagaland,0,405,0,0,0,0,0,956,18/07/20
Odisha,0,11330,83,0,0,0,0,16110,18/07/20
Puducherry,0,1014,25,0,0,0,0,1832,18/07/20
Punjab,0,6373,239,0,0,0,0,9442,18/07/20
Rajasthan,0,20626,546,0,0,0,0,27789,18/07/20
Sikkim,0,90,0,0,0,0,0,266,18/07/20
Tamil Nadu,0,110807,2315,0,0,0,0,160907,18/07/20
Telangana,0,28705,403,0,0,0,0,42496,18/07/20
Tripura,0,1684,3,0,0,0,0,2366,18/07/20
Uttarakhand,0,3021,51,0,0,0,0,4102,18/07/20
Uttar Pradesh,0,27634,1084,0,0,0,0,45163,18/07/20
West Bengal,0,22253,1049,0,0,0,0,38011,18/07/20
Cases being reassigned to states,0,0,0,0,0,0,0,163,18/07/20
Andaman and Nicobar Islands,0,145,0,0,0,0,0,198,19/07/20
Andhra Pradesh,0,21763,586,0,0,0,0,44609,19/07/20
Arunachal Pradesh,0,274,3,0,0,0,0,650,19/07/20
Assam,0,15165,53,0,0,0,0,22918,19/07/20
Bihar,0,15536,208,0,0,0,0,25136,19/07/20
Chandigarh,0,485,12,0,0,0,0,700,19/07/20
Chhattisgarh,0,3658,24,0,0,0,0,5233,19/07/20
Dadra and Nagar Haveli and Daman and Diu,0,414,2,0,0,0,0,602,19/07/20
Delhi,0,101274,3597,0,0,0,0,121582,19/07/20
Goa,0,2038,21,0,0,0,0,3484,19/07/20
Gujarat,0,34035,2122,0,0,0,0,47390,19/07/20
Haryana,0,19318,344,0,0,0,0,25547,19/07/20
Himachal Pradesh,0,1036,11,0,0,0,0,1457,19/07/20
Jammu and Kashmir,0,7165,236,0,0,0,0,13198,19/07/20
Jharkhand,0,2611,46,0,0,0,0,5342,19/07/20
Karnataka,0,21775,1240,0,0,0,0,59652,19/07/20
Kerala,0,5199,40,0,0,0,0,11659,19/07/20
Ladakh,0,985,1,0,0,0,0,1159,19/07/20
Madhya Pradesh,0,14864,706,0,0,0,0,21763,19/07/20
Maharashtra,0,165663,11596,0,0,0,0,300937,19/07/20
Manipur,0,1182,0,0,0,0,0,1891,19/07/20
Meghalaya,0,66,2,0,0,0,0,418,19/07/20
Mizoram,0,167,0,0,0,0,0,284,19/07/20
Nagaland,0,432,0,0,0,0,0,978,19/07/20
Odisha,0,11937,86,0,0,0,0,16701,19/07/20
Puducherry,0,1066,28,0,0,0,0,1894,19/07/20
Punjab,0,6454,246,0,0,0,0,9792,19/07/20
Rajasthan,0,21144,553,0,0,0,0,28500,19/07/20
Sikkim,0,90,0,0,0,0,0,275,19/07/20
Tamil Nadu,0,113856,2403,0,0,0,0,165714,19/07/20
Telangana,0,30607,409,0,0,0,0,43780,19/07/20
Tripura,0,1735,5,0,0,0,0,2654,19/07/20
Uttarakhand,0,3081,52,0,0,0,0,4276,19/07/20
Uttar Pradesh,0,28664,1108,0,0,0,0,47036,19/07/20
West Bengal,0,23539,1076,0,0,0,0,40209,19/07/20
Andaman and Nicobar Islands,0,145,0,0,0,0,0,203,20/07/20
Andhra Pradesh,0,22890,642,0,0,0,0,49650,20/07/20
Arunachal Pradesh,0,282,3,0,0,0,0,740,20/07/20
Assam,0,16023,57,0,0,0,0,23999,20/07/20
Bihar,0,16308,217,0,0,0,0,26569,20/07/20
Chandigarh,0,488,12,0,0,0,0,717,20/07/20
Chhattisgarh,0,3775,24,0,0,0,0,5407,20/07/20
Dadra and Nagar Haveli and Daman and Diu,0,414,2,0,0,0,0,605,20/07/20
Delhi,0,103134,3628,0,0,0,0,122793,20/07/20
Goa,0,2218,22,0,0,0,0,3657,20/07/20
Gujarat,0,34901,2142,0,0,0,0,48355,20/07/20
Haryana,0,19793,349,0,0,0,0,26164,20/07/20
Himachal Pradesh,0,1059,11,0,0,0,0,1483,20/07/20
Jammu and Kashmir,0,7811,244,0,0,0,0,13899,20/07/20
Jharkhand,0,2716,49,0,0,0,0,5535,20/07/20
Karnataka,0,23065,1331,0,0,0,0,63772,20/07/20
Kerala,0,5371,42,0,0,0,0,12480,20/07/20
Ladakh,0,1003,2,0,0,0,0,1178,20/07/20
Madhya Pradesh,0,15311,721,0,0,0,0,22600,20/07/20
Maharashtra,0,169569,11854,0,0,0,0,310455,20/07/20
Manipur,0,1213,0,0,0,0,0,1911,20/07/20
Meghalaya,0,66,2,0,0,0,0,450,20/07/20
Mizoram,0,167,0,0,0,0,0,284,20/07/20
Nagaland,0,445,0,0,0,0,0,988,20/07/20
Odisha,0,12453,91,0,0,0,0,17437,20/07/20
Puducherry,0,1154,28,0,0,0,0,1999,20/07/20
Punjab,0,6535,254,0,0,0,0,10100,20/07/20
Rajasthan,0,21730,559,0,0,0,0,29434,20/07/20
Sikkim,0,92,0,0,0,0,0,283,20/07/20
Tamil Nadu,0,117915,2481,0,0,0,0,170693,20/07/20
Telangana,0,32438,415,0,0,0,0,45076,20/07/20
Tripura,0,1759,5,0,0,0,0,2878,20/07/20
Uttarakhand,0,3116,52,0,0,0,0,4515,20/07/20
Uttar Pradesh,0,29845,1146,0,0,0,0,49247,20/07/20
West Bengal,0,24883,1112,0,0,0,0,42487,20/07/20
Andaman and Nicobar Islands,0,152,0,0,0,0,0,207,21/07/20
Andhra Pradesh,0,24228,696,0,0,0,0,53724,21/07/20
Arunachal Pradesh,0,285,3,0,0,0,0,790,21/07/20
Assam,0,17095,58,0,0,0,0,25382,21/07/20
Bihar,0,17433,217,0,0,0,0,27646,21/07/20
Chandigarh,0,518,12,0,0,0,0,737,21/07/20
Chhattisgarh,0,3944,25,0,0,0,0,5561,21/07/20
Dadra and Nagar Haveli and Daman and Diu,0,448,2,0,0,0,0,684,21/07/20
Delhi,0,104918,3663,0,0,0,0,123747,21/07/20
Goa,0,2361,23,0,0,0,0,3853,21/07/20
Gujarat,0,35678,2162,0,0,0,0,49353,21/07/20
Haryana,0,20226,355,0,0,0,0,26858,21/07/20
Himachal Pradesh,0,1067,11,0,0,0,0,1631,21/07/20
Jammu and Kashmir,0,8274,254,0,0,0,0,14650,21/07/20
Jharkhand,0,2810,53,0,0,0,0,5756,21/07/20
Karnataka,0,23795,1403,0,0,0,0,67420,21/07/20
Kerala,0,5616,43,0,0,0,0,13274,21/07/20
Ladakh,0,1007,2,0,0,0,0,1195,21/07/20
Madhya Pradesh,0,15684,738,0,0,0,0,23310,21/07/20
Maharashtra,0,175029,12030,0,0,0,0,318695,21/07/20
Manipur,0,1307,0,0,0,0,0,1925,21/07/20
Meghalaya,0,66,4,0,0,0,0,466,21/07/20
Mizoram,0,168,0,0,0,0,0,297,21/07/20
Nagaland,0,484,0,0,0,0,0,1021,21/07/20
Odisha,0,12910,97,0,0,0,0,18110,21/07/20
Puducherry,0,1265,29,0,0,0,0,2092,21/07/20
Punjab,0,7118,262,0,0,0,0,10510,21/07/20
Rajasthan,0,22195,568,0,0,0,0,30390,21/07/20
Sikkim,0,92,0,0,0,0,0,305,21/07/20
Tamil Nadu,0,121776,2551,0,0,0,0,175678,21/07/20
Telangana,0,34323,422,0,0,0,0,46274,21/07/20
Tripura,0,1845,7,0,0,0,0,3079,21/07/20
Uttarakhand,0,3212,55,0,0,0,0,4642,21/07/20
Uttar Pradesh,0,30831,1192,0,0,0,0,51160,21/07/20
West Bengal,0,26418,1147,0,0,0,0,44769,21/07/20
Andaman and Nicobar Islands,0,159,0,0,0,0,0,212,22/07/20
Andhra Pradesh,0,25574,758,0,0,0,0,58668,22/07/20
Arunachal Pradesh,0,303,3,0,0,0,0,858,22/07/20
Assam,0,18033,58,0,0,0,0,25382,22/07/20
Bihar,0,18515,217,0,0,0,0,28952,22/07/20
Chandigarh,0,518,12,0,0,0,0,751,22/07/20
Chhattisgarh,0,4114,29,0,0,0,0,5729,22/07/20
Dadra and Nagar Haveli and Daman and Diu,0,463,2,0,0,0,0,705,22/07/20
Delhi,0,106118,3690,0,0,0,0,125096,22/07/20
Goa,0,2449,26,0,0,0,0,4027,22/07/20
Gujarat,0,36423,2196,0,0,0,0,50379,22/07/20
Haryana,0,20952,364,0,0,0,0,27462,22/07/20
Himachal Pradesh,0,1077,11,0,0,0,0,1664,22/07/20
Jammu and Kashmir,0,8455,263,0,0,0,0,15258,22/07/20
Jharkhand,0,2904,55,0,0,0,0,6159,22/07/20
Karnataka,0,25459,1464,0,0,0,0,71069,22/07/20
Kerala,0,5890,44,0,0,0,0,13994,22/07/20
Ladakh,0,1010,2,0,0,0,0,1198,22/07/20
Madhya Pradesh,0,16257,756,0,0,0,0,24095,22/07/20
Maharashtra,0,182217,12276,0,0,0,0,327031,22/07/20
Manipur,0,1400,0,0,0,0,0,2015,22/07/20
Meghalaya,0,70,4,0,0,0,0,490,22/07/20
Mizoram,0,168,0,0,0,0,0,317,22/07/20
Nagaland,0,485,0,0,0,0,0,1030,22/07/20
Odisha,0,13310,103,0,0,0,0,18757,22/07/20
Puducherry,0,1318,30,0,0,0,0,2179,22/07/20
Punjab,0,7389,263,0,0,0,0,10889,22/07/20
Rajasthan,0,22744,577,0,0,0,0,31373,22/07/20
Sikkim,0,108,0,0,0,0,0,330,22/07/20
Tamil Nadu,0,126670,2626,0,0,0,0,180643,22/07/20
Telangana,0,37385,429,0,0,0,0,47705,22/07/20
Tripura,0,1926,8,0,0,0,0,3331,22/07/20
Uttarakhand,0,3297,55,0,0,0,0,4849,22/07/20
Uttar Pradesh,0,31855,1229,0,0,0,0,53288,22/07/20
West Bengal,0,28035,1182,0,0,0,0,47030,22/07/20
Andaman and Nicobar Islands,0,163,0,0,0,0,0,221,23/07/20
Andhra Pradesh,0,32127,823,0,0,0,0,64713,23/07/20
Arunachal Pradesh,0,314,3,0,0,0,0,949,23/07/20
Assam,0,18033,64,0,0,0,0,26772,23/07/20
Bihar,0,19646,217,0,0,0,0,30369,23/07/20
Chandigarh,0,526,13,0,0,0,0,793,23/07/20
Chhattisgarh,0,4230,29,0,0,0,0,5968,23/07/20
Dadra and Nagar Haveli and Daman and Diu,0,474,2,0,0,0,0,733,23/07/20
Delhi,0,107650,3719,0,0,0,0,126323,23/07/20
Goa,0,2541,28,0,0,0,0,4176,23/07/20
Gujarat,0,37260,2224,0,0,0,0,51399,23/07/20
Haryana,0,21697,372,0,0,0,0,28186,23/07/20
Himachal Pradesh,0,1105,11,0,0,0,0,1725,23/07/20
Jammu and Kashmir,0,8607,273,0,0,0,0,15711,23/07/20
Jharkhand,0,3024,64,0,0,0,0,6485,23/07/20
Karnataka,0,27239,1519,0,0,0,0,75833,23/07/20
Kerala,0,6162,45,0,0,0,0,15032,23/07/20
Ladakh,0,1018,2,0,0,0,0,1206,23/07/20
Madhya Pradesh,0,16836,770,0,0,0,0,24842,23/07/20
Maharashtra,0,187769,12556,0,0,0,0,337607,23/07/20
Manipur,0,1428,0,0,0,0,0,2060,23/07/20
Meghalaya,0,77,4,0,0,0,0,514,23/07/20
Mizoram,0,179,0,0,0,0,0,317,23/07/20
Nagaland,0,486,0,0,0,0,0,1084,23/07/20
Odisha,0,13750,108,0,0,0,0,19835,23/07/20
Puducherry,0,1369,31,0,0,0,0,2300,23/07/20
Punjab,0,7641,269,0,0,0,0,11301,23/07/20
Rajasthan,0,23364,583,0,0,0,0,32334,23/07/20
Sikkim,0,112,0,0,0,0,0,438,23/07/20
Tamil Nadu,0,131583,3144,0,0,0,0,186492,23/07/20
Telangana,0,37666,438,0,0,0,0,49259,23/07/20
Tripura,0,2032,9,0,0,0,0,3449,23/07/20
Uttarakhand,0,3349,57,0,0,0,0,5300,23/07/20
Uttar Pradesh,0,33500,1263,0,0,0,0,55588,23/07/20
West Bengal,0,29650,1221,0,0,0,0,49321,23/07/20
Andaman and Nicobar Islands,0,170,0,0,0,0,0,240,24/07/20
Andhra Pradesh,0,37555,884,0,0,0,0,72711,24/07/20
Arunachal Pradesh,0,334,3,0,0,0,0,991,24/07/20
Assam,0,20699,70,0,0,0,0,28791,24/07/20
Bihar,0,20769,217,0,0,0,0,31980,24/07/20
Chandigarh,0,531,13,0,0,0,0,800,24/07/20
Chhattisgarh,0,4377,30,0,0,0,0,6254,24/07/20
Dadra and Nagar Haveli and Daman and Diu,0,489,2,0,0,0,0,770,24/07/20
Delhi,0,109065,3745,0,0,0,0,127364,24/07/20
Goa,0,2655,29,0,0,0,0,4350,24/07/20
Gujarat,0,37978,2252,0,0,0,0,52477,24/07/20
Haryana,0,22249,378,0,0,0,0,28975,24/07/20
Himachal Pradesh,0,1136,11,0,0,0,0,1834,24/07/20
Jammu and Kashmir,0,8709,282,0,0,0,0,16429,24/07/20
Jharkhand,0,3174,67,0,0,0,0,6975,24/07/20
Karnataka,0,29310,1616,0,0,0,0,80863,24/07/20
Kerala,0,6594,50,0,0,0,0,16110,24/07/20
Ladakh,0,1025,2,0,0,0,0,1210,24/07/20
Madhya Pradesh,0,17359,780,0,0,0,0,25474,24/07/20
Maharashtra,0,194253,12854,0,0,0,0,347502,24/07/20
Manipur,0,1466,0,0,0,0,0,2115,24/07/20
Meghalaya,0,78,4,0,0,0,0,534,24/07/20
Mizoram,0,183,0,0,0,0,0,332,24/07/20
Nagaland,0,530,0,0,0,0,0,1174,24/07/20
Odisha,0,14393,114,0,0,0,0,21099,24/07/20
Puducherry,0,1400,34,0,0,0,0,2420,24/07/20
Punjab,0,7741,277,0,0,0,0,11739,24/07/20
Rajasthan,0,23815,594,0,0,0,0,33220,24/07/20
Sikkim,0,122,0,0,0,0,0,460,24/07/20
Tamil Nadu,0,136793,3232,0,0,0,0,192964,24/07/20
Telangana,0,39327,447,0,0,0,0,50826,24/07/20
Tripura,0,2072,10,0,0,0,0,3656,24/07/20
Uttarakhand,0,3399,60,0,0,0,0,5445,24/07/20
Uttar Pradesh,0,35803,1289,0,0,0,0,58104,24/07/20
West Bengal,0,31656,1255,0,0,0,0,51757,24/07/20
Andaman and Nicobar Islands,0,174,0,0,0,0,0,259,25/07/20
Andhra Pradesh,0,39935,933,0,0,0,0,80858,25/07/20
Arunachal Pradesh,0,392,3,0,0,0,0,1056,25/07/20
Assam,0,21761,76,0,0,0,0,29921,25/07/20
Bihar,0,22343,220,0,0,0,0,33926,25/07/20
Chandigarh,0,535,13,0,0,0,0,823,25/07/20
Chhattisgarh,0,4567,36,0,0,0,0,6731,25/07/20
Dadra and Nagar Haveli and Daman and Diu,0,512,2,0,0,0,0,815,25/07/20
Delhi,0,110931,3777,0,0,0,0,128389,25/07/20
Goa,0,2865,29,0,0,0,0,4540,25/07/20
Gujarat,0,38849,2278,0,0,0,0,53545,25/07/20
Haryana,0,22953,382,0,0,0,0,29755,25/07/20
Himachal Pradesh,0,1145,11,0,0,0,0,1954,25/07/20
Jammu and Kashmir,0,9217,296,0,0,0,0,16782,25/07/20
Jharkhand,0,3307,70,0,0,0,0,7493,25/07/20
Karnataka,0,31347,1724,0,0,0,0,85870,25/07/20
Kerala,0,7562,54,0,0,0,0,16995,25/07/20
Ladakh,0,1035,2,0,0,0,0,1246,25/07/20
Madhya Pradesh,0,17866,791,0,0,0,0,26210,25/07/20
Maharashtra,0,199967,13132,0,0,0,0,357117,25/07/20
Manipur,0,1491,0,0,0,0,0,2146,25/07/20
Meghalaya,0,87,5,0,0,0,0,588,25/07/20
Mizoram,0,183,0,0,0,0,0,361,25/07/20
Nagaland,0,537,1,0,0,0,0,1239,25/07/20
Odisha,0,15201,120,0,0,0,0,22693,25/07/20
Puducherry,0,1483,35,0,0,0,0,2515,25/07/20
Punjab,0,8096,282,0,0,0,0,12216,25/07/20
Rajasthan,0,24547,602,0,0,0,0,34178,25/07/20
Sikkim,0,142,0,0,0,0,0,477,25/07/20
Tamil Nadu,0,143297,3320,0,0,0,0,199749,25/07/20
Telangana,0,40334,455,0,0,0,0,52466,25/07/20
Tripura,0,2131,11,0,0,0,0,3759,25/07/20
Uttarakhand,0,3399,60,0,0,0,0,5445,25/07/20
Uttar Pradesh,0,37712,1348,0,0,0,0,60771,25/07/20
West Bengal,0,33529,1290,0,0,0,0,53973,25/07/20
Andaman and Nicobar Islands,0,176,0,0,0,0,0,290,26/07/20
Andhra Pradesh,0,43255,985,0,0,0,0,88671,26/07/20
Arunachal Pradesh,0,428,3,0,0,0,0,1126,26/07/20
Assam,0,23055,77,0,0,0,0,31086,26/07/20
Bihar,0,24053,234,0,0,0,0,36604,26/07/20
Chandigarh,0,555,13,0,0,0,0,852,26/07/20
Chhattisgarh,0,4683,39,0,0,0,0,7087,26/07/20
Dadra and Nagar Haveli and Daman and Diu,0,530,2,0,0,0,0,860,26/07/20
Delhi,0,113068,3806,0,0,0,0,129531,26/07/20
Goa,0,3047,33,0,0,0,0,4686,26/07/20
Gujarat,0,39631,2300,0,0,0,0,54626,26/07/20
Haryana,0,23654,389,0,0,0,0,30538,26/07/20
Himachal Pradesh,0,1173,11,0,0,0,0,2049,26/07/20
Jammu and Kashmir,0,9517,305,0,0,0,0,17305,26/07/20
Jharkhand,0,3425,82,0,0,0,0,7836,26/07/20
Karnataka,0,33750,1796,0,0,0,0,90942,26/07/20
Kerala,0,8611,59,0,0,0,0,18098,26/07/20
Ladakh,0,1057,3,0,0,0,0,1276,26/07/20
Madhya Pradesh,0,18488,799,0,0,0,0,26926,26/07/20
Maharashtra,0,207194,13389,0,0,0,0,366368,26/07/20
Manipur,0,1524,0,0,0,0,0,2176,26/07/20
Meghalaya,0,94,5,0,0,0,0,646,26/07/20
Mizoram,0,183,0,0,0,0,0,361,26/07/20
Nagaland,0,541,4,0,0,0,0,1289,26/07/20
Odisha,0,15929,130,0,0,0,0,24013,26/07/20
Puducherry,0,1561,38,0,0,0,0,2654,26/07/20
Punjab,0,8297,291,0,0,0,0,12684,26/07/20
Rajasthan,0,25306,613,0,0,0,0,35298,26/07/20
Sikkim,0,142,0,0,0,0,0,499,26/07/20
Tamil Nadu,0,151055,3409,0,0,0,0,206737,26/07/20
Telangana***,0,40334,455,0,0,0,0,52466,26/07/20
Tripura,0,2209,11,0,0,0,0,3862,26/07/20
Uttarakhand,0,3495,63,0,0,0,0,5961,26/07/20
Uttar Pradesh,0,39903,1387,0,0,0,0,63742,26/07/20
West Bengal,0,35654,1332,0,0,0,0,56377,26/07/20
Andaman and Nicobar Islands,0,182,0,0,0,0,0,324,27/07/20
Andhra Pradesh,0,46301,1041,0,0,0,0,96298,27/07/20
Arunachal Pradesh,0,505,3,0,0,0,0,1158,27/07/20
Assam,0,24040,79,0,0,0,0,32228,27/07/20
Bihar,0,25815,244,0,0,0,0,39176,27/07/20
Chandigarh,0,572,13,0,0,0,0,887,27/07/20
Chhattisgarh,0,4944,43,0,0,0,0,7450,27/07/20
Dadra and Nagar Haveli and Daman and Diu,0,550,2,0,0,0,0,914,27/07/20
Delhi,0,114875,3827,0,0,0,0,130606,27/07/20
Goa,0,3277,35,0,0,0,0,4861,27/07/20
Gujarat,0,40365,2326,0,0,0,0,55822,27/07/20
Haryana,0,24384,392,0,0,0,0,31332,27/07/20
Himachal Pradesh,0,1198,12,0,0,0,0,2176,27/07/20
Jammu and Kashmir,0,9928,312,0,0,0,0,17920,27/07/20
Jharkhand,0,3704,85,0,0,0,0,8275,27/07/20
Karnataka,0,35838,1878,0,0,0,0,96141,27/07/20
Kerala,0,9300,61,0,0,0,0,19025,27/07/20
Ladakh,0,1063,4,0,0,0,0,1285,27/07/20
Madhya Pradesh,0,19132,811,0,0,0,0,27800,27/07/20
Maharashtra,0,213238,13656,0,0,0,0,375799,27/07/20
Manipur,0,1554,0,0,0,0,0,2235,27/07/20
Meghalaya,0,135,5,0,0,0,0,702,27/07/20
Mizoram,0,193,0,0,0,0,0,361,27/07/20
Nagaland,0,549,4,0,0,0,0,1339,27/07/20
Odisha,0,16793,140,0,0,0,0,25389,27/07/20
Puducherry,0,1645,40,0,0,0,0,2786,27/07/20
Punjab,0,8810,306,0,0,0,0,13218,27/07/20
Rajasthan,0,25353,621,0,0,0,0,35909,27/07/20
Sikkim,0,148,0,0,0,0,0,545,27/07/20
Tamil Nadu,0,156526,3494,0,0,0,0,213723,27/07/20
Telangana,0,41332,463,0,0,0,0,54059,27/07/20
Tripura,0,2361,13,0,0,0,0,3900,27/07/20
Uttarakhand,0,3566,63,0,0,0,0,6104,27/07/20
Uttar Pradesh,0,41641,1426,0,0,0,0,66988,27/07/20
West Bengal,0,37751,1372,0,0,0,0,58718,27/07/20
Andaman and Nicobar Islands,0,192,1,0,0,0,0,338,28/07/20
Andhra Pradesh,0,49558,1090,0,0,0,0,102349,28/07/20
Arunachal Pradesh,0,574,3,0,0,0,0,1239,28/07/20
Assam,0,25402,86,0,0,0,0,33576,28/07/20
Bihar,0,27530,253,0,0,0,0,41244,28/07/20
Chandigarh,0,575,14,0,0,0,0,910,28/07/20
Chhattisgarh,0,5172,44,0,0,0,0,7745,28/07/20
Dadra and Nagar Haveli and Daman and Diu,0,564,2,0,0,0,0,946,28/07/20
Delhi,0,116372,3853,0,0,0,0,131219,28/07/20
Goa,0,3410,36,0,0,0,0,5119,28/07/20
Gujarat,0,41380,2348,0,0,0,0,56874,28/07/20
Haryana,0,25046,397,0,0,0,0,32127,28/07/20
Himachal Pradesh,0,1216,14,0,0,0,0,2270,28/07/20
Jammu and Kashmir,0,10402,321,0,0,0,0,18390,28/07/20
Jharkhand,0,3770,89,0,0,0,0,8683,28/07/20
Karnataka,0,37685,1953,0,0,0,0,101465,28/07/20
Kerala,0,10045,63,0,0,0,0,19727,28/07/20
Ladakh,0,1066,4,0,0,0,0,1306,28/07/20
Madhya Pradesh,0,19791,820,0,0,0,0,28589,28/07/20
Maharashtra,0,221944,13883,0,0,0,0,383723,28/07/20
Manipur,0,1596,0,0,0,0,0,2286,28/07/20
Meghalaya,0,186,5,0,0,0,0,738,28/07/20
Mizoram,0,193,0,0,0,0,0,384,28/07/20
Nagaland,0,569,5,0,0,0,0,1385,28/07/20
Odisha,0,17374,147,0,0,0,0,26892,28/07/20
Puducherry,0,1720,43,0,0,0,0,2872,28/07/20
Punjab,0,9064,318,0,0,0,0,13769,28/07/20
Rajasthan,0,26123,631,0,0,0,0,36878,28/07/20
Sikkim,0,174,1,0,0,0,0,555,28/07/20
Tamil Nadu,0,162249,3571,0,0,0,0,220716,28/07/20
Telengana,0,42909,480,0,0,0,0,57142,28/07/20
Tripura,0,2467,17,0,0,0,0,4049,28/07/20
Uttarakhand,0,3675,66,0,0,0,0,6328,28/07/20
Uttar Pradesh,0,42833,1456,0,0,0,0,70493,28/07/20
West Bengal,0,39917,1411,0,0,0,0,60830,28/07/20
Andaman and Nicobar Islands,0,196,1,0,0,0,0,363,29/07/20
Andhra Pradesh,0,52622,1148,0,0,0,0,110297,29/07/20
Arunachal Pradesh,0,617,3,0,0,0,0,1330,29/07/20
Assam,0,26618,88,0,0,0,0,34947,29/07/20
Bihar,0,28856,269,0,0,0,0,43843,29/07/20
Chandigarh,0,599,14,0,0,0,0,934,29/07/20
Chhattisgarh,0,5439,46,0,0,0,0,8257,29/07/20
Dadra and Nagar Haveli and Daman and Diu,0,596,2,0,0,0,0,982,29/07/20
Delhi,0,117507,3881,0,0,0,0,132275,29/07/20
Goa,0,3595,36,0,0,0,0,5287,29/07/20
Gujarat,0,42412,2372,0,0,0,0,57982,29/07/20
Haryana,0,25758,406,0,0,0,0,32876,29/07/20
Himachal Pradesh,0,1234,14,0,0,0,0,2330,29/07/20
Jammu and Kashmir,0,10885,333,0,0,0,0,18879,29/07/20
Jharkhand,0,3868,89,0,0,0,0,9078,29/07/20
Karnataka,0,40504,2055,0,0,0,0,107001,29/07/20
Kerala,0,10724,67,0,0,0,0,20894,29/07/20
Ladakh,0,1067,6,0,0,0,0,1327,29/07/20
Madhya Pradesh,0,20343,830,0,0,0,0,29217,29/07/20
Maharashtra,0,232277,14165,0,0,0,0,391440,29/07/20
Manipur,0,1612,0,0,0,0,0,2317,29/07/20
Meghalaya,0,194,5,0,0,0,0,779,29/07/20
Mizoram,0,198,0,0,0,0,0,384,29/07/20
Nagaland,0,577,5,0,0,0,0,1460,29/07/20
Odisha,0,18061,154,0,0,0,0,28107,29/07/20
Puducherry,0,1782,47,0,0,0,0,3011,29/07/20
Punjab,0,9752,336,0,0,0,0,14378,29/07/20
Rajasthan,0,27202,644,0,0,0,0,38514,29/07/20
Sikkim,0,186,1,0,0,0,0,579,29/07/20
Tamil Nadu,0,166956,3659,0,0,0,0,227688,29/07/20
Telengana***,0,42909,480,0,0,0,0,57142,29/07/20
Tripura,0,2621,21,0,0,0,0,4269,29/07/20
Uttarakhand,0,3720,70,0,0,0,0,6587,29/07/20
Uttar Pradesh,0,44520,1497,0,0,0,0,73951,29/07/20
West Bengal,0,42022,1449,0,0,0,0,62964,29/07/20
Andaman and Nicobar Islands,0,201,2,0,0,0,0,428,30/07/20
Andhra Pradesh,0,55406,1213,0,0,0,0,120390,30/07/20
Arunachal Pradesh,0,677,3,0,0,0,0,1410,30/07/20
Assam,0,27832,92,0,0,0,0,36295,30/07/20
Bihar,0,30320,278,0,0,0,0,46080,30/07/20
Chandigarh,0,611,14,0,0,0,0,978,30/07/20
Chhattisgarh,0,5636,48,0,0,0,0,8539,30/07/20
Dadra and Nagar Haveli and Daman and Diu,0,648,2,0,0,0,0,1026,30/07/20
Delhi,0,118633,3907,0,0,0,0,133310,30/07/20
Goa,0,3784,39,0,0,0,0,5489,30/07/20
Gujarat,0,43195,2396,0,0,0,0,59126,30/07/20
Haryana,0,26420,413,0,0,0,0,33631,30/07/20
Himachal Pradesh,0,1332,14,0,0,0,0,2403,30/07/20
Jammu and Kashmir,0,11322,348,0,0,0,0,19419,30/07/20
Jharkhand,0,4035,98,0,0,0,0,9861,30/07/20
Karnataka,0,42901,2147,0,0,0,0,112504,30/07/20
Kerala,0,11365,68,0,0,0,0,21797,30/07/20
Ladakh,0,1080,6,0,0,0,0,1347,30/07/20
Madhya Pradesh,0,20934,843,0,0,0,0,30134,30/07/20
Maharashtra,0,239755,14463,0,0,0,0,400651,30/07/20
Manipur,0,1639,0,0,0,0,0,2458,30/07/20
Meghalaya,0,207,5,0,0,0,0,784,30/07/20
Mizoram,0,215,0,0,0,0,0,398,30/07/20
Nagaland,0,595,5,0,0,0,0,1513,30/07/20
Odisha,0,18939,159,0,0,0,0,29175,30/07/20
Puducherry,0,1874,47,0,0,0,0,3177,30/07/20
Punjab,0,10213,361,0,0,0,0,14946,30/07/20
Rajasthan,0,27569,650,0,0,0,0,38964,30/07/20
Sikkim,0,198,1,0,0,0,0,596,30/07/20
Tamil Nadu,0,172883,3741,0,0,0,0,234114,30/07/20
Telengana,0,43751,492,0,0,0,0,58906,30/07/20
Tripura,0,2678,21,0,0,0,0,4485,30/07/20
Uttarakhand,0,3811,72,0,0,0,0,6866,30/07/20
Uttar Pradesh,0,45807,1530,0,0,0,0,77334,30/07/20
West Bengal,0,44116,1490,0,0,0,0,65258,30/07/20
Andaman and Nicobar Islands,0,201,4,0,0,0,0,471,31/07/20
Andhra Pradesh,0,60024,1281,0,0,0,0,130557,31/07/20
Arunachal Pradesh,0,827,3,0,0,0,0,1484,31/07/20
Assam,0,29080,94,0,0,0,0,38407,31/07/20
Bihar,0,31350,282,0,0,0,0,48477,31/07/20
Chandigarh,0,647,14,0,0,0,0,1016,31/07/20
Chhattisgarh,0,5921,51,0,0,0,0,8761,31/07/20
Dadra and Nagar Haveli and Daman and Diu,0,668,2,0,0,0,0,1064,31/07/20
Delhi,0,119724,3936,0,0,0,0,134403,31/07/20
Goa,0,4005,42,0,0,0,0,5704,31/07/20
Gujarat,0,44074,2418,0,0,0,0,60285,31/07/20
Haryana,0,27340,417,0,0,0,0,34254,31/07/20
Himachal Pradesh,0,1387,14,0,0,0,0,2506,31/07/20
Jammu and Kashmir,0,11842,365,0,0,0,0,19869,31/07/20
Jharkhand,0,4176,103,0,0,0,0,10167,31/07/20
Karnataka,0,46694,2230,0,0,0,0,118632,31/07/20
Kerala,0,12159,70,0,0,0,0,22303,31/07/20
Ladakh,0,1094,7,0,0,0,0,1378,31/07/20
Madhya Pradesh,0,21657,857,0,0,0,0,30968,31/07/20
Maharashtra,0,248615,14729,0,0,0,0,411798,31/07/20
Manipur,0,1672,4,0,0,0,0,2505,31/07/20
Meghalaya,0,210,5,0,0,0,0,803,31/07/20
Mizoram,0,234,0,0,0,0,0,408,31/07/20
Nagaland,0,625,5,0,0,0,0,1566,31/07/20
Odisha,0,19746,169,0,0,0,0,30378,31/07/20
Puducherry,0,1958,48,0,0,0,0,3298,31/07/20
Punjab,0,10509,370,0,0,0,0,15456,31/07/20
Rajasthan,0,28385,663,0,0,0,0,40145,31/07/20
Sikkim,0,214,1,0,0,0,0,610,31/07/20
Tamil Nadu,0,178178,3838,0,0,0,0,239978,31/07/20
Telengana,0,44572,505,0,0,0,0,60717,31/07/20
Tripura,0,2962,21,0,0,0,0,4706,31/07/20
Uttarakhand,0,3996,76,0,0,0,0,7065,31/07/20
Uttar Pradesh,0,46803,1587,0,0,0,0,81039,31/07/20
West Bengal,0,46256,1536,0,0,0,0,67692,31/07/20
Andaman and Nicobar Islands,0,214,5,0,0,0,0,548,01/08/20
Andhra Pradesh,0,63864,1349,0,0,0,0,140933,01/08/20
Arunachal Pradesh,0,918,3,0,0,0,0,1591,01/08/20
Assam,0,30357,98,0,0,0,0,40269,01/08/20
Bihar,0,33358,296,0,0,0,0,51233,01/08/20
Chandigarh,0,667,15,0,0,0,0,1051,01/08/20
Chhattisgarh,0,6230,53,0,0,0,0,9086,01/08/20
Dadra and Nagar Haveli and Daman and Diu,0,686,2,0,0,0,0,1100,01/08/20
Delhi,0,120930,3963,0,0,0,0,135598,01/08/20
Goa,0,4211,45,0,0,0,0,5913,01/08/20
Gujarat,0,44907,2441,0,0,0,0,61438,01/08/20
Haryana,0,28227,421,0,0,0,0,34965,01/08/20
Himachal Pradesh,0,1459,14,0,0,0,0,2564,01/08/20
Jammu and Kashmir,0,12217,377,0,0,0,0,20359,01/08/20
Jharkhand,0,4314,106,0,0,0,0,10958,01/08/20
Karnataka,0,49788,2314,0,0,0,0,124115,01/08/20
Kerala,0,13023,73,0,0,0,0,23613,01/08/20
Ladakh,0,1095,7,0,0,0,0,1404,01/08/20
Madhya Pradesh,0,22271,867,0,0,0,0,31806,01/08/20
Maharashtra,0,256158,14994,0,0,0,0,422118,01/08/20
Manipur,0,1689,5,0,0,0,0,2621,01/08/20
Meghalaya,0,215,5,0,0,0,0,823,01/08/20
Mizoram,0,247,0,0,0,0,0,412,01/08/20
Nagaland,0,635,5,0,0,0,0,1693,01/08/20
Odisha,0,20518,177,0,0,0,0,31877,01/08/20
Puducherry,0,2100,49,0,0,0,0,3472,01/08/20
Punjab,0,10734,386,0,0,0,0,16119,01/08/20
Rajasthan,0,29035,674,0,0,0,0,41298,01/08/20
Sikkim,0,231,1,0,0,0,0,639,01/08/20
Tamil Nadu,0,183956,3935,0,0,0,0,245859,01/08/20
Telengana,0,45388,519,0,0,0,0,62703,01/08/20
Tripura,0,3327,21,0,0,0,0,4978,01/08/20
Uttarakhand,0,4168,80,0,0,0,0,7183,01/08/20
Uttar Pradesh,0,48863,1630,0,0,0,0,85461,01/08/20
West Bengal,0,48374,1581,0,0,0,0,70188,01/08/20
Andaman and Nicobar Islands,0,226,7,0,0,0,0,636,02/08/20
Andhra Pradesh,0,76614,1407,0,0,0,0,150209,02/08/20
Arunachal Pradesh,0,969,3,0,0,0,0,1673,02/08/20
Assam,0,31442,101,0,0,0,0,41726,02/08/20
Bihar,0,34994,309,0,0,0,0,54240,02/08/20
Chandigarh,0,683,18,0,0,0,0,1079,02/08/20
Chhattisgarh,0,6610,55,0,0,0,0,9385,02/08/20
Dadra and Nagar Haveli and Daman and Diu,0,725,2,0,0,0,0,1145,02/08/20
Delhi,0,122131,3989,0,0,0,0,136716,02/08/20
Goa,0,4438,48,0,0,0,0,6193,02/08/20
Gujarat,0,45699,2464,0,0,0,0,62463,02/08/20
Haryana,0,29080,428,0,0,0,0,35758,02/08/20
Himachal Pradesh,0,1502,14,0,0,0,0,2634,02/08/20
Jammu and Kashmir,0,12871,388,0,0,0,0,20972,02/08/20
Jharkhand,0,4513,113,0,0,0,0,11686,02/08/20
Karnataka,0,53648,2412,0,0,0,0,129287,02/08/20
Kerala,0,13775,81,0,0,0,0,24742,02/08/20
Ladakh,0,1108,7,0,0,0,0,1462,02/08/20
Madhya Pradesh,0,22969,876,0,0,0,0,32614,02/08/20
Maharashtra,0,266883,15316,0,0,0,0,431719,02/08/20
Manipur,0,1699,6,0,0,0,0,2756,02/08/20
Meghalaya,0,252,5,0,0,0,0,856,02/08/20
Mizoram,0,253,0,0,0,0,0,468,02/08/20
Nagaland,0,640,5,0,0,0,0,1831,02/08/20
Odisha,0,21274,187,0,0,0,0,33479,02/08/20
Puducherry,0,2198,51,0,0,0,0,3606,02/08/20
Punjab,0,11075,405,0,0,0,0,17063,02/08/20
Rajasthan,0,29977,690,0,0,0,0,42646,02/08/20
Sikkim,0,269,1,0,0,0,0,650,02/08/20
Tamil Nadu,0,190966,4034,0,0,0,0,251738,02/08/20
Telengana,0,46502,530,0,0,0,0,64786,02/08/20
Tripura,0,3463,23,0,0,0,0,5233,02/08/20
Uttarakhand,0,4330,83,0,0,0,0,7447,02/08/20
Uttar Pradesh,0,51334,1677,0,0,0,0,89048,02/08/20
West Bengal,0,50517,1629,0,0,0,0,72777,02/08/20
Andaman and Nicobar Islands,0,242,8,0,0,0,0,734,03/08/20
Andhra Pradesh,0,82886,1474,0,0,0,0,158764,03/08/20
Arunachal Pradesh,0,996,3,0,0,0,0,1698,03/08/20
Assam,0,32384,105,0,0,0,0,42904,03/08/20
Bihar,0,36389,329,0,0,0,0,57024,03/08/20
Chandigarh,0,698,19,0,0,0,0,1117,03/08/20
Chhattisgarh,0,6991,58,0,0,0,0,9531,03/08/20
Dadra and Nagar Haveli and Daman and Diu,0,766,2,0,0,0,0,1184,03/08/20
Delhi,0,123317,4004,0,0,0,0,137677,03/08/20
Goa,0,4668,53,0,0,0,0,6530,03/08/20
Gujarat,0,46504,2486,0,0,0,0,63562,03/08/20
Haryana,0,29690,433,0,0,0,0,36519,03/08/20
Himachal Pradesh,0,1559,14,0,0,0,0,2703,03/08/20
Jammu and Kashmir,0,13127,396,0,0,0,0,21416,03/08/20
Jharkhand,0,4682,118,0,0,0,0,12523,03/08/20
Karnataka,0,57725,2496,0,0,0,0,134819,03/08/20
Kerala,0,14463,82,0,0,0,0,25911,03/08/20
Ladakh,0,1108,7,0,0,0,0,1466,03/08/20
Madhya Pradesh,0,23550,886,0,0,0,0,33535,03/08/20
Maharashtra,0,276809,15576,0,0,0,0,441228,03/08/20
Manipur,0,1737,7,0,0,0,0,2831,03/08/20
Meghalaya,0,264,5,0,0,0,0,874,03/08/20
Mizoram,0,258,0,0,0,0,0,482,03/08/20
Nagaland,0,648,5,0,0,0,0,1935,03/08/20
Odisha,0,21955,197,0,0,0,0,34913,03/08/20
Puducherry,0,2309,52,0,0,0,0,3806,03/08/20
Punjab,0,11466,423,0,0,0,0,17853,03/08/20
Rajasthan,0,30710,703,0,0,0,0,43804,03/08/20
Sikkim,0,289,1,0,0,0,0,658,03/08/20
Tamil Nadu,0,196483,4132,0,0,0,0,257613,03/08/20
Telengana,0,47590,540,0,0,0,0,66677,03/08/20
Tripura,0,3605,27,0,0,0,0,5374,03/08/20
Uttarakhand,0,4437,86,0,0,0,0,7593,03/08/20
Uttar Pradesh,0,53168,1730,0,0,0,0,92921,03/08/20
West Bengal,0,52730,1678,0,0,0,0,75516,03/08/20
Andaman and Nicobar Islands,0,263,10,0,0,0,0,830,04/08/20
Andhra Pradesh,0,88672,1537,0,0,0,0,166586,04/08/20
Arunachal Pradesh,0,1063,3,0,0,0,0,1758,04/08/20
Assam,0,33428,109,0,0,0,0,45275,04/08/20
Bihar,0,38228,330,0,0,0,0,59328,04/08/20
Chandigarh,0,706,19,0,0,0,0,1159,04/08/20
Chhattisgarh,0,7256,61,0,0,0,0,9779,04/08/20
Dadra and Nagar Haveli and Daman and Diu,0,860,2,0,0,0,0,1274,04/08/20
Delhi,0,124254,4021,0,0,0,0,138482,04/08/20
Goa,0,4876,56,0,0,0,0,6816,04/08/20
Gujarat,0,47478,2508,0,0,0,0,64585,04/08/20
Haryana,0,30470,440,0,0,0,0,37173,04/08/20
Himachal Pradesh,0,1658,14,0,0,0,0,2818,04/08/20
Jammu and Kashmir,0,14032,407,0,0,0,0,22006,04/08/20
Jharkhand,0,4792,125,0,0,0,0,13478,04/08/20
Karnataka,0,62500,2594,0,0,0,0,139571,04/08/20
Kerala,0,15278,84,0,0,0,0,26873,04/08/20
Ladakh,0,1109,7,0,0,0,0,1485,04/08/20
Madhya Pradesh,0,24099,900,0,0,0,0,34285,04/08/20
Maharashtra,0,287030,15842,0,0,0,0,450196,04/08/20
Manipur,0,1766,7,0,0,0,0,2920,04/08/20
Meghalaya,0,264,5,0,0,0,0,902,04/08/20
Mizoram,0,266,0,0,0,0,0,501,04/08/20
Nagaland,0,657,5,0,0,0,0,2129,04/08/20
Odisha,0,23074,207,0,0,0,0,36297,04/08/20
Puducherry,0,2411,56,0,0,0,0,3982,04/08/20
Punjab,0,11882,442,0,0,0,0,18527,04/08/20
Rajasthan,0,31458,715,0,0,0,0,44975,04/08/20
Sikkim,0,297,1,0,0,0,0,688,04/08/20
Tamil Nadu,0,202283,4241,0,0,0,0,263222,04/08/20
Telengana,0,49675,563,0,0,0,0,68946,04/08/20
Tripura,0,3675,28,0,0,0,0,5505,04/08/20
Uttarakhand,0,4538,90,0,0,0,0,7800,04/08/20
Uttar Pradesh,0,55393,1778,0,0,0,0,97362,04/08/20
West Bengal,0,54818,1731,0,0,0,0,78232,04/08/20
Andaman and Nicobar Islands,0,277,12,0,0,0,0,928,05/08/20
Andhra Pradesh,0,95625,1604,0,0,0,0,176333,05/08/20
Arunachal Pradesh,0,1105,3,0,0,0,0,1790,05/08/20
Assam,0,34421,115,0,0,0,0,48161,05/08/20
Bihar,0,40348,347,0,0,0,0,61788,05/08/20
Chandigarh,0,715,20,0,0,0,0,1206,05/08/20
Chhattisgarh,0,7613,69,0,0,0,0,10202,05/08/20
Dadra and Nagar Haveli and Daman and Diu,0,919,2,0,0,0,0,1325,05/08/20
Delhi,0,125226,4033,0,0,0,0,139156,05/08/20
Goa,0,5114,60,0,0,0,0,7075,05/08/20
Gujarat,0,48376,2533,0,0,0,0,65599,05/08/20
Haryana,0,31226,448,0,0,0,0,37796,05/08/20
Himachal Pradesh,0,1710,14,0,0,0,0,2879,05/08/20
Jammu and Kashmir,0,14856,417,0,0,0,0,22396,05/08/20
Jharkhand,0,5164,128,0,0,0,0,13940,05/08/20
Karnataka,0,69272,2704,0,0,0,0,145830,05/08/20
Kerala,0,16299,87,0,0,0,0,27956,05/08/20
Ladakh,0,1127,7,0,0,0,0,1534,05/08/20
Madhya Pradesh,0,25414,912,0,0,0,0,35082,05/08/20
Maharashtra,0,299356,16142,0,0,0,0,457956,05/08/20
Manipur,0,1814,7,0,0,0,0,3018,05/08/20
Meghalaya,0,330,5,0,0,0,0,917,05/08/20
Mizoram,0,282,0,0,0,0,0,504,05/08/20
Nagaland,0,659,5,0,0,0,0,2405,05/08/20
Odisha,0,24483,216,0,0,0,0,37681,05/08/20
Puducherry,0,2537,58,0,0,0,0,4147,05/08/20
Punjab,0,12491,462,0,0,0,0,19015,05/08/20
Rajasthan,0,32832,732,0,0,0,0,46679,05/08/20
Sikkim,0,299,1,0,0,0,0,783,05/08/20
Tamil Nadu,0,208784,4349,0,0,0,0,268285,05/08/20
Telengana,0,50814,576,0,0,0,0,70958,05/08/20
Tripura,0,3725,30,0,0,0,0,5628,05/08/20
Uttarakhand,0,4847,95,0,0,0,0,8008,05/08/20
Uttar Pradesh,0,57271,1817,0,0,0,0,100310,05/08/20
West Bengal,0,56884,1785,0,0,0,0,80984,05/08/20
Andaman and Nicobar Islands,0,326,14,0,0,0,0,1027,06/08/20
Andhra Pradesh,0,104354,1681,0,0,0,0,186461,06/08/20
Arunachal Pradesh,0,1210,3,0,0,0,0,1855,06/08/20
Assam,0,35892,121,0,0,0,0,50445,06/08/20
Bihar,0,42414,355,0,0,0,0,64770,06/08/20
Chandigarh,0,715,20,0,0,0,0,1270,06/08/20
Chhattisgarh,0,7871,71,0,0,0,0,10407,06/08/20
Dadra and Nagar Haveli and Daman and Diu,0,960,2,0,0,0,0,1366,06/08/20
Delhi,0,126116,4044,0,0,0,0,140232,06/08/20
Goa,0,5287,64,0,0,0,0,7423,06/08/20
Gujarat,0,49433,2556,0,0,0,0,66669,06/08/20
Haryana,0,31960,455,0,0,0,0,38548,06/08/20
Himachal Pradesh,0,1762,14,0,0,0,0,2916,06/08/20
Jammu and Kashmir,0,15244,426,0,0,0,0,22955,06/08/20
Jharkhand,0,5703,136,0,0,0,0,14888,06/08/20
Karnataka,0,74679,2804,0,0,0,0,151449,06/08/20
Kerala,0,17533,94,0,0,0,0,29151,06/08/20
Ladakh,0,1164,7,0,0,0,0,1592,06/08/20
Madhya Pradesh,0,26064,929,0,0,0,0,35734,06/08/20
Maharashtra,0,305521,16476,0,0,0,0,468265,06/08/20
Manipur,0,1862,7,0,0,0,0,3093,06/08/20
Meghalaya,0,330,5,0,0,0,0,929,06/08/20
Mizoram,0,286,0,0,0,0,0,537,06/08/20
Nagaland,0,685,6,0,0,0,0,2498,06/08/20
Odisha,0,25738,225,0,0,0,0,39018,06/08/20
Puducherry,0,2668,65,0,0,0,0,4433,06/08/20
Punjab,0,12943,491,0,0,0,0,19856,06/08/20
Rajasthan,0,33849,745,0,0,0,0,47272,06/08/20
Sikkim,0,303,1,0,0,0,0,800,06/08/20
Tamil Nadu,0,214815,4461,0,0,0,0,273460,06/08/20
Telengana,0,52103,589,0,0,0,0,73050,06/08/20
Tripura,0,3793,31,0,0,0,0,5725,06/08/20
Uttarakhand,0,5233,98,0,0,0,0,8254,06/08/20
Uttar Pradesh,0,60558,1857,0,0,0,0,104388,06/08/20
West Bengal,0,58962,1846,0,0,0,0,83800,06/08/20
Andaman and Nicobar Islands,0,355,16,0,0,0,0,1123,07/08/20
Andhra Pradesh,0,112870,1753,0,0,0,0,196789,07/08/20
Arunachal Pradesh,0,1245,3,0,0,0,0,1948,07/08/20
Assam,0,37224,126,0,0,0,0,52817,07/08/20
Bihar,0,43537,363,0,0,0,0,67788,07/08/20
Chandigarh,0,777,20,0,0,0,0,1327,07/08/20
Chhattisgarh,0,8088,77,0,0,0,0,10932,07/08/20
Dadra and Nagar Haveli and Daman and Diu,0,973,2,0,0,0,0,1391,07/08/20
Delhi,0,127124,4059,0,0,0,0,141531,07/08/20
Goa,0,5453,66,0,0,0,0,7614,07/08/20
Gujarat,0,50350,2583,0,0,0,0,67699,07/08/20
Haryana,0,32640,458,0,0,0,0,39303,07/08/20
Himachal Pradesh,0,1865,14,0,0,0,0,3047,07/08/20
Jammu and Kashmir,0,15708,436,0,0,0,0,23454,07/08/20
Jharkhand,0,6594,145,0,0,0,0,15756,07/08/20
Karnataka,0,80281,2897,0,0,0,0,158254,07/08/20
Kerala,0,18333,97,0,0,0,0,30449,07/08/20
Ladakh,0,1177,7,0,0,0,0,1595,07/08/20
Madhya Pradesh,0,26902,946,0,0,0,0,36564,07/08/20
Maharashtra,0,316375,16792,0,0,0,0,479779,07/08/20
Manipur,0,1905,8,0,0,0,0,3217,07/08/20
Meghalaya,0,345,5,0,0,0,0,990,07/08/20
Mizoram,0,288,0,0,0,0,0,539,07/08/20
Nagaland,0,819,6,0,0,0,0,2580,07/08/20
Odisha,0,26888,235,0,0,0,0,40717,07/08/20
Puducherry,0,2808,70,0,0,0,0,4621,07/08/20
Punjab,0,13659,517,0,0,0,0,20891,07/08/20
Rajasthan,0,35131,757,0,0,0,0,48996,07/08/20
Sikkim,0,353,1,0,0,0,0,829,07/08/20
Tamil Nadu,0,221087,4571,0,0,0,0,279144,07/08/20
Telengana,0,53239,601,0,0,0,0,75257,07/08/20
Tripura,0,3860,36,0,0,0,0,5853,07/08/20
Uttarakhand,0,5427,98,0,0,0,0,8552,07/08/20
Uttar Pradesh,0,63402,1918,0,0,0,0,108974,07/08/20
West Bengal,0,61023,1902,0,0,0,0,86754,07/08/20
Andaman and Nicobar Islands,0,425,19,0,0,0,0,1222,08/08/20
Andhra Pradesh,0,120464,1842,0,0,0,0,206960,08/08/20
Arunachal Pradesh,0,1326,3,0,0,0,0,2049,08/08/20
Assam,0,38809,132,0,0,0,0,55496,08/08/20
Bihar,0,44482,369,0,0,0,0,71304,08/08/20
Chandigarh,0,820,23,0,0,0,0,1374,08/08/20
Chhattisgarh,0,8319,87,0,0,0,0,11408,08/08/20
Dadra and Nagar Haveli and Daman and Diu,0,1014,2,0,0,0,0,1437,08/08/20
Delhi,0,128232,4082,0,0,0,0,142723,08/08/20
Goa,0,5595,70,0,0,0,0,7947,08/08/20
Gujarat,0,51720,2605,0,0,0,0,68768,08/08/20
Haryana,0,33444,467,0,0,0,0,40054,08/08/20
Himachal Pradesh,0,1954,14,0,0,0,0,3150,08/08/20
Jammu and Kashmir,0,16218,449,0,0,0,0,23927,08/08/20
Jharkhand,0,7391,151,0,0,0,0,16465,08/08/20
Karnataka,0,84232,2998,0,0,0,0,164924,08/08/20
Kerala,0,19147,102,0,0,0,0,31700,08/08/20
Ladakh,0,1194,9,0,0,0,0,1614,08/08/20
Madhya Pradesh,0,27621,962,0,0,0,0,37298,08/08/20
Maharashtra,0,327281,17092,0,0,0,0,490262,08/08/20
Manipur,0,1926,10,0,0,0,0,3466,08/08/20
Meghalaya,0,411,5,0,0,0,0,1006,08/08/20
Mizoram,0,289,0,0,0,0,0,566,08/08/20
Nagaland,0,824,7,0,0,0,0,2657,08/08/20
Odisha,0,28698,247,0,0,0,0,42550,08/08/20
Puducherry,0,2914,75,0,0,0,0,4862,08/08/20
Punjab,0,14040,539,0,0,0,0,21930,08/08/20
Rajasthan,0,36195,767,0,0,0,0,50157,08/08/20
Sikkim,0,406,1,0,0,0,0,854,08/08/20
Tamil Nadu,0,227575,4690,0,0,0,0,285024,08/08/20
Telengana,0,54330,615,0,0,0,0,77513,08/08/20
Tripura,0,4084,37,0,0,0,0,5999,08/08/20
Uttarakhand,0,5731,112,0,0,0,0,8901,08/08/20
Uttar Pradesh,0,66834,1981,0,0,0,0,113378,08/08/20
West Bengal,0,63060,1954,0,0,0,0,89666,08/08/20
Andaman and Nicobar Islands,0,500,20,0,0,0,0,1351,09/08/20
Andhra Pradesh,0,129615,1939,0,0,0,0,217040,09/08/20
Arunachal Pradesh,0,1430,3,0,0,0,0,2117,09/08/20
Assam,0,40591,140,0,0,0,0,57714,09/08/20
Bihar,0,48243,382,0,0,0,0,75294,09/08/20
Chandigarh,0,872,24,0,0,0,0,1426,09/08/20
Chhattisgarh,0,8582,89,0,0,0,0,11743,09/08/20
Dadra and Nagar Haveli and Daman and Diu,0,1037,2,0,0,0,0,1456,09/08/20
Delhi,0,129362,4098,0,0,0,0,144127,09/08/20
Goa,0,5802,72,0,0,0,0,8206,09/08/20
Gujarat,0,52855,2628,0,0,0,0,69869,09/08/20
Haryana,0,34031,474,0,0,0,0,40843,09/08/20
Himachal Pradesh,0,2081,14,0,0,0,0,3264,09/08/20
Jammu and Kashmir,0,16667,459,0,0,0,0,24390,09/08/20
Jharkhand,0,8123,155,0,0,0,0,17094,09/08/20
Karnataka,0,89238,3091,0,0,0,0,172102,09/08/20
Kerala,0,20862,106,0,0,0,0,33120,09/08/20
Ladakh,0,1214,9,0,0,0,0,1639,09/08/20
Madhya Pradesh,0,28353,977,0,0,0,0,38157,09/08/20
Maharashtra,0,338362,17367,0,0,0,0,503084,09/08/20
Manipur,0,1927,11,0,0,0,0,3635,09/08/20
Meghalaya,0,423,6,0,0,0,0,1023,09/08/20
Mizoram,0,296,0,0,0,0,0,593,09/08/20
Nagaland,0,896,7,0,0,0,0,2688,09/08/20
Odisha,0,30242,259,0,0,0,0,44193,09/08/20
Puducherry,0,3054,80,0,0,0,0,5123,09/08/20
Punjab,0,14880,562,0,0,0,0,22928,09/08/20
Rajasthan,0,37163,778,0,0,0,0,51328,09/08/20
Sikkim,0,470,1,0,0,0,0,860,09/08/20
Tamil Nadu,0,232618,4808,0,0,0,0,290907,09/08/20
Telengana,0,55999,627,0,0,0,0,79495,09/08/20
Tripura,0,4176,41,0,0,0,0,6146,09/08/20
Uttarakhand,0,5963,117,0,0,0,0,9402,09/08/20
Uttar Pradesh,0,69833,2028,0,0,0,0,118038,09/08/20
West Bengal,0,65124,2005,0,0,0,0,92615,09/08/20
Andaman and Nicobar Islands,0,648,20,0,0,0,0,1490,10/08/20
Andhra Pradesh,0,138712,2036,0,0,0,0,227860,10/08/20
Arunachal Pradesh,0,1482,3,0,0,0,0,2155,10/08/20
Assam,0,42325,145,0,0,0,0,58837,10/08/20
Bihar,0,51158,387,0,0,0,0,79451,10/08/20
Chandigarh,0,904,25,0,0,0,0,1515,10/08/20
Chhattisgarh,0,8809,96,0,0,0,0,12148,10/08/20
Dadra and Nagar Haveli and Daman and Diu,0,1121,2,0,0,0,0,1564,10/08/20
Delhi,0,130587,4111,0,0,0,0,145427,10/08/20
Goa,0,5995,75,0,0,0,0,8712,10/08/20
Gujarat,0,54166,2652,0,0,0,0,70965,10/08/20
Haryana,0,34781,483,0,0,0,0,41635,10/08/20
Himachal Pradesh,0,2181,15,0,0,0,0,3371,10/08/20
Jammu and Kashmir,0,17003,472,0,0,0,0,24897,10/08/20
Jharkhand,0,8838,177,0,0,0,0,18138,10/08/20
Karnataka,0,93908,3198,0,0,0,0,178087,10/08/20
Kerala,0,21832,108,0,0,0,0,34331,10/08/20
Ladakh,0,1222,9,0,0,0,0,1688,10/08/20
Madhya Pradesh,0,29020,996,0,0,0,0,39025,10/08/20
Maharashtra,0,351710,17757,0,0,0,0,515332,10/08/20
Manipur,0,2044,11,0,0,0,0,3753,10/08/20
Meghalaya,0,490,6,0,0,0,0,1062,10/08/20
Mizoram,0,298,0,0,0,0,0,620,10/08/20
Nagaland,0,904,8,0,0,0,0,2781,10/08/20
Odisha,0,31785,272,0,0,0,0,45927,10/08/20
Puducherry,0,3201,87,0,0,0,0,5382,10/08/20
Punjab,0,15319,586,0,0,0,0,23903,10/08/20
Rajasthan,0,38235,789,0,0,0,0,52497,10/08/20
Sikkim,0,494,1,0,0,0,0,866,10/08/20
Tamil Nadu,0,238638,4927,0,0,0,0,296901,10/08/20
Telengana,0,57586,637,0,0,0,0,80751,10/08/20
Tripura,0,4443,42,0,0,0,0,6208,10/08/20
Uttarakhand,0,6134,125,0,0,0,0,9632,10/08/20
Uttar Pradesh,0,72650,2069,0,0,0,0,122609,10/08/20
West Bengal,0,67120,2059,0,0,0,0,95554,10/08/20
Andaman and Nicobar Islands,0,709,20,0,0,0,0,1625,11/08/20
Andhra Pradesh,0,145636,2116,0,0,0,0,235525,11/08/20
Arunachal Pradesh,0,1592,3,0,0,0,0,2231,11/08/20
Assam,0,43586,151,0,0,0,0,61737,11/08/20
Bihar,0,54088,397,0,0,0,0,82550,11/08/20
Chandigarh,0,1004,25,0,0,0,0,1595,11/08/20
Chhattisgarh,0,9013,99,0,0,0,0,12448,11/08/20
Dadra and Nagar Haveli and Daman and Diu,0,1167,2,0,0,0,0,1613,11/08/20
Delhi,0,131657,4131,0,0,0,0,146134,11/08/20
Goa,0,6208,80,0,0,0,0,9029,11/08/20
Gujarat,0,55304,2672,0,0,0,0,72031,11/08/20
Haryana,0,35492,489,0,0,0,0,42429,11/08/20
Himachal Pradesh,0,2205,17,0,0,0,0,3463,11/08/20
Jammu and Kashmir,0,17375,478,0,0,0,0,25367,11/08/20
Jharkhand,0,9724,188,0,0,0,0,18723,11/08/20
Karnataka,0,99126,3312,0,0,0,0,182354,11/08/20
Kerala,0,22616,115,0,0,0,0,35515,11/08/20
Ladakh,0,1237,9,0,0,0,0,1717,11/08/20
Madhya Pradesh,0,29674,1015,0,0,0,0,39891,11/08/20
Maharashtra,0,358421,18050,0,0,0,0,524513,11/08/20
Manipur,0,2122,11,0,0,0,0,3853,11/08/20
Meghalaya,0,498,6,0,0,0,0,1114,11/08/20
Mizoram,0,323,0,0,0,0,0,623,11/08/20
Nagaland,0,973,8,0,0,0,0,3011,11/08/20
Odisha,0,33021,286,0,0,0,0,47455,11/08/20
Puducherry,0,3355,89,0,0,0,0,5624,11/08/20
Punjab,0,15735,604,0,0,0,0,24889,11/08/20
Rajasthan,0,39060,800,0,0,0,0,53670,11/08/20
Sikkim,0,510,1,0,0,0,0,910,11/08/20
Tamil Nadu,0,244675,5041,0,0,0,0,302815,11/08/20
Telengana,0,59374,645,0,0,0,0,82647,11/08/20
Tripura,0,4656,43,0,0,0,0,6372,11/08/20
Uttarakhand,0,6301,134,0,0,0,0,10021,11/08/20
Uttar Pradesh,0,76724,2120,0,0,0,0,126722,11/08/20
West Bengal,0,70328,2100,0,0,0,0,98459,11/08/20
Andaman and Nicobar Islands,0,749,21,0,0,0,0,1764,12/08/20
Andhra Pradesh,0,154749,2203,0,0,0,0,244549,12/08/20
Arunachal Pradesh,0,1634,3,0,0,0,0,2327,12/08/20
Assam,0,45073,155,0,0,0,0,64406,12/08/20
Bihar,0,56709,413,0,0,0,0,86413,12/08/20
Chandigarh,0,1015,26,0,0,0,0,1670,12/08/20
Chhattisgarh,0,9239,104,0,0,0,0,12929,12/08/20
Dadra and Nagar Haveli and Daman and Diu,0,1209,2,0,0,0,0,1653,12/08/20
Delhi,0,132384,4139,0,0,0,0,147391,12/08/20
Goa,0,6480,86,0,0,0,0,9444,12/08/20
Gujarat,0,56444,2695,0,0,0,0,73163,12/08/20
Haryana,0,36082,500,0,0,0,0,43227,12/08/20
Himachal Pradesh,0,2273,18,0,0,0,0,3497,12/08/20
Jammu and Kashmir,0,17979,490,0,0,0,0,25931,12/08/20
Jharkhand,0,10375,192,0,0,0,0,19225,12/08/20
Karnataka,0,105599,3398,0,0,0,0,188611,12/08/20
Kerala,0,24042,120,0,0,0,0,36932,12/08/20
Ladakh,0,1255,9,0,0,0,0,1770,12/08/20
Madhya Pradesh,0,30596,1033,0,0,0,0,40734,12/08/20
Maharashtra,0,368435,18306,0,0,0,0,535601,12/08/20
Manipur,0,2128,12,0,0,0,0,3941,12/08/20
Meghalaya,0,509,6,0,0,0,0,1136,12/08/20
Mizoram,0,323,0,0,0,0,0,648,12/08/20
Nagaland,0,991,8,0,0,0,0,3031,12/08/20
Odisha,0,34806,296,0,0,0,0,48796,12/08/20
Puducherry,0,3532,91,0,0,0,0,5900,12/08/20
Punjab,0,16790,636,0,0,0,0,25889,12/08/20
Rajasthan,0,40399,811,0,0,0,0,54887,12/08/20
Sikkim,0,534,1,0,0,0,0,913,12/08/20
Tamil Nadu,0,250680,5159,0,0,0,0,308649,12/08/20
Telengana,0,61294,654,0,0,0,0,84544,12/08/20
Tripura,0,4838,43,0,0,0,0,6482,12/08/20
Uttarakhand,0,6470,136,0,0,0,0,10432,12/08/20
Uttar Pradesh,0,80589,2176,0,0,0,0,131763,12/08/20
West Bengal,0,73395,2149,0,0,0,0,101390,12/08/20
Andaman and Nicobar Islands,0,829,21,0,0,0,0,1900,13/08/20
Andhra Pradesh,0,161425,2296,0,0,0,0,254146,13/08/20
Arunachal Pradesh,0,1659,3,0,0,0,0,2430,13/08/20
Assam,0,47209,161,0,0,0,0,68999,13/08/20
Bihar,0,59786,416,0,0,0,0,90321,13/08/20
Chandigarh,0,1023,26,0,0,0,0,1751,13/08/20
Chhattisgarh,0,9508,109,0,0,0,0,13498,13/08/20
Dadra and Nagar Haveli and Daman and Diu,0,1248,2,0,0,0,0,1696,13/08/20
Delhi,0,133405,4153,0,0,0,0,148504,13/08/20
Goa,0,6641,89,0,0,0,0,9924,13/08/20
Gujarat,0,57421,2713,0,0,0,0,74318,13/08/20
Haryana,0,36694,503,0,0,0,0,44024,13/08/20
Himachal Pradesh,0,2362,18,0,0,0,0,3636,13/08/20
Jammu and Kashmir,0,18523,498,0,0,0,0,26413,13/08/20
Jharkhand,0,10815,197,0,0,0,0,19743,13/08/20
Karnataka,0,112633,3510,0,0,0,0,196494,13/08/20
Kerala,0,24922,126,0,0,0,0,38144,13/08/20
Ladakh,0,1274,9,0,0,0,0,1811,13/08/20
Madhya Pradesh,0,31239,1048,0,0,0,0,41604,13/08/20
Maharashtra,0,381843,18650,0,0,0,0,548313,13/08/20
Manipur,0,2231,12,0,0,0,0,3982,13/08/20
Meghalaya,0,517,6,0,0,0,0,1179,13/08/20
Mizoram,0,330,0,0,0,0,0,649,13/08/20
Nagaland,0,1113,8,0,0,0,0,3118,13/08/20
Odisha,0,36479,305,0,0,0,0,50672,13/08/20
Puducherry,0,3676,96,0,0,0,0,6381,13/08/20
Punjab,0,17212,675,0,0,0,0,26909,13/08/20
Rajasthan,0,41648,822,0,0,0,0,56100,13/08/20
Sikkim,0,550,1,0,0,0,0,930,13/08/20
Tamil Nadu,0,256313,5278,0,0,0,0,314520,13/08/20
Telengana,0,63074,665,0,0,0,0,86475,13/08/20
Tripura,0,4912,44,0,0,0,0,6603,13/08/20
Uttarakhand,0,6687,140,0,0,0,0,10886,13/08/20
Uttar Pradesh,0,84661,2230,0,0,0,0,136238,13/08/20
West Bengal,0,76120,2203,0,0,0,0,104326,13/08/20
Andaman and Nicobar Islands,0,924,22,0,0,0,0,2037,14/08/20
Andhra Pradesh,0,170984,2378,0,0,0,0,264142,14/08/20
Arunachal Pradesh,0,1718,4,0,0,0,0,2512,14/08/20
Assam,0,49383,169,0,0,0,0,71795,14/08/20
Bihar,0,62284,426,0,0,0,0,94193,14/08/20
Chandigarh,0,1076,27,0,0,0,0,1842,14/08/20
Chhattisgarh,0,9658,114,0,0,0,0,13937,14/08/20
Dadra and Nagar Haveli and Daman and Diu,0,1292,2,0,0,0,0,1752,14/08/20
Delhi,0,134318,4167,0,0,0,0,149460,14/08/20
Goa,0,6912,91,0,0,0,0,10494,14/08/20
Gujarat,0,58467,2731,0,0,0,0,75408,14/08/20
Haryana,0,37486,511,0,0,0,0,44817,14/08/20
Himachal Pradesh,0,2435,19,0,0,0,0,3816,14/08/20
Jammu and Kashmir,0,19302,509,0,0,0,0,26949,14/08/20
Jharkhand,0,12844,209,0,0,0,0,20881,14/08/20
Karnataka,0,121242,3613,0,0,0,0,203200,14/08/20
Kerala,0,25688,129,0,0,0,0,39708,14/08/20
Ladakh,0,1282,9,0,0,0,0,1849,14/08/20
Madhya Pradesh,0,31835,1065,0,0,0,0,42618,14/08/20
Maharashtra,0,390958,19063,0,0,0,0,560126,14/08/20
Manipur,0,2295,13,0,0,0,0,4112,14/08/20
Meghalaya,0,547,6,0,0,0,0,1193,14/08/20
Mizoram,0,343,0,0,0,0,0,649,14/08/20
Nagaland,0,1139,8,0,0,0,0,3168,14/08/20
Odisha,0,37901,314,0,0,0,0,52653,14/08/20
Puducherry,0,3828,102,0,0,0,0,6680,14/08/20
Punjab,0,17839,706,0,0,0,0,27936,14/08/20
Rajasthan,0,41819,833,0,0,0,0,57414,14/08/20
Sikkim,0,581,1,0,0,0,0,931,14/08/20
Tamil Nadu,0,261459,5397,0,0,0,0,320355,14/08/20
Telengana,0,64284,674,0,0,0,0,88396,14/08/20
Tripura,0,5015,46,0,0,0,0,6767,14/08/20
Uttarakhand,0,7014,143,0,0,0,0,11302,14/08/20
Uttar Pradesh,0,88786,2280,0,0,0,0,140775,14/08/20
West Bengal,0,78617,2259,0,0,0,0,107323,14/08/20
Andaman and Nicobar Islands,0,1032,24,0,0,0,0,2186,15/08/20
Andhra Pradesh,0,180703,2475,0,0,0,0,273085,15/08/20
Arunachal Pradesh,0,1750,5,0,0,0,0,2607,15/08/20
Assam,0,51693,175,0,0,0,0,74501,15/08/20
Bihar,0,64930,442,0,0,0,0,98008,15/08/20
Chandigarh,0,1091,28,0,0,0,0,1928,15/08/20
Chhattisgarh,0,9857,130,0,0,0,0,14481,15/08/20
Dadra and Nagar Haveli and Daman and Diu,0,1331,2,0,0,0,0,1797,15/08/20
Delhi,0,135108,4178,0,0,0,0,150652,15/08/20
Goa,0,7157,93,0,0,0,0,10970,15/08/20
Gujarat,0,59538,2746,0,0,0,0,76480,15/08/20
Haryana,0,38348,518,0,0,0,0,45614,15/08/20
Himachal Pradesh,0,2551,19,0,0,0,0,3874,15/08/20
Jammu and Kashmir,0,19942,520,0,0,0,0,27489,15/08/20
Jharkhand,0,13515,224,0,0,0,0,21595,15/08/20
Karnataka,0,128182,3717,0,0,0,0,211108,15/08/20
Kerala,0,26992,139,0,0,0,0,41277,15/08/20
Ladakh,0,1303,9,0,0,0,0,1879,15/08/20
Madhya Pradesh,0,32405,1081,0,0,0,0,43414,15/08/20
Maharashtra,0,401442,19427,0,0,0,0,572734,15/08/20
Manipur,0,2360,13,0,0,0,0,4198,15/08/20
Meghalaya,0,581,6,0,0,0,0,1228,15/08/20
Mizoram,0,348,0,0,0,0,0,657,15/08/20
Nagaland,0,1198,8,0,0,0,0,3322,15/08/20
Odisha,0,39206,324,0,0,0,0,54630,15/08/20
Puducherry,0,4009,106,0,0,0,0,6995,15/08/20
Punjab,0,18328,731,0,0,0,0,29013,15/08/20
Rajasthan,0,43897,846,0,0,0,0,58692,15/08/20
Sikkim,0,623,1,0,0,0,0,1080,15/08/20
Tamil Nadu,0,267015,5514,0,0,0,0,326245,15/08/20
Telengana,0,66196,684,0,0,0,0,90259,15/08/20
Tripura,0,5088,50,0,0,0,0,6934,15/08/20
Uttarakhand,0,7502,147,0,0,0,0,11615,15/08/20
Uttar Pradesh,0,92526,2335,0,0,0,0,145287,15/08/20
West Bengal,0,81189,2319,0,0,0,0,110358,15/08/20
Andaman and Nicobar Islands,0,1128,24,0,0,0,0,2306,16/08/20
Andhra Pradesh,0,191117,2562,0,0,0,0,281817,16/08/20
Arunachal Pradesh,0,1771,5,0,0,0,0,2658,16/08/20
Assam,0,53286,182,0,0,0,0,75558,16/08/20
Bihar,0,68510,450,0,0,0,0,101551,16/08/20
Chandigarh,0,1118,28,0,0,0,0,2009,16/08/20
Chhattisgarh,0,10046,134,0,0,0,0,14987,16/08/20
Dadra and Nagar Haveli and Daman and Diu,0,1384,2,0,0,0,0,1843,16/08/20
Delhi,0,136251,4188,0,0,0,0,151928,16/08/20
Goa,0,7488,98,0,0,0,0,11339,16/08/20
Gujarat,0,60553,2765,0,0,0,0,77559,16/08/20
Haryana,0,38939,528,0,0,0,0,46410,16/08/20
Himachal Pradesh,0,2632,19,0,0,0,0,3993,16/08/20
Jammu and Kashmir,0,20676,527,0,0,0,0,28021,16/08/20
Jharkhand,0,14024,228,0,0,0,0,22389,16/08/20
Karnataka,0,134811,3831,0,0,0,0,219926,16/08/20
Kerala,0,27795,146,0,0,0,0,42885,16/08/20
Ladakh,0,1307,10,0,0,0,0,1909,16/08/20
Madhya Pradesh,0,33353,1094,0,0,0,0,44433,16/08/20
Maharashtra,0,408286,19749,0,0,0,0,584754,16/08/20
Manipur,0,2438,13,0,0,0,0,4390,16/08/20
Meghalaya,0,596,6,0,0,0,0,1292,16/08/20
Mizoram,0,356,0,0,0,0,0,777,16/08/20
Nagaland,0,1321,8,0,0,0,0,3340,16/08/20
Odisha,0,40727,333,0,0,0,0,57126,16/08/20
Puducherry,0,4224,106,0,0,0,0,7354,16/08/20
Punjab,0,18863,771,0,0,0,0,30041,16/08/20
Rajasthan,0,45254,862,0,0,0,0,59979,16/08/20
Sikkim,0,661,1,0,0,0,0,1148,16/08/20
Tamil Nadu,0,272251,5641,0,0,0,0,332105,16/08/20
Telengana,0,68126,693,0,0,0,0,91361,16/08/20
Tripura,0,5151,55,0,0,0,0,7061,16/08/20
Uttarakhand,0,7748,151,0,0,0,0,11940,16/08/20
Uttar Pradesh,0,96231,2393,0,0,0,0,150061,16/08/20
West Bengal,0,83836,2377,0,0,0,0,113432,16/08/20
Andaman and Nicobar Islands,0,1226,28,0,0,0,0,2399,17/08/20
Andhra Pradesh,0,201234,2650,0,0,0,0,289829,17/08/20
Arunachal Pradesh,0,1808,5,0,0,0,0,2701,17/08/20
Assam,0,55215,189,0,0,0,0,76875,17/08/20
Bihar,0,72324,461,0,0,0,0,103844,17/08/20
Chandigarh,0,1137,29,0,0,0,0,2102,17/08/20
Chhattisgarh,0,10235,141,0,0,0,0,15471,17/08/20
Dadra and Nagar Haveli and Daman and Diu,0,1431,2,0,0,0,0,1878,17/08/20
Delhi,0,137561,4196,0,0,0,0,152580,17/08/20
Goa,0,7775,104,0,0,0,0,11639,17/08/20
Gujarat,0,61512,2785,0,0,0,0,78680,17/08/20
Haryana,0,39601,538,0,0,0,0,47153,17/08/20
Himachal Pradesh,0,2720,19,0,0,0,0,4156,17/08/20
Jammu and Kashmir,0,20943,542,0,0,0,0,28470,17/08/20
Jharkhand,0,14699,244,0,0,0,0,23055,17/08/20
Karnataka,0,141491,3947,0,0,0,0,226966,17/08/20
Kerala,0,28894,156,0,0,0,0,44415,17/08/20
Ladakh,0,1356,14,0,0,0,0,1948,17/08/20
Madhya Pradesh,0,34038,1105,0,0,0,0,45455,17/08/20
Maharashtra,0,417123,20037,0,0,0,0,595865,17/08/20
Manipur,0,2632,16,0,0,0,0,4569,17/08/20
Meghalaya,0,675,6,0,0,0,0,1374,17/08/20
Mizoram,0,371,0,0,0,0,0,789,17/08/20
Nagaland,0,1422,8,0,0,0,0,3394,17/08/20
Odisha,0,42277,343,0,0,0,0,60050,17/08/20
Puducherry,0,4443,110,0,0,0,0,7732,17/08/20
Punjab,0,19431,812,0,0,0,0,31206,17/08/20
Rajasthan,0,46604,876,0,0,0,0,61296,17/08/20
Sikkim,0,673,1,0,0,0,0,1167,17/08/20
Tamil Nadu,0,278270,5766,0,0,0,0,338055,17/08/20
Telengana,0,70132,703,0,0,0,0,92255,17/08/20
Tripura,0,5286,59,0,0,0,0,7204,17/08/20
Uttarakhand,0,8100,152,0,0,0,0,12175,17/08/20
Uttar Pradesh,0,100432,2449,0,0,0,0,154418,17/08/20
West Bengal,0,86771,2428,0,0,0,0,116498,17/08/20
Andaman and Nicobar Islands,0,1325,29,0,0,0,0,2445,18/08/20
Andhra Pradesh,0,209100,2732,0,0,0,0,296609,18/08/20
Arunachal Pradesh,0,1893,5,0,0,0,0,2741,18/08/20
Assam,0,56734,197,0,0,0,0,79667,18/08/20
Bihar,0,76452,468,0,0,0,0,106307,18/08/20
Chandigarh,0,1183,30,0,0,0,0,2216,18/08/20
Chhattisgarh,0,10598,150,0,0,0,0,16025,18/08/20
Dadra and Nagar Haveli and Daman and Diu,0,1459,2,0,0,0,0,1908,18/08/20
Delhi,0,138301,4214,0,0,0,0,153367,18/08/20
Goa,0,8058,111,0,0,0,0,11994,18/08/20
Gujarat,0,62595,2800,0,0,0,0,79710,18/08/20
Haryana,0,40610,550,0,0,0,0,48040,18/08/20
Himachal Pradesh,0,2834,19,0,0,0,0,4174,18/08/20
Jammu and Kashmir,0,21296,548,0,0,0,0,28892,18/08/20
Jharkhand,0,15051,250,0,0,0,0,23752,18/08/20
Karnataka,0,148562,4062,0,0,0,0,233283,18/08/20
Kerala,0,30025,169,0,0,0,0,46140,18/08/20
Ladakh,0,1368,14,0,0,0,0,1966,18/08/20
Madhya Pradesh,0,35025,1128,0,0,0,0,46385,18/08/20
Maharashtra,0,428514,20265,0,0,0,0,604358,18/08/20
Manipur,0,2734,17,0,0,0,0,4687,18/08/20
Meghalaya,0,679,6,0,0,0,0,1418,18/08/20
Mizoram,0,372,0,0,0,0,0,789,18/08/20
Nagaland,0,1530,8,0,0,0,0,3455,18/08/20
Odisha,0,43780,353,0,0,0,0,62294,18/08/20
Puducherry,0,4627,114,0,0,0,0,8029,18/08/20
Punjab,0,20180,863,0,0,0,0,32696,18/08/20
Rajasthan,0,47654,887,0,0,0,0,62630,18/08/20
Sikkim,0,701,1,0,0,0,0,1187,18/08/20
Tamil Nadu,0,283937,5886,0,0,0,0,343945,18/08/20
Telengana,0,72202,711,0,0,0,0,93937,18/08/20
Tripura,0,5404,62,0,0,0,0,7409,18/08/20
Uttarakhand,0,8485,158,0,0,0,0,12493,18/08/20
Uttar Pradesh,0,104808,2515,0,0,0,0,158216,18/08/20
West Bengal,0,89703,2473,0,0,0,0,119578,18/08/20
Andaman and Nicobar Islands,0,1421,30,0,0,0,0,2529,19/08/20
Andhra Pradesh,0,218311,2820,0,0,0,0,306261,19/08/20
Arunachal Pradesh,0,1949,5,0,0,0,0,2875,19/08/20
Assam,0,58294,203,0,0,0,0,82201,19/08/20
Bihar,0,80330,476,0,0,0,0,109498,19/08/20
Chandigarh,0,1243,30,0,0,0,0,2305,19/08/20
Chhattisgarh,0,10847,158,0,0,0,0,16833,19/08/20
Dadra and Nagar Haveli and Daman and Diu,0,1524,2,0,0,0,0,1951,19/08/20
Delhi,0,139447,4226,0,0,0,0,154741,19/08/20
Goa,0,8356,116,0,0,0,0,12333,19/08/20
Gujarat,0,63703,2820,0,0,0,0,80802,19/08/20
Haryana,0,41298,557,0,0,0,0,48936,19/08/20
Himachal Pradesh,0,2923,19,0,0,0,0,4235,19/08/20
Jammu and Kashmir,0,21886,561,0,0,0,0,29326,19/08/20
Jharkhand,0,15507,262,0,0,0,0,24477,19/08/20
Karnataka,0,156949,4201,0,0,0,0,240948,19/08/20
Kerala,0,31390,175,0,0,0,0,47898,19/08/20
Ladakh,0,1395,17,0,0,0,0,2010,19/08/20
Madhya Pradesh,0,35713,1141,0,0,0,0,47375,19/08/20
Maharashtra,0,437870,20687,0,0,0,0,615477,19/08/20
Manipur,0,2789,18,0,0,0,0,4765,19/08/20
Meghalaya,0,685,6,0,0,0,0,1457,19/08/20
Mizoram,0,379,0,0,0,0,0,860,19/08/20
Nagaland,0,1664,8,0,0,0,0,3520,19/08/20
Odisha,0,45315,362,0,0,0,0,64533,19/08/20
Puducherry,0,4909,123,0,0,0,0,8396,19/08/20
Punjab,0,21762,898,0,0,0,0,34400,19/08/20
Rajasthan,0,48960,898,0,0,0,0,63977,19/08/20
Sikkim,0,755,2,0,0,0,0,1207,19/08/20
Tamil Nadu,0,289787,6007,0,0,0,0,349654,19/08/20
Telengana,0,73991,719,0,0,0,0,95700,19/08/20
Tripura,0,5497,65,0,0,0,0,7645,19/08/20
Uttarakhand,0,8724,164,0,0,0,0,12961,19/08/20
Uttar Pradesh,0,109607,2585,0,0,0,0,162434,19/08/20
West Bengal,0,92690,2528,0,0,0,0,122753,19/08/20
Andaman and Nicobar Islands,0,1529,30,0,0,0,0,2604,20/08/20
Andhra Pradesh,0,226372,2906,0,0,0,0,316003,20/08/20
Arunachal Pradesh,0,2022,5,0,0,0,0,2950,20/08/20
Assam,0,60348,213,0,0,0,0,84317,20/08/20
Bihar,0,84404,487,0,0,0,0,112437,20/08/20
Chandigarh,0,1351,31,0,0,0,0,2396,20/08/20
Chhattisgarh,0,11185,161,0,0,0,0,17485,20/08/20
Dadra and Nagar Haveli and Daman and Diu,0,1604,2,0,0,0,0,1995,20/08/20
Delhi,0,140767,4235,0,0,0,0,156139,20/08/20
Goa,0,8713,124,0,0,0,0,12675,20/08/20
Gujarat,0,64823,2837,0,0,0,0,81942,20/08/20
Haryana,0,42056,567,0,0,0,0,49930,20/08/20
Himachal Pradesh,0,2992,19,0,0,0,0,4411,20/08/20
Jammu and Kashmir,0,22497,572,0,0,0,0,30034,20/08/20
Jharkhand,0,16175,277,0,0,0,0,26090,20/08/20
Karnataka,0,164150,4327,0,0,0,0,249590,20/08/20
Kerala,0,32607,182,0,0,0,0,50231,20/08/20
Ladakh,0,1397,18,0,0,0,0,2048,20/08/20
Madhya Pradesh,0,36475,1159,0,0,0,0,48351,20/08/20
Maharashtra,0,446881,21033,0,0,0,0,628642,20/08/20
Manipur,0,2885,18,0,0,0,0,4876,20/08/20
Meghalaya,0,694,6,0,0,0,0,1506,20/08/20
Mizoram,0,384,0,0,0,0,0,873,20/08/20
Nagaland,0,1706,8,0,0,0,0,3558,20/08/20
Odisha,0,46936,372,0,0,0,0,67122,20/08/20
Puducherry,0,5312,129,0,0,0,0,8750,20/08/20
Punjab,0,22703,921,0,0,0,0,36084,20/08/20
Rajasthan,0,49963,910,0,0,0,0,65289,20/08/20
Sikkim,0,789,3,0,0,0,0,1232,20/08/20
Tamil Nadu,0,296171,6123,0,0,0,0,355449,20/08/20
Telengana,0,75186,729,0,0,0,0,97424,20/08/20
Tripura,0,5565,65,0,0,0,0,7835,20/08/20
Uttarakhand,0,9132,178,0,0,0,0,13225,20/08/20
Uttar Pradesh,0,115227,2638,0,0,0,0,167510,20/08/20
West Bengal,0,95663,2581,0,0,0,0,125922,20/08/20
Andaman and Nicobar Islands,0,1638,31,0,0,0,0,2680,21/08/20
Andhra Pradesh,0,235218,3001,0,0,0,0,325396,21/08/20
Arunachal Pradesh,0,2093,5,0,0,0,0,3066,21/08/20
Assam,0,63120,221,0,0,0,0,86052,21/08/20
Bihar,0,87660,492,0,0,0,0,114941,21/08/20
Chandigarh,0,1390,31,0,0,0,0,2515,21/08/20
Chhattisgarh,0,11739,168,0,0,0,0,18501,21/08/20
Dadra and Nagar Haveli and Daman and Diu,0,1627,2,0,0,0,0,2030,21/08/20
Delhi,0,141826,4257,0,0,0,0,157354,21/08/20
Goa,0,9063,126,0,0,0,0,13099,21/08/20
Gujarat,0,65946,2853,0,0,0,0,83107,21/08/20
Haryana,0,42793,578,0,0,0,0,50926,21/08/20
Himachal Pradesh,0,3085,23,0,0,0,0,4538,21/08/20
Jammu and Kashmir,0,23225,578,0,0,0,0,30717,21/08/20
Jharkhand,0,17057,286,0,0,0,0,26753,21/08/20
Karnataka,0,170381,4429,0,0,0,0,256975,21/08/20
Kerala,0,33824,191,0,0,0,0,52199,21/08/20
Ladakh,0,1436,18,0,0,0,0,2077,21/08/20
Madhya Pradesh,0,37540,1171,0,0,0,0,49493,21/08/20
Maharashtra,0,459124,21359,0,0,0,0,643289,21/08/20
Manipur,0,3002,18,0,0,0,0,4925,21/08/20
Meghalaya,0,730,6,0,0,0,0,1661,21/08/20
Mizoram,0,402,0,0,0,0,0,895,21/08/20
Nagaland,0,1921,8,0,0,0,0,3583,21/08/20
Odisha,0,48577,380,0,0,0,0,70020,21/08/20
Puducherry,0,5634,137,0,0,0,0,9292,21/08/20
Punjab,0,23037,957,0,0,0,0,37824,21/08/20
Rajasthan,0,51190,921,0,0,0,0,66619,21/08/20
Sikkim,0,827,3,0,0,0,0,1290,21/08/20
Tamil Nadu,0,301913,6239,0,0,0,0,361435,21/08/20
Telengana,0,76967,737,0,0,0,0,99391,21/08/20
Tripura,0,5649,69,0,0,0,0,8091,21/08/20
Uttarakhand,0,9433,187,0,0,0,0,13636,21/08/20
Uttar Pradesh,0,121090,2733,0,0,0,0,172334,21/08/20
West Bengal,0,98789,2634,0,0,0,0,129119,21/08/20
Andaman and Nicobar Islands,0,1744,32,0,0,0,0,2747,22/08/20
Andhra Pradesh,0,244045,3092,0,0,0,0,334940,22/08/20
Arunachal Pradesh,0,2125,5,0,0,0,0,3126,22/08/20
Assam,0,65596,227,0,0,0,0,87908,22/08/20
Bihar,0,91552,498,0,0,0,0,117413,22/08/20
Chandigarh,0,1426,33,0,0,0,0,2631,22/08/20
Chhattisgarh,0,12022,180,0,0,0,0,19510,22/08/20
Dadra and Nagar Haveli and Daman and Diu,0,1652,2,0,0,0,0,2082,22/08/20
Delhi,0,142908,4270,0,0,0,0,158604,22/08/20
Goa,0,9540,135,0,0,0,0,13484,22/08/20
Gujarat,0,67267,2867,0,0,0,0,84311,22/08/20
Haryana,0,43413,585,0,0,0,0,52129,22/08/20
Himachal Pradesh,0,3234,25,0,0,0,0,4728,22/08/20
Jammu and Kashmir,0,23805,593,0,0,0,0,31371,22/08/20
Jharkhand,0,18372,297,0,0,0,0,28196,22/08/20
Karnataka,0,176942,4522,0,0,0,0,264546,22/08/20
Kerala,0,35243,203,0,0,0,0,54182,22/08/20
Ladakh,0,1449,19,0,0,0,0,2133,22/08/20
Madhya Pradesh,0,38527,1185,0,0,0,0,50640,22/08/20
Maharashtra,0,470873,21698,0,0,0,0,657450,22/08/20
Manipur,0,3261,20,0,0,0,0,5049,22/08/20
Meghalaya,0,749,6,0,0,0,0,1718,22/08/20
Mizoram,0,420,0,0,0,0,0,903,22/08/20
Nagaland,0,2074,8,0,0,0,0,3619,22/08/20
Odisha,0,50504,390,0,0,0,0,72718,22/08/20
Puducherry,0,5934,143,0,0,0,0,9594,22/08/20
Punjab,0,23893,991,0,0,0,0,39327,22/08/20
Rajasthan,0,52496,933,0,0,0,0,67954,22/08/20
Sikkim,0,834,3,0,0,0,0,1336,22/08/20
Tamil Nadu,0,307677,6340,0,0,0,0,367430,22/08/20
Telengana,0,78735,744,0,0,0,0,101865,22/08/20
Tripura,0,6061,70,0,0,0,0,8371,22/08/20
Uttarakhand,0,9676,192,0,0,0,0,14083,22/08/20
Uttar Pradesh,0,126657,2797,0,0,0,0,177239,22/08/20
West Bengal,0,101871,2689,0,0,0,0,132364,22/08/20
Andaman and Nicobar Islands,0,1853,32,0,0,0,0,2808,23/08/20
Andhra Pradesh,0,252638,3189,0,0,0,0,345216,23/08/20
Arunachal Pradesh,0,2228,5,0,0,0,0,3223,23/08/20
Assam,0,67641,234,0,0,0,0,89468,23/08/20
Bihar,0,94858,503,0,0,0,0,119529,23/08/20
Chandigarh,0,1471,33,0,0,0,0,2776,23/08/20
Chhattisgarh,0,12394,189,0,0,0,0,20078,23/08/20
Dadra and Nagar Haveli and Daman and Diu,0,1702,2,0,0,0,0,2120,23/08/20
Delhi,0,144138,4284,0,0,0,0,160016,23/08/20
Goa,0,10019,140,0,0,0,0,13790,23/08/20
Gujarat,0,68243,2881,0,0,0,0,85523,23/08/20
Haryana,0,44013,597,0,0,0,0,53290,23/08/20
Himachal Pradesh,0,3341,29,0,0,0,0,4895,23/08/20
Jammu and Kashmir,0,24398,608,0,0,0,0,31981,23/08/20
Jharkhand,0,18507,308,0,0,0,0,28571,23/08/20
Karnataka,0,184568,4615,0,0,0,0,271876,23/08/20
Kerala,0,36535,218,0,0,0,0,56354,23/08/20
Ladakh,0,1469,21,0,0,0,0,2210,23/08/20
Madhya Pradesh,0,39399,1206,0,0,0,0,51866,23/08/20
Maharashtra,0,480114,21995,0,0,0,0,671942,23/08/20
Manipur,0,3455,22,0,0,0,0,5132,23/08/20
Meghalaya,0,769,7,0,0,0,0,1811,23/08/20
Mizoram,0,423,0,0,0,0,0,917,23/08/20
Nagaland,0,2166,9,0,0,0,0,3635,23/08/20
Odisha,0,52277,399,0,0,0,0,75537,23/08/20
Puducherry,0,6307,151,0,0,0,0,10112,23/08/20
Punjab,0,24302,1036,0,0,0,0,40643,23/08/20
Rajasthan,0,54144,944,0,0,0,0,69264,23/08/20
Sikkim,0,871,3,0,0,0,0,1381,23/08/20
Tamil Nadu,0,313280,6420,0,0,0,0,373410,23/08/20
Telengana,0,80586,755,0,0,0,0,104249,23/08/20
Tripura,0,6182,72,0,0,0,0,8702,23/08/20
Uttarakhand,0,10021,195,0,0,0,0,14566,23/08/20
Uttar Pradesh,0,131295,2867,0,0,0,0,182453,23/08/20
West Bengal,0,104959,2737,0,0,0,0,135596,23/08/20
Andaman and Nicobar Islands,0,1963,33,0,0,0,0,2860,24/08/20
Andhra Pradesh,0,260087,3282,0,0,0,0,353111,24/08/20
Arunachal Pradesh,0,2297,5,0,0,0,0,3263,24/08/20
Assam,0,70900,242,0,0,0,0,90740,24/08/20
Bihar,0,98325,511,0,0,0,0,121947,24/08/20
Chandigarh,0,1492,37,0,0,0,0,2918,24/08/20
Chhattisgarh,0,12931,197,0,0,0,0,20918,24/08/20
Dadra and Nagar Haveli and Daman and Diu,0,1753,2,0,0,0,0,2161,24/08/20
Delhi,0,145388,4300,0,0,0,0,161466,24/08/20
Goa,0,10472,144,0,0,0,0,13999,24/08/20
Gujarat,0,69212,2895,0,0,0,0,86624,24/08/20
Haryana,0,44822,603,0,0,0,0,54386,24/08/20
Himachal Pradesh,0,3461,29,0,0,0,0,5001,24/08/20
Jammu and Kashmir,0,24832,617,0,0,0,0,32647,24/08/20
Jharkhand,0,19629,312,0,0,0,0,29677,24/08/20
Karnataka,0,189564,4683,0,0,0,0,277814,24/08/20
Kerala,0,37645,223,0,0,0,0,58262,24/08/20
Ladakh,0,1491,23,0,0,0,0,2279,24/08/20
Madhya Pradesh,0,40390,1229,0,0,0,0,53129,24/08/20
Maharashtra,0,488271,22253,0,0,0,0,682383,24/08/20
Manipur,0,3616,22,0,0,0,0,5246,24/08/20
Meghalaya,0,776,8,0,0,0,0,1917,24/08/20
Mizoram,0,459,0,0,0,0,0,918,24/08/20
Nagaland,0,2294,9,0,0,0,0,3686,24/08/20
Odisha,0,54406,409,0,0,0,0,78530,24/08/20
Puducherry,0,6657,159,0,0,0,0,10522,24/08/20
Punjab,0,26528,1086,0,0,0,0,41779,24/08/20
Rajasthan,0,55324,955,0,0,0,0,70609,24/08/20
Sikkim,0,871,3,0,0,0,0,1403,24/08/20
Tamil Nadu,0,319327,6517,0,0,0,0,379385,24/08/20
Telengana,0,82411,761,0,0,0,0,106091,24/08/20
Tripura,0,6341,73,0,0,0,0,8902,24/08/20
Uttarakhand,0,10480,200,0,0,0,0,15124,24/08/20
Uttar Pradesh,0,135613,2926,0,0,0,0,187781,24/08/20
West Bengal,0,108007,2794,0,0,0,0,138870,24/08/20
Andaman and Nicobar Islands,0,2092,35,0,0,0,0,2904,25/08/20
Andhra Pradesh,0,268828,3368,0,0,0,0,361712,25/08/20
Arunachal Pradesh,0,2427,5,0,0,0,0,3312,25/08/20
Assam,0,73090,252,0,0,0,0,92619,25/08/20
Bihar,0,101292,514,0,0,0,0,123198,25/08/20
Chandigarh,0,1646,37,0,0,0,0,3035,25/08/20
Chhattisgarh,0,13424,206,0,0,0,0,22054,25/08/20
Dadra and Nagar Haveli and Daman and Diu,0,1786,2,0,0,0,0,2181,25/08/20
Delhi,0,146588,4313,0,0,0,0,162527,25/08/20
Goa,0,10909,148,0,0,0,0,14138,25/08/20
Gujarat,0,70231,2908,0,0,0,0,87691,25/08/20
Haryana,0,45405,613,0,0,0,0,55460,25/08/20
Himachal Pradesh,0,3584,29,0,0,0,0,5101,25/08/20
Jammu and Kashmir,0,25205,624,0,0,0,0,33075,25/08/20
Jharkhand,0,20870,330,0,0,0,0,31005,25/08/20
Karnataka,0,197625,4810,0,0,0,0,283665,25/08/20
Kerala,0,38883,234,0,0,0,0,59504,25/08/20
Ladakh,0,1517,23,0,0,0,0,2330,25/08/20
Madhya Pradesh,0,41231,1246,0,0,0,0,54421,25/08/20
Maharashtra,0,502490,22465,0,0,0,0,693398,25/08/20
Manipur,0,3714,22,0,0,0,0,5362,25/08/20
Meghalaya,0,789,8,0,0,0,0,1976,25/08/20
Mizoram,0,461,0,0,0,0,0,953,25/08/20
Nagaland,0,2396,9,0,0,0,0,3714,25/08/20
Odisha,0,56925,419,0,0,0,0,81479,25/08/20
Puducherry,0,6942,164,0,0,0,0,10859,25/08/20
Punjab,0,28357,1129,0,0,0,0,43284,25/08/20
Rajasthan,0,56600,967,0,0,0,0,71955,25/08/20
Sikkim,0,934,3,0,0,0,0,1446,25/08/20
Tamil Nadu,0,325456,6614,0,0,0,0,385352,25/08/20
Telengana,0,84163,770,0,0,0,0,108670,25/08/20
Tripura,0,6414,78,0,0,0,0,9195,25/08/20
Uttarakhand,0,10912,207,0,0,0,0,15529,25/08/20
Uttar Pradesh,0,140107,2987,0,0,0,0,192382,25/08/20
West Bengal,0,111292,2851,0,0,0,0,141837,25/08/20
Andaman and Nicobar Islands,0,2231,37,0,0,0,0,2945,26/08/20
Andhra Pradesh,0,278247,3460,0,0,0,0,371639,26/08/20
Arunachal Pradesh,0,2508,5,0,0,0,0,3412,26/08/20
Assam,0,74814,260,0,0,0,0,94592,26/08/20
Bihar,0,104301,519,0,0,0,0,124536,26/08/20
Chandigarh,0,1713,40,0,0,0,0,3209,26/08/20
Chhattisgarh,0,13732,221,0,0,0,0,23341,26/08/20
Dadra and Nagar Haveli and Daman and Diu,0,1820,2,0,0,0,0,2203,26/08/20
Delhi,0,147743,4330,0,0,0,0,164071,26/08/20
Goa,0,11224,157,0,0,0,0,14530,26/08/20
Gujarat,0,71236,2928,0,0,0,0,88805,26/08/20
Haryana,0,46496,623,0,0,0,0,56608,26/08/20
Himachal Pradesh,0,3748,30,0,0,0,0,5154,26/08/20
Jammu and Kashmir,0,25594,638,0,0,0,0,33776,26/08/20
Jharkhand,0,21388,347,0,0,0,0,31973,26/08/20
Karnataka,0,204439,4958,0,0,0,0,291826,26/08/20
Kerala,0,40339,244,0,0,0,0,61879,26/08/20
Ladakh,0,1549,24,0,0,0,0,2420,26/08/20
Madhya Pradesh,0,42310,1265,0,0,0,0,55800,26/08/20
Maharashtra,0,514790,22794,0,0,0,0,703823,26/08/20
Manipur,0,3812,24,0,0,0,0,5444,26/08/20
Meghalaya,0,832,8,0,0,0,0,2018,26/08/20
Mizoram,0,464,0,0,0,0,0,967,26/08/20
Nagaland,0,2611,9,0,0,0,0,3752,26/08/20
Odisha,0,59470,428,0,0,0,0,84231,26/08/20
Puducherry,0,7273,172,0,0,0,0,11426,26/08/20
Punjab,0,29145,1178,0,0,0,0,44577,26/08/20
Rajasthan,0,58126,980,0,0,0,0,73325,26/08/20
Sikkim,0,1054,3,0,0,0,0,1475,26/08/20
Tamil Nadu,0,332454,6721,0,0,0,0,391303,26/08/20
Telengana,0,85223,780,0,0,0,0,111688,26/08/20
Tripura,0,6574,83,0,0,0,0,9523,26/08/20
Uttarakhand,0,11201,213,0,0,0,0,16014,26/08/20
Uttar Pradesh,0,144754,3059,0,0,0,0,197388,26/08/20
West Bengal,0,114543,2909,0,0,0,0,144801,26/08/20
Andaman and Nicobar Islands,0,2309,41,0,0,0,0,2985,27/08/20
Andhra Pradesh,0,286720,3541,0,0,0,0,382469,27/08/20
Arunachal Pradesh,0,2563,5,0,0,0,0,3555,27/08/20
Assam,0,76962,274,0,0,0,0,96771,27/08/20
Bihar,0,106361,530,0,0,0,0,126714,27/08/20
Chandigarh,0,1796,41,0,0,0,0,3376,27/08/20
Chhattisgarh,0,14145,231,0,0,0,0,24550,27/08/20
Dadra and Nagar Haveli and Daman and Diu,0,1862,2,0,0,0,0,2228,27/08/20
Delhi,0,148897,4347,0,0,0,0,165764,27/08/20
Goa,0,11511,165,0,0,0,0,15027,27/08/20
Gujarat,0,72282,2945,0,0,0,0,89994,27/08/20
Haryana,0,47613,634,0,0,0,0,58005,27/08/20
Himachal Pradesh,0,3810,32,0,0,0,0,5321,27/08/20
Jammu and Kashmir,0,26193,657,0,0,0,0,34480,27/08/20
Jharkhand,0,22349,362,0,0,0,0,33046,27/08/20
Karnataka,0,211688,5091,0,0,0,0,300406,27/08/20
Kerala,0,41690,257,0,0,0,0,64355,27/08/20
Ladakh,0,1580,25,0,0,0,0,2451,27/08/20
Madhya Pradesh,0,43246,1282,0,0,0,0,56864,27/08/20
Maharashtra,0,522427,23089,0,0,0,0,718711,27/08/20
Manipur,0,3829,25,0,0,0,0,5585,27/08/20
Meghalaya,0,874,8,0,0,0,0,2050,27/08/20
Mizoram,0,473,0,0,0,0,0,967,27/08/20
Nagaland,0,2611,9,0,0,0,0,3778,27/08/20
Odisha,0,62813,441,0,0,0,0,87602,27/08/20
Puducherry,0,7486,180,0,0,0,0,11930,27/08/20
Punjab,0,30231,1219,0,0,0,0,46090,27/08/20
Rajasthan,0,59579,992,0,0,0,0,74670,27/08/20
Sikkim,0,1076,3,0,0,0,0,1486,27/08/20
Tamil Nadu,0,338060,6839,0,0,0,0,397261,27/08/20
Telengana,0,86095,788,0,0,0,0,114483,27/08/20
Tripura,0,6697,85,0,0,0,0,9908,27/08/20
Uttarakhand,0,11524,219,0,0,0,0,16549,27/08/20
Uttar Pradesh,0,148562,3149,0,0,0,0,203028,27/08/20
West Bengal,0,117857,2964,0,0,0,0,147775,27/08/20
Andaman and Nicobar Islands,0,2374,42,0,0,0,0,3018,28/08/20
Andhra Pradesh,0,295248,3633,0,0,0,0,393090,28/08/20
Arunachal Pradesh,0,2621,5,0,0,0,0,3633,28/08/20
Assam,0,79307,278,0,0,0,0,98807,28/08/20
Bihar,0,109175,538,0,0,0,0,128780,28/08/20
Chandigarh,0,1977,43,0,0,0,0,3564,28/08/20
Chhattisgarh,0,14607,245,0,0,0,0,25988,28/08/20
Dadra and Nagar Haveli and Daman and Diu,0,1916,2,0,0,0,0,2266,28/08/20
Delhi,0,150027,4369,0,0,0,0,167604,28/08/20
Goa,0,11867,171,0,0,0,0,15483,28/08/20
Gujarat,0,73475,2962,0,0,0,0,91179,28/08/20
Haryana,0,48690,646,0,0,0,0,59298,28/08/20
Himachal Pradesh,0,4008,33,0,0,0,0,5501,28/08/20
Jammu and Kashmir,0,26721,671,0,0,0,0,35135,28/08/20
Jharkhand,0,22927,373,0,0,0,0,34396,28/08/20
Karnataka,0,219554,5232,0,0,0,0,309792,28/08/20
Kerala,0,43757,267,0,0,0,0,66761,28/08/20
Ladakh,0,1640,27,0,0,0,0,2492,28/08/20
Madhya Pradesh,0,44453,1306,0,0,0,0,58181,28/08/20
Maharashtra,0,531563,23444,0,0,0,0,733568,28/08/20
Manipur,0,3957,25,0,0,0,0,5725,28/08/20
Meghalaya,0,899,8,0,0,0,0,2129,28/08/20
Mizoram,0,500,0,0,0,0,0,974,28/08/20
Nagaland,0,2735,9,0,0,0,0,3784,28/08/20
Odisha,0,65323,448,0,0,0,0,90986,28/08/20
Puducherry,0,7761,190,0,0,0,0,12434,28/08/20
Punjab,0,30972,1256,0,0,0,0,47836,28/08/20
Rajasthan,0,60585,1005,0,0,0,0,76015,28/08/20
Sikkim,0,1151,3,0,0,0,0,1542,28/08/20
Tamil Nadu,0,343930,6948,0,0,0,0,403242,28/08/20
Telengana,0,87675,799,0,0,0,0,117415,28/08/20
Tripura,0,6839,89,0,0,0,0,10414,28/08/20
Uttarakhand,0,11775,228,0,0,0,0,17277,28/08/20
Uttar Pradesh,0,152893,3217,0,0,0,0,208419,28/08/20
West Bengal,0,121046,3017,0,0,0,0,150772,28/08/20
Andaman and Nicobar Islands,0,2444,42,0,0,0,0,3050,29/08/20
Andhra Pradesh,0,303711,3714,0,0,0,0,403616,29/08/20
Arunachal Pradesh,0,2709,5,0,0,0,0,3745,29/08/20
Assam,0,81070,286,0,0,0,0,101367,29/08/20
Bihar,0,112452,558,0,0,0,0,131057,29/08/20
Chandigarh,0,2107,45,0,0,0,0,3724,29/08/20
Chhattisgarh,0,15109,251,0,0,0,0,27233,29/08/20
Dadra and Nagar Haveli and Daman and Diu,0,1960,2,0,0,0,0,2290,29/08/20
Delhi,0,151473,4389,0,0,0,0,169412,29/08/20
Goa,0,12296,175,0,0,0,0,16006,29/08/20
Gujarat,0,74525,2976,0,0,0,0,92452,29/08/20
Haryana,0,49710,661,0,0,0,0,60596,29/08/20
Himachal Pradesh,0,4149,33,0,0,0,0,5637,29/08/20
Jammu and Kashmir,0,27372,678,0,0,0,0,35831,29/08/20
Jharkhand,0,23850,381,0,0,0,0,35321,29/08/20
Karnataka,0,227018,5368,0,0,0,0,318752,29/08/20
Kerala,0,45854,274,0,0,0,0,69304,29/08/20
Ladakh,0,1714,28,0,0,0,0,2540,29/08/20
Madhya Pradesh,0,45396,1323,0,0,0,0,59433,29/08/20
Maharashtra,0,543170,23775,0,0,0,0,747995,29/08/20
Manipur,0,4057,27,0,0,0,0,5843,29/08/20
Meghalaya,0,958,10,0,0,0,0,2240,29/08/20
Mizoram,0,509,0,0,0,0,0,1003,29/08/20
Nagaland,0,2850,9,0,0,0,0,3805,29/08/20
Odisha,0,67826,456,0,0,0,0,94668,29/08/20
Puducherry,0,8080,199,0,0,0,0,13024,29/08/20
Punjab,0,33008,1307,0,0,0,0,49378,29/08/20
Rajasthan,0,62033,1017,0,0,0,0,77370,29/08/20
Sikkim,0,1184,3,0,0,0,0,1576,29/08/20
Tamil Nadu,0,349682,7050,0,0,0,0,409238,29/08/20
Telengana,0,89350,808,0,0,0,0,120166,29/08/20
Tripura,0,7037,94,0,0,0,0,10857,29/08/20
Uttarakhand,0,12124,239,0,0,0,0,17865,29/08/20
Uttar Pradesh,0,157879,3294,0,0,0,0,213824,29/08/20
West Bengal,0,124332,3073,0,0,0,0,153754,29/08/20
Andaman and Nicobar Islands,0,2519,44,0,0,0,0,3081,30/08/20
Andhra Pradesh,0,312687,3796,0,0,0,0,414164,30/08/20
Arunachal Pradesh,0,2754,5,0,0,0,0,3877,30/08/20
Assam,0,82510,289,0,0,0,0,103794,30/08/20
Bihar,0,114772,561,0,0,0,0,133003,30/08/20
Chandigarh,0,2248,45,0,0,0,0,3985,30/08/20
Chhattisgarh,0,15818,262,0,0,0,0,28746,30/08/20
Dadra and Nagar Haveli and Daman and Diu,0,1998,2,0,0,0,0,2306,30/08/20
Delhi,0,152922,4404,0,0,0,0,171366,30/08/20
Goa,0,12729,178,0,0,0,0,16553,30/08/20
Gujarat,0,75636,2989,0,0,0,0,93734,30/08/20
Haryana,0,50711,670,0,0,0,0,61987,30/08/20
Himachal Pradesh,0,4308,34,0,0,0,0,5781,30/08/20
Jammu and Kashmir,0,28020,685,0,0,0,0,36377,30/08/20
Jharkhand,0,25103,397,0,0,0,0,36857,30/08/20
Karnataka,0,235128,5483,0,0,0,0,327076,30/08/20
Kerala,0,48079,280,0,0,0,0,71701,30/08/20
Ladakh,0,1745,32,0,0,0,0,2603,30/08/20
Madhya Pradesh,0,46413,1345,0,0,0,0,60875,30/08/20
Maharashtra,0,554711,24103,0,0,0,0,764281,30/08/20
Manipur,0,4186,28,0,0,0,0,5960,30/08/20
Meghalaya,0,1035,10,0,0,0,0,2283,30/08/20
Mizoram,0,584,0,0,0,0,0,1008,30/08/20
Nagaland,0,2917,9,0,0,0,0,3851,30/08/20
Odisha,0,70714,470,0,0,0,0,97920,30/08/20
Puducherry,0,8511,211,0,0,0,0,13556,30/08/20
Punjab,0,34091,1348,0,0,0,0,50848,30/08/20
Rajasthan,0,62971,1030,0,0,0,0,78777,30/08/20
Sikkim,0,1195,3,0,0,0,0,1602,30/08/20
Tamil Nadu,0,355727,7137,0,0,0,0,415590,30/08/20
Telengana,0,90988,818,0,0,0,0,123090,30/08/20
Tripura,0,7232,98,0,0,0,0,11307,30/08/20
Uttarakhand,0,12586,250,0,0,0,0,18571,30/08/20
Uttar Pradesh,0,162741,3356,0,0,0,0,219457,30/08/20
West Bengal,0,127644,3126,0,0,0,0,156766,30/08/20
Andaman and Nicobar Islands,0,2586,45,0,0,0,0,3104,31/08/20
Andhra Pradesh,0,321754,3884,0,0,0,0,424767,31/08/20
Arunachal Pradesh,0,2822,7,0,0,0,0,4034,31/08/20
Assam,0,83927,296,0,0,0,0,105774,31/08/20
Bihar,0,117124,578,0,0,0,0,135035,31/08/20
Chandigarh,0,2296,52,0,0,0,0,4155,31/08/20
Chhattisgarh,0,16303,269,0,0,0,0,30092,31/08/20
Dadra and Nagar Haveli and Daman and Diu,0,2042,2,0,0,0,0,2340,31/08/20
Delhi,0,154171,4426,0,0,0,0,173390,31/08/20
Goa,0,13186,183,0,0,0,0,17004,31/08/20
Gujarat,0,76731,3006,0,0,0,0,95009,31/08/20
Haryana,0,51620,682,0,0,0,0,63282,31/08/20
Himachal Pradesh,0,4450,35,0,0,0,0,5945,31/08/20
Jammu and Kashmir,0,28510,694,0,0,0,0,37163,31/08/20
Jharkhand,0,26448,410,0,0,0,0,38435,31/08/20
Karnataka,0,242229,5589,0,0,0,0,335928,31/08/20
Kerala,0,49849,287,0,0,0,0,73855,31/08/20
Ladakh,0,1757,34,0,0,0,0,2638,31/08/20
Madhya Pradesh,0,47467,1374,0,0,0,0,62433,31/08/20
Maharashtra,0,562401,24399,0,0,0,0,780689,31/08/20
Manipur,0,4239,28,0,0,0,0,6112,31/08/20
Meghalaya,0,1049,10,0,0,0,0,2343,31/08/20
Mizoram,0,589,0,0,0,0,0,1011,31/08/20
Nagaland,0,3026,9,0,0,0,0,3922,31/08/20
Odisha,0,73233,482,0,0,0,0,100934,31/08/20
Puducherry,0,8968,221,0,0,0,0,14127,31/08/20
Punjab,0,35747,1404,0,0,0,0,52526,31/08/20
Rajasthan,0,65093,1043,0,0,0,0,80227,31/08/20
Sikkim,0,1220,3,0,0,0,0,1627,31/08/20
Tamil Nadu,0,362133,7231,0,0,0,0,422085,31/08/20
Telengana,0,92837,827,0,0,0,0,124963,31/08/20
Tripura,0,7433,103,0,0,0,0,11644,31/08/20
Uttarakhand,0,13066,257,0,0,0,0,19235,31/08/20
Uttar Pradesh,0,167543,3423,0,0,0,0,225632,31/08/20
West Bengal,0,130952,3176,0,0,0,0,159785,31/08/20
Andaman and Nicobar Islands,0,2647,46,0,0,0,0,3132,01/09/20
Andhra Pradesh,0,330526,3969,0,0,0,0,434771,01/09/20
Arunachal Pradesh,0,2885,7,0,0,0,0,4112,01/09/20
Assam,0,85461,306,0,0,0,0,109040,01/09/20
Bihar,0,119540,582,0,0,0,0,136457,01/09/20
Chandigarh,0,2431,56,0,0,0,0,4346,01/09/20
Chhattisgarh,0,16989,277,0,0,0,0,31503,01/09/20
Dadra and Nagar Haveli and Daman and Diu,0,2081,2,0,0,0,0,2367,01/09/20
Delhi,0,155678,4444,0,0,0,0,174748,01/09/20
Goa,0,13577,192,0,0,0,0,17418,01/09/20
Gujarat,0,77756,3020,0,0,0,0,96300,01/09/20
Haryana,0,52672,689,0,0,0,0,64732,01/09/20
Himachal Pradesh,0,4515,38,0,0,0,0,6116,01/09/20
Jammu and Kashmir,0,29015,703,0,0,0,0,37698,01/09/20
Jharkhand,0,27143,417,0,0,0,0,41656,01/09/20
Karnataka,0,249467,5702,0,0,0,0,342423,01/09/20
Kerala,0,51538,294,0,0,0,0,75385,01/09/20
Ladakh,0,1874,34,0,0,0,0,2681,01/09/20
Madhya Pradesh,0,48657,1394,0,0,0,0,63965,01/09/20
Maharashtra,0,573559,24583,0,0,0,0,792541,01/09/20
Manipur,0,4330,28,0,0,0,0,6252,01/09/20
Meghalaya,0,1162,10,0,0,0,0,2368,01/09/20
Mizoram,0,591,0,0,0,0,0,1011,01/09/20
Nagaland,0,3067,9,0,0,0,0,3950,01/09/20
Odisha,0,77286,492,0,0,0,0,103536,01/09/20
Puducherry,0,9334,228,0,0,0,0,14411,01/09/20
Punjab,0,37027,1453,0,0,0,0,53992,01/09/20
Rajasthan,0,66812,1056,0,0,0,0,81693,01/09/20
Sikkim,0,1225,3,0,0,0,0,1652,01/09/20
Tamil Nadu,0,368141,7322,0,0,0,0,428041,01/09/20
Telengana,0,95162,836,0,0,0,0,127697,01/09/20
Tripura,0,7674,113,0,0,0,0,12153,01/09/20
Uttarakhand,0,13650,269,0,0,0,0,19827,01/09/20
Uttar Pradesh,0,172140,3486,0,0,0,0,230414,01/09/20
West Bengal,0,134270,3228,0,0,0,0,162778,01/09/20
Andaman and Nicobar Islands,0,2714,46,0,0,0,0,3160,02/09/20
Andhra Pradesh,0,339876,4053,0,0,0,0,445139,02/09/20
Arunachal Pradesh,0,2979,7,0,0,0,0,4212,02/09/20
Assam,0,86895,315,0,0,0,0,111724,02/09/20
Bihar,0,121560,621,0,0,0,0,138349,02/09/20
Chandigarh,0,2551,57,0,0,0,0,4550,02/09/20
Chhattisgarh,0,17567,287,0,0,0,0,33387,02/09/20
Dadra and Nagar Haveli and Daman and Diu,0,2122,2,0,0,0,0,2386,02/09/20
Delhi,0,156728,4462,0,0,0,0,177060,02/09/20
Goa,0,13850,194,0,0,0,0,18006,02/09/20
Gujarat,0,78887,3034,0,0,0,0,97629,02/09/20
Haryana,0,53835,706,0,0,0,0,66426,02/09/20
Himachal Pradesh,0,4688,40,0,0,0,0,6255,02/09/20
Jammu and Kashmir,0,29484,717,0,0,0,0,38223,02/09/20
Jharkhand,0,28149,428,0,0,0,0,43833,02/09/20
Karnataka,0,254626,5837,0,0,0,0,351481,02/09/20
Kerala,0,53649,298,0,0,0,0,76525,02/09/20
Ladakh,0,1978,35,0,0,0,0,2733,02/09/20
Madhya Pradesh,0,49992,1426,0,0,0,0,65490,02/09/20
Maharashtra,0,584537,24903,0,0,0,0,808306,02/09/20
Manipur,0,4450,29,0,0,0,0,6382,02/09/20
Meghalaya,0,1235,12,0,0,0,0,2440,02/09/20
Mizoram,0,612,0,0,0,0,0,1020,02/09/20
Nagaland,0,3201,9,0,0,0,0,4003,02/09/20
Odisha,0,80770,503,0,0,0,0,106561,02/09/20
Puducherry,0,9675,240,0,0,0,0,14766,02/09/20
Punjab,0,38147,1512,0,0,0,0,55508,02/09/20
Rajasthan,0,68124,1069,0,0,0,0,83163,02/09/20
Sikkim,0,1237,4,0,0,0,0,1670,02/09/20
Tamil Nadu,0,374172,7418,0,0,0,0,433969,02/09/20
Telengana,0,97402,846,0,0,0,0,130589,02/09/20
Tripura,0,7847,118,0,0,0,0,12702,02/09/20
Uttarakhand,0,14076,280,0,0,0,0,20398,02/09/20
Uttar Pradesh,0,176677,3542,0,0,0,0,235757,02/09/20
West Bengal,0,137616,3283,0,0,0,0,165721,02/09/20
Andaman and Nicobar Islands,0,2758,47,0,0,0,0,3186,03/09/20
Andhra Pradesh,0,348330,4125,0,0,0,0,455531,03/09/20
Arunachal Pradesh,0,3075,7,0,0,0,0,4360,03/09/20
Assam,0,88729,323,0,0,0,0,115279,03/09/20
Bihar,0,123794,646,0,0,0,0,141441,03/09/20
Chandigarh,0,2670,59,0,0,0,0,4789,03/09/20
Chhattisgarh,0,18220,299,0,0,0,0,35683,03/09/20
Dadra and Nagar Haveli and Daman and Diu,0,2141,2,0,0,0,0,2435,03/09/20
Delhi,0,158586,4481,0,0,0,0,179569,03/09/20
Goa,0,14059,204,0,0,0,0,18642,03/09/20
Gujarat,0,79929,3046,0,0,0,0,98888,03/09/20
Haryana,0,54875,721,0,0,0,0,68218,03/09/20
Himachal Pradesh,0,4760,43,0,0,0,0,6416,03/09/20
Jammu and Kashmir,0,30079,732,0,0,0,0,38864,03/09/20
Jharkhand,0,29747,438,0,0,0,0,44862,03/09/20
Karnataka,0,260913,5950,0,0,0,0,361341,03/09/20
Kerala,0,55778,305,0,0,0,0,78072,03/09/20
Ladakh,0,2007,35,0,0,0,0,2785,03/09/20
Madhya Pradesh,0,51124,1453,0,0,0,0,66914,03/09/20
Maharashtra,0,598496,25195,0,0,0,0,825739,03/09/20
Manipur,0,4607,29,0,0,0,0,6507,03/09/20
Meghalaya,0,1318,13,0,0,0,0,2517,03/09/20
Mizoram,0,661,0,0,0,0,0,1020,03/09/20
Nagaland,0,3223,9,0,0,0,0,4017,03/09/20
Odisha,0,84073,514,0,0,0,0,109780,03/09/20
Puducherry,0,9968,253,0,0,0,0,15157,03/09/20
Punjab,0,39742,1618,0,0,0,0,56989,03/09/20
Rajasthan,0,70674,1081,0,0,0,0,84674,03/09/20
Sikkim,0,1269,4,0,0,0,0,1704,03/09/20
Tamil Nadu,0,380063,7516,0,0,0,0,439959,03/09/20
Telengana,0,100013,856,0,0,0,0,133406,03/09/20
Tripura,0,8033,126,0,0,0,0,13292,03/09/20
Uttarakhand,0,14501,291,0,0,0,0,21234,03/09/20
Uttar Pradesh,0,181364,3616,0,0,0,0,241439,03/09/20
West Bengal,0,140913,3339,0,0,0,0,168697,03/09/20
Andaman and Nicobar Islands,0,2823,48,0,0,0,0,3223,04/09/20
Andhra Pradesh,0,358009,4200,0,0,0,0,465730,04/09/20
Arunachal Pradesh,0,3167,7,0,0,0,0,4574,04/09/20
Assam,0,90700,330,0,0,0,0,118333,04/09/20
Bihar,0,124976,672,0,0,0,0,142967,04/09/20
Chandigarh,0,2883,63,0,0,0,0,5065,04/09/20
Chhattisgarh,0,18950,315,0,0,0,0,37967,04/09/20
Dadra and Nagar Haveli and Daman and Diu,0,2154,2,0,0,0,0,2450,04/09/20
Delhi,0,160114,4500,0,0,0,0,182306,04/09/20
Goa,0,14361,212,0,0,0,0,19355,04/09/20
Gujarat,0,81055,3062,0,0,0,0,100213,04/09/20
Haryana,0,55889,740,0,0,0,0,70099,04/09/20
Himachal Pradesh,0,4859,48,0,0,0,0,6615,04/09/20
Jammu and Kashmir,0,30759,743,0,0,0,0,39943,04/09/20
Jharkhand,0,30886,444,0,0,0,0,46480,04/09/20
Karnataka,0,268035,6054,0,0,0,0,370206,04/09/20
Kerala,0,57728,315,0,0,0,0,79625,04/09/20
Ladakh,0,2039,35,0,0,0,0,2840,04/09/20
Madhya Pradesh,0,52215,1483,0,0,0,0,68586,04/09/20
Maharashtra,0,612484,25586,0,0,0,0,843844,04/09/20
Manipur,0,4774,32,0,0,0,0,6609,04/09/20
Meghalaya,0,1393,13,0,0,0,0,2626,04/09/20
Mizoram,0,671,0,0,0,0,0,1040,04/09/20
Nagaland,0,3324,9,0,0,0,0,4066,04/09/20
Odisha,0,87351,522,0,0,0,0,113411,04/09/20
Puducherry,0,10279,260,0,0,0,0,15581,04/09/20
Punjab,0,41271,1690,0,0,0,0,58515,04/09/20
Rajasthan,0,71220,1095,0,0,0,0,86227,04/09/20
Sikkim,0,1304,4,0,0,0,0,1738,04/09/20
Tamil Nadu,0,386173,7608,0,0,0,0,445851,04/09/20
Telengana,0,102024,866,0,0,0,0,135884,04/09/20
Tripura,0,8212,129,0,0,0,0,13816,04/09/20
Uttarakhand,0,15009,300,0,0,0,0,22180,04/09/20
Uttar Pradesh,0,185812,3691,0,0,0,0,247101,04/09/20
West Bengal,0,144248,3394,0,0,0,0,171681,04/09/20
Andaman and Nicobar Islands,0,2863,49,0,0,0,0,3257,05/09/20
Andhra Pradesh,0,370163,4276,0,0,0,0,476506,05/09/20
Arunachal Pradesh,0,3280,7,0,0,0,0,4775,05/09/20
Assam,0,92720,345,0,0,0,0,121224,05/09/20
Bihar,0,126371,701,0,0,0,0,144104,05/09/20
Chandigarh,0,3105,68,0,0,0,0,5268,05/09/20
Chhattisgarh,0,19625,337,0,0,0,0,40634,05/09/20
Dadra and Nagar Haveli and Daman and Diu,0,2180,2,0,0,0,0,2467,05/09/20
Delhi,0,161865,4513,0,0,0,0,185220,05/09/20
Goa,0,14747,220,0,0,0,0,19863,05/09/20
Gujarat,0,82273,3076,0,0,0,0,101533,05/09/20
Haryana,0,57171,759,0,0,0,0,71983,05/09/20
Himachal Pradesh,0,4965,50,0,0,0,0,6830,05/09/20
Jammu and Kashmir,0,31435,755,0,0,0,0,40990,05/09/20
Jharkhand,0,32043,447,0,0,0,0,48039,05/09/20
Karnataka,0,274196,6170,0,0,0,0,379486,05/09/20
Kerala,0,60444,326,0,0,0,0,82104,05/09/20
Ladakh,0,2085,35,0,0,0,0,2935,05/09/20
Madhya Pradesh,0,53257,1513,0,0,0,0,70244,05/09/20
Maharashtra,0,625773,25964,0,0,0,0,863062,05/09/20
Manipur,0,4899,35,0,0,0,0,6699,05/09/20
Meghalaya,0,1468,14,0,0,0,0,2734,05/09/20
Mizoram,0,683,0,0,0,0,0,1046,05/09/20
Nagaland,0,3361,10,0,0,0,0,4107,05/09/20
Odisha,0,90331,531,0,0,0,0,116678,05/09/20
Puducherry,0,10674,280,0,0,0,0,16164,05/09/20
Punjab,0,42543,1739,0,0,0,0,60013,05/09/20
Rajasthan,0,71899,1108,0,0,0,0,87797,05/09/20
Sikkim,0,1329,5,0,0,0,0,1843,05/09/20
Tamil Nadu,0,392507,7687,0,0,0,0,451827,05/09/20
Telengana,0,104603,877,0,0,0,0,138395,05/09/20
Tripura,0,8483,136,0,0,0,0,14507,05/09/20
Uttarakhand,0,15511,312,0,0,0,0,23011,05/09/20
Uttar Pradesh,0,190818,3762,0,0,0,0,253175,05/09/20
West Bengal,0,147553,3452,0,0,0,0,174659,05/09/20
Andaman and Nicobar Islands,0,2904,50,0,0,0,0,3292,06/09/20
Andhra Pradesh,0,382104,4347,0,0,0,0,487331,06/09/20
Arunachal Pradesh,0,3381,8,0,0,0,0,4914,06/09/20
Assam,0,95063,352,0,0,0,0,123922,06/09/20
Bihar,0,128503,735,0,0,0,0,145832,06/09/20
Chandigarh,0,3290,69,0,0,0,0,5502,06/09/20
Chhattisgarh,0,20487,356,0,0,0,0,43163,06/09/20
Dadra and Nagar Haveli and Daman and Diu,0,2234,2,0,0,0,0,2537,06/09/20
Delhi,0,163785,4538,0,0,0,0,188193,06/09/20
Goa,0,15281,229,0,0,0,0,20455,06/09/20
Gujarat,0,83419,3091,0,0,0,0,102844,06/09/20
Haryana,0,58580,781,0,0,0,0,74272,06/09/20
Himachal Pradesh,0,4986,54,0,0,0,0,7018,06/09/20
Jammu and Kashmir,0,31924,770,0,0,0,0,42241,06/09/20
Jharkhand,0,34330,462,0,0,0,0,49797,06/09/20
Karnataka,0,283298,6298,0,0,0,0,389232,06/09/20
Kerala,0,62555,337,0,0,0,0,84759,06/09/20
Ladakh,0,2127,35,0,0,0,0,2996,06/09/20
Madhya Pradesh,0,54649,1543,0,0,0,0,71880,06/09/20
Maharashtra,0,636574,26276,0,0,0,0,883862,06/09/20
Manipur,0,4975,36,0,0,0,0,6883,06/09/20
Meghalaya,0,1527,15,0,0,0,0,2916,06/09/20
Mizoram,0,718,0,0,0,0,0,1062,06/09/20
Nagaland,0,3392,10,0,0,0,0,4128,06/09/20
Odisha,0,93774,538,0,0,0,0,120221,06/09/20
Puducherry,0,11107,298,0,0,0,0,16566,06/09/20
Punjab,0,43849,1808,0,0,0,0,61527,06/09/20
Rajasthan,0,73245,1122,0,0,0,0,89363,06/09/20
Sikkim,0,1347,5,0,0,0,0,1901,06/09/20
Tamil Nadu,0,398366,7748,0,0,0,0,457697,06/09/20
Telengana,0,107530,886,0,0,0,0,140969,06/09/20
Tripura,0,8745,144,0,0,0,0,15109,06/09/20
Uttarakhand,0,16056,330,0,0,0,0,23961,06/09/20
Uttar Pradesh,0,195959,3843,0,0,0,0,259765,06/09/20
West Bengal,0,150801,3510,0,0,0,0,177701,06/09/20
Andaman and Nicobar Islands,0,2951,50,0,0,0,0,3332,07/09/20
Andhra Pradesh,0,394019,4417,0,0,0,0,498125,07/09/20
Arunachal Pradesh,0,3472,8,0,0,0,0,5000,07/09/20
Assam,0,96826,360,0,0,0,0,125459,07/09/20
Bihar,0,130485,750,0,0,0,0,147661,07/09/20
Chandigarh,0,3439,71,0,0,0,0,5763,07/09/20
Chhattisgarh,0,21198,380,0,0,0,0,45263,07/09/20
Dadra and Nagar Haveli and Daman and Diu,0,2271,2,0,0,0,0,2575,07/09/20
Delhi,0,165973,4567,0,0,0,0,191449,07/09/20
Goa,0,15839,236,0,0,0,0,20829,07/09/20
Gujarat,0,84631,3105,0,0,0,0,104179,07/09/20
Haryana,0,60051,806,0,0,0,0,76549,07/09/20
Himachal Pradesh,0,5184,55,0,0,0,0,7415,07/09/20
Jammu and Kashmir,0,32327,784,0,0,0,0,43557,07/09/20
Jharkhand,0,36184,469,0,0,0,0,51063,07/09/20
Karnataka,0,292873,6393,0,0,0,0,398551,07/09/20
Kerala,0,64751,347,0,0,0,0,87841,07/09/20
Ladakh,0,2151,35,0,0,0,0,3036,07/09/20
Madhya Pradesh,0,55887,1572,0,0,0,0,73574,07/09/20
Maharashtra,0,644400,26604,0,0,0,0,907212,07/09/20
Manipur,0,5164,38,0,0,0,0,7022,07/09/20
Meghalaya,0,1556,16,0,0,0,0,3005,07/09/20
Mizoram,0,734,0,0,0,0,0,1114,07/09/20
Nagaland,0,3511,10,0,0,0,0,4178,07/09/20
Odisha,0,96364,546,0,0,0,0,124031,07/09/20
Puducherry,0,11632,314,0,0,0,0,17032,07/09/20
Punjab,0,45455,1862,0,0,0,0,63473,07/09/20
Rajasthan,0,74861,1137,0,0,0,0,90956,07/09/20
Sikkim,0,1371,5,0,0,0,0,1910,07/09/20
Tamil Nadu,0,404186,7836,0,0,0,0,463480,07/09/20
Telengana,0,110241,895,0,0,0,0,142771,07/09/20
Tripura,0,9048,149,0,0,0,0,15508,07/09/20
Uttarakhand,0,16648,341,0,0,0,0,24629,07/09/20
Uttar Pradesh,0,200738,3920,0,0,0,0,266283,07/09/20
West Bengal,0,154008,3562,0,0,0,0,180788,07/09/20
Andaman and Nicobar Islands,0,2997,50,0,0,0,0,3359,08/09/20
Andhra Pradesh,0,404074,4487,0,0,0,0,506493,08/09/20
Arunachal Pradesh,0,3596,8,0,0,0,0,5180,08/09/20
Assam,0,99076,370,0,0,0,0,128244,08/09/20
Bihar,0,132145,761,0,0,0,0,149027,08/09/20
Chandigarh,0,3734,74,0,0,0,0,5995,08/09/20
Chhattisgarh,0,22177,395,0,0,0,0,47280,08/09/20
Dadra and Nagar Haveli and Daman and Diu,0,2291,2,0,0,0,0,2590,08/09/20
Delhi,0,168384,4599,0,0,0,0,193526,08/09/20
Goa,0,16427,245,0,0,0,0,21173,08/09/20
Gujarat,0,85907,3120,0,0,0,0,105509,08/09/20
Haryana,0,61611,829,0,0,0,0,78773,08/09/20
Himachal Pradesh,0,5370,56,0,0,0,0,7660,08/09/20
Jammu and Kashmir,0,32760,801,0,0,0,0,44570,08/09/20
Jharkhand,0,37550,482,0,0,0,0,52620,08/09/20
Karnataka,0,300770,6534,0,0,0,0,404324,08/09/20
Kerala,0,66997,359,0,0,0,0,89489,08/09/20
Ladakh,0,2211,35,0,0,0,0,3064,08/09/20
Madhya Pradesh,0,56909,1589,0,0,0,0,75459,08/09/20
Maharashtra,0,659322,27027,0,0,0,0,923641,08/09/20
Manipur,0,5358,38,0,0,0,0,7106,08/09/20
Meghalaya,0,1560,17,0,0,0,0,3034,08/09/20
Mizoram,0,735,0,0,0,0,0,1114,08/09/20
Nagaland,0,3685,10,0,0,0,0,4220,08/09/20
Odisha,0,99398,556,0,0,0,0,127892,08/09/20
Puducherry,0,12135,325,0,0,0,0,17316,08/09/20
Punjab,0,47020,1923,0,0,0,0,65583,08/09/20
Rajasthan,0,76427,1151,0,0,0,0,92536,08/09/20
Sikkim,0,1396,5,0,0,0,0,1939,08/09/20
Tamil Nadu,0,410116,7925,0,0,0,0,469256,08/09/20
Telengana,0,112587,906,0,0,0,0,145163,08/09/20
Tripura,0,9342,152,0,0,0,0,16135,08/09/20
Uttarakhand,0,17123,348,0,0,0,0,25436,08/09/20
Uttar Pradesh,0,205731,3976,0,0,0,0,271851,08/09/20
West Bengal,0,157029,3620,0,0,0,0,183865,08/09/20
Andaman and Nicobar Islands,0,3035,50,0,0,0,0,3392,09/09/20
Andhra Pradesh,0,415765,4560,0,0,0,0,517094,09/09/20
Arunachal Pradesh,0,3723,9,0,0,0,0,5402,09/09/20
Assam,0,101239,378,0,0,0,0,130823,09/09/20
Bihar,0,134391,765,0,0,0,0,150502,09/09/20
Chandigarh,0,3960,78,0,0,0,0,6372,09/09/20
Chhattisgarh,0,22792,407,0,0,0,0,50114,09/09/20
Dadra and Nagar Haveli and Daman and Diu,0,2321,2,0,0,0,0,2617,09/09/20
Delhi,0,170140,4618,0,0,0,0,197135,09/09/20
Goa,0,16875,256,0,0,0,0,21630,09/09/20
Gujarat,0,87352,3133,0,0,0,0,106804,09/09/20
Haryana,0,63315,854,0,0,0,0,81059,09/09/20
Himachal Pradesh,0,5445,60,0,0,0,0,7831,09/09/20
Jammu and Kashmir,0,33251,815,0,0,0,0,45925,09/09/20
Jharkhand,0,39362,496,0,0,0,0,55296,09/09/20
Karnataka,0,308573,6680,0,0,0,0,412190,09/09/20
Kerala,0,68863,372,0,0,0,0,92515,09/09/20
Ladakh,0,2211,35,0,0,0,0,3102,09/09/20
Madhya Pradesh,0,58509,1609,0,0,0,0,77323,09/09/20
Maharashtra,0,672556,27407,0,0,0,0,943772,09/09/20
Manipur,0,5480,39,0,0,0,0,7202,09/09/20
Meghalaya,0,1716,17,0,0,0,0,3076,09/09/20
Mizoram,0,745,0,0,0,0,0,1123,09/09/20
Nagaland,0,3739,10,0,0,0,0,4245,09/09/20
Odisha,0,102185,569,0,0,0,0,131382,09/09/20
Puducherry,0,12581,337,0,0,0,0,17749,09/09/20
Punjab,0,49327,1990,0,0,0,0,67547,09/09/20
Rajasthan,0,77872,1164,0,0,0,0,94126,09/09/20
Sikkim,0,1413,7,0,0,0,0,1958,09/09/20
Tamil Nadu,0,416715,8012,0,0,0,0,474940,09/09/20
Telengana,0,115072,916,0,0,0,0,147642,09/09/20
Tripura,0,9653,161,0,0,0,0,16717,09/09/20
Uttarakhand,0,17473,360,0,0,0,0,26094,09/09/20
Uttar Pradesh,0,211170,4047,0,0,0,0,278473,09/09/20
West Bengal,0,160025,3677,0,0,0,0,186956,09/09/20
Andaman and Nicobar Islands,0,3078,51,0,0,0,0,3426,10/09/20
Andhra Pradesh,0,425607,4634,0,0,0,0,527512,10/09/20
Arunachal Pradesh,0,3906,9,0,0,0,0,5545,10/09/20
Assam,0,103504,396,0,0,0,0,133066,10/09/20
Bihar,0,135791,775,0,0,0,0,152192,10/09/20
Chandigarh,0,4140,80,0,0,0,0,6704,10/09/20
Chhattisgarh,0,24414,477,0,0,0,0,52932,10/09/20
Dadra and Nagar Haveli and Daman and Diu,0,2346,2,0,0,0,0,2643,10/09/20
Delhi,0,172763,4638,0,0,0,0,201174,10/09/20
Goa,0,17156,262,0,0,0,0,22251,10/09/20
Gujarat,0,88688,3149,0,0,0,0,108133,10/09/20
Haryana,0,65143,882,0,0,0,0,83353,10/09/20
Himachal Pradesh,0,5597,63,0,0,0,0,8147,10/09/20
Jammu and Kashmir,0,33871,832,0,0,0,0,47542,10/09/20
Jharkhand,0,40659,512,0,0,0,0,56897,10/09/20
Karnataka,0,315433,6808,0,0,0,0,421730,10/09/20
Kerala,0,70917,384,0,0,0,0,95917,10/09/20
Ladakh,0,2329,35,0,0,0,0,3142,10/09/20
Madhya Pradesh,0,59850,1640,0,0,0,0,79192,10/09/20
Maharashtra,0,686462,27787,0,0,0,0,967349,10/09/20
Manipur,0,5548,40,0,0,0,0,7362,10/09/20
Meghalaya,0,1823,19,0,0,0,0,3197,10/09/20
Mizoram,0,750,0,0,0,0,0,1192,10/09/20
Nagaland,0,3787,10,0,0,0,0,4375,10/09/20
Odisha,0,105295,580,0,0,0,0,135130,10/09/20
Puducherry,0,12967,347,0,0,0,0,18084,10/09/20
Punjab,0,50558,2061,0,0,0,0,69684,10/09/20
Rajasthan,0,79450,1178,0,0,0,0,95736,10/09/20
Sikkim,0,1429,7,0,0,0,0,1989,10/09/20
Tamil Nadu,0,423231,8090,0,0,0,0,480524,10/09/20
Telengana,0,117143,927,0,0,0,0,150176,10/09/20
Tripura,0,9993,173,0,0,0,0,17252,10/09/20
Uttarakhand,0,18262,372,0,0,0,0,27211,10/09/20
Uttar Pradesh,0,216901,4112,0,0,0,0,285041,10/09/20
West Bengal,0,162992,3730,0,0,0,0,190063,10/09/20
Andaman and Nicobar Islands,0,3121,51,0,0,0,0,3465,11/09/20
Andhra Pradesh,0,435647,4702,0,0,0,0,537687,11/09/20
Arunachal Pradesh,0,4005,9,0,0,0,0,5672,11/09/20
Assam,0,105701,414,0,0,0,0,135805,11/09/20
Bihar,0,137544,785,0,0,0,0,153568,11/09/20
Chandigarh,0,4331,83,0,0,0,0,6987,11/09/20
Chhattisgarh,0,25855,493,0,0,0,0,55680,11/09/20
Dadra and Nagar Haveli and Daman and Diu,0,2375,2,0,0,0,0,2671,11/09/20
Delhi,0,175400,4666,0,0,0,0,205482,11/09/20
Goa,0,17592,268,0,0,0,0,22890,11/09/20
Gujarat,0,90103,3164,0,0,0,0,109465,11/09/20
Haryana,0,66705,907,0,0,0,0,85944,11/09/20
Himachal Pradesh,0,5677,66,0,0,0,0,8466,11/09/20
Jammu and Kashmir,0,34215,845,0,0,0,0,49134,11/09/20
Jharkhand,0,42115,517,0,0,0,0,58079,11/09/20
Karnataka,0,322454,6937,0,0,0,0,430947,11/09/20
Kerala,0,72578,396,0,0,0,0,99266,11/09/20
Ladakh,0,2366,36,0,0,0,0,3177,11/09/20
Madhya Pradesh,0,61285,1661,0,0,0,0,81379,11/09/20
Maharashtra,0,700715,28282,0,0,0,0,990795,11/09/20
Manipur,0,5793,44,0,0,0,0,7470,11/09/20
Meghalaya,0,1842,20,0,0,0,0,3296,11/09/20
Mizoram,0,750,0,0,0,0,0,1333,11/09/20
Nagaland,0,3792,10,0,0,0,0,4636,11/09/20
Odisha,0,108001,591,0,0,0,0,139121,11/09/20
Puducherry,0,13389,353,0,0,0,0,18536,11/09/20
Punjab,0,51906,2149,0,0,0,0,72143,11/09/20
Rajasthan,0,80482,1192,0,0,0,0,97376,11/09/20
Sikkim,0,1470,7,0,0,0,0,2009,11/09/20
Tamil Nadu,0,429416,8154,0,0,0,0,486052,11/09/20
Telengana,0,119467,940,0,0,0,0,152602,11/09/20
Tripura,0,10255,173,0,0,0,0,17811,11/09/20
Uttarakhand,0,18783,377,0,0,0,0,28266,11/09/20
Uttar Pradesh,0,221506,4206,0,0,0,0,292029,11/09/20
West Bengal,0,166027,3771,0,0,0,0,193175,11/09/20
Andaman and Nicobar Islands,0,3157,51,0,0,0,0,3494,12/09/20
Andhra Pradesh,0,446716,4779,0,0,0,0,547686,12/09/20
Arunachal Pradesh,0,4126,10,0,0,0,0,5825,12/09/20
Assam,0,108329,430,0,0,0,0,138339,12/09/20
Bihar,0,139458,797,0,0,0,0,155445,12/09/20
Chandigarh,0,4600,86,0,0,0,0,7292,12/09/20
Chhattisgarh,0,27123,519,0,0,0,0,58643,12/09/20
Dadra and Nagar Haveli and Daman and Diu,0,2413,2,0,0,0,0,2695,12/09/20
Delhi,0,178154,4687,0,0,0,0,209748,12/09/20
Goa,0,18065,276,0,0,0,0,23445,12/09/20
Gujarat,0,91343,3180,0,0,0,0,110809,12/09/20
Haryana,0,68525,932,0,0,0,0,88332,12/09/20
Himachal Pradesh,0,5839,71,0,0,0,0,8784,12/09/20
Jammu and Kashmir,0,34689,854,0,0,0,0,50712,12/09/20
Jharkhand,0,43328,532,0,0,0,0,59040,12/09/20
Karnataka,0,334999,7067,0,0,0,0,440411,12/09/20
Kerala,0,73900,410,0,0,0,0,102254,12/09/20
Ladakh,0,2387,38,0,0,0,0,3228,12/09/20
Madhya Pradesh,0,62936,1691,0,0,0,0,83619,12/09/20
Maharashtra,0,715023,28724,0,0,0,0,1015681,12/09/20
Manipur,0,6002,44,0,0,0,0,7579,12/09/20
Meghalaya,0,1889,24,0,0,0,0,3447,12/09/20
Mizoram,0,790,0,0,0,0,0,1379,12/09/20
Nagaland,0,3802,10,0,0,0,0,4946,12/09/20
Odisha,0,112062,605,0,0,0,0,143117,12/09/20
Puducherry,0,13783,365,0,0,0,0,19026,12/09/20
Punjab,0,53308,2212,0,0,0,0,74616,12/09/20
Rajasthan,0,81970,1207,0,0,0,0,99036,12/09/20
Sikkim,0,1486,8,0,0,0,0,2026,12/09/20
Tamil Nadu,0,435422,8231,0,0,0,0,491571,12/09/20
Telengana,0,121925,950,0,0,0,0,154880,12/09/20
Tripura,0,10734,182,0,0,0,0,18281,12/09/20
Uttarakhand,0,19428,388,0,0,0,0,29221,12/09/20
Uttar Pradesh,0,227442,4282,0,0,0,0,299045,12/09/20
West Bengal,0,169043,3828,0,0,0,0,196332,12/09/20
Andaman and Nicobar Islands,0,3202,51,0,0,0,0,3521,13/09/20
Andhra Pradesh,0,457008,4846,0,0,0,0,557587,13/09/20
Arunachal Pradesh,0,4253,10,0,0,0,0,5975,13/09/20
Assam,0,110885,453,0,0,0,0,140471,13/09/20
Bihar,0,141499,808,0,0,0,0,156703,13/09/20
Chandigarh,0,4864,92,0,0,0,0,7542,13/09/20
Chhattisgarh,0,27978,539,0,0,0,0,61763,13/09/20
Dadra and Nagar Haveli and Daman and Diu,0,2444,2,0,0,0,0,2725,13/09/20
Delhi,0,181295,4715,0,0,0,0,214069,13/09/20
Goa,0,18576,286,0,0,0,0,24185,13/09/20
Gujarat,0,92678,3195,0,0,0,0,112174,13/09/20
Haryana,0,70713,956,0,0,0,0,91115,13/09/20
Himachal Pradesh,0,5962,73,0,0,0,0,9229,13/09/20
Jammu and Kashmir,0,35285,864,0,0,0,0,52410,13/09/20
Jharkhand,0,45074,542,0,0,0,0,60460,13/09/20
Karnataka,0,344556,7161,0,0,0,0,449551,13/09/20
Kerala,0,75844,425,0,0,0,0,105139,13/09/20
Ladakh,0,2414,39,0,0,0,0,3294,13/09/20
Madhya Pradesh,0,64398,1728,0,0,0,0,85966,13/09/20
Maharashtra,0,728512,29115,0,0,0,0,1037765,13/09/20
Manipur,0,6102,45,0,0,0,0,7731,13/09/20
Meghalaya,0,2020,25,0,0,0,0,3615,13/09/20
Mizoram,0,823,0,0,0,0,0,1414,13/09/20
Nagaland,0,3839,10,0,0,0,0,5064,13/09/20
Odisha,0,115279,616,0,0,0,0,146894,13/09/20
Puducherry,0,14228,370,0,0,0,0,19445,13/09/20
Punjab,0,55385,2288,0,0,0,0,77057,13/09/20
Rajasthan,0,82902,1221,0,0,0,0,100705,13/09/20
Sikkim,0,1503,11,0,0,0,0,2055,13/09/20
Tamil Nadu,0,441649,8307,0,0,0,0,497066,13/09/20
Telengana,0,124528,961,0,0,0,0,157096,13/09/20
Tripura,0,11132,194,0,0,0,0,18910,13/09/20
Uttarakhand,0,20153,402,0,0,0,0,30336,13/09/20
Uttar Pradesh,0,233527,4349,0,0,0,0,305831,13/09/20
West Bengal,0,172085,3887,0,0,0,0,199493,13/09/20
Andaman and Nicobar Islands,0,3243,51,0,0,0,0,3546,14/09/20
Andhra Pradesh,0,467139,4912,0,0,0,0,567123,14/09/20
Arunachal Pradesh,0,4379,10,0,0,0,0,6121,14/09/20
Assam,0,113133,469,0,0,0,0,141763,14/09/20
Bihar,0,143350,822,0,0,0,0,158285,14/09/20
Chandigarh,0,5170,93,0,0,0,0,7991,14/09/20
Chhattisgarh,0,31931,555,0,0,0,0,63991,14/09/20
Dadra and Nagar Haveli and Daman and Diu,0,2488,2,0,0,0,0,2745,14/09/20
Delhi,0,184748,4744,0,0,0,0,218304,14/09/20
Goa,0,19129,290,0,0,0,0,24592,14/09/20
Gujarat,0,93883,3210,0,0,0,0,113500,14/09/20
Haryana,0,72587,975,0,0,0,0,93641,14/09/20
Himachal Pradesh,0,6114,77,0,0,0,0,9555,14/09/20
Jammu and Kashmir,0,35737,878,0,0,0,0,54096,14/09/20
Jharkhand,0,46583,555,0,0,0,0,61474,14/09/20
Karnataka,0,352958,7265,0,0,0,0,459445,14/09/20
Kerala,0,77699,439,0,0,0,0,108278,14/09/20
Ladakh,0,2436,40,0,0,0,0,3345,14/09/20
Madhya Pradesh,0,65998,1762,0,0,0,0,88247,14/09/20
Maharashtra,0,740061,29531,0,0,0,0,1060308,14/09/20
Manipur,0,6191,46,0,0,0,0,7875,14/09/20
Meghalaya,0,2075,26,0,0,0,0,3724,14/09/20
Mizoram,0,830,0,0,0,0,0,1428,14/09/20
Nagaland,0,3901,10,0,0,0,0,5083,14/09/20
Odisha,0,118642,626,0,0,0,0,150807,14/09/20
Puducherry,0,14570,385,0,0,0,0,19833,14/09/20
Punjab,0,57536,2356,0,0,0,0,79679,14/09/20
Rajasthan,0,84518,1236,0,0,0,0,102408,14/09/20
Sikkim,0,1505,14,0,0,0,0,2086,14/09/20
Tamil Nadu,0,447366,8381,0,0,0,0,502759,14/09/20
Telengana,0,127007,974,0,0,0,0,158513,14/09/20
Tripura,0,11536,200,0,0,0,0,19165,14/09/20
Uttarakhand,0,21040,414,0,0,0,0,31973,14/09/20
Uttar Pradesh,0,239485,4429,0,0,0,0,312036,14/09/20
West Bengal,0,175139,3945,0,0,0,0,202708,14/09/20
Andaman and Nicobar Islands,0,3278,52,0,0,0,0,3557,15/09/20
Andhra Pradesh,0,476903,4972,0,0,0,0,575079,15/09/20
Arunachal Pradesh,0,4531,11,0,0,0,0,6298,15/09/20
Assam,0,115054,482,0,0,0,0,144166,15/09/20
Bihar,0,145560,831,0,0,0,0,160366,15/09/20
Chandigarh,0,5300,98,0,0,0,0,8245,15/09/20
Chhattisgarh,0,33109,573,0,0,0,0,67327,15/09/20
Dadra and Nagar Haveli and Daman and Diu,0,2513,2,0,0,0,0,2763,15/09/20
Delhi,0,188122,4770,0,0,0,0,221533,15/09/20
Goa,0,19648,304,0,0,0,0,24898,15/09/20
Gujarat,0,95138,3227,0,0,0,0,114834,15/09/20
Haryana,0,74712,1000,0,0,0,0,96129,15/09/20
Himachal Pradesh,0,6182,82,0,0,0,0,9923,15/09/20
Jammu and Kashmir,0,36381,895,0,0,0,0,55325,15/09/20
Jharkhand,0,48112,561,0,0,0,0,62737,15/09/20
Karnataka,0,361823,7384,0,0,0,0,467689,15/09/20
Kerala,0,79809,454,0,0,0,0,110818,15/09/20
Ladakh,0,2475,41,0,0,0,0,3419,15/09/20
Madhya Pradesh,0,67711,1791,0,0,0,0,90730,15/09/20
Maharashtra,0,755850,29894,0,0,0,0,1077374,15/09/20
Manipur,0,6340,46,0,0,0,0,7971,15/09/20
Meghalaya,0,2151,27,0,0,0,0,3864,15/09/20
Mizoram,0,919,0,0,0,0,0,1468,15/09/20
Nagaland,0,3915,10,0,0,0,0,5214,15/09/20
Odisha,0,122024,637,0,0,0,0,155005,15/09/20
Puducherry,0,15027,394,0,0,0,0,20226,15/09/20
Punjab,0,58999,2424,0,0,0,0,82113,15/09/20
Rajasthan,0,86162,1250,0,0,0,0,104138,15/09/20
Sikkim,0,1521,16,0,0,0,0,2119,15/09/20
Tamil Nadu,0,453165,8434,0,0,0,0,508511,15/09/20
Telengana,0,129187,984,0,0,0,0,160571,15/09/20
Tripura,0,11925,207,0,0,0,0,19696,15/09/20
Uttarakhand,0,22213,429,0,0,0,0,33016,15/09/20
Uttar Pradesh,0,245417,4491,0,0,0,0,317195,15/09/20
West Bengal,0,178223,4003,0,0,0,0,205919,15/09/20
Andaman and Nicobar Islands,0,3318,52,0,0,0,0,3574,16/09/20
Andhra Pradesh,0,486531,5041,0,0,0,0,583925,16/09/20
Arunachal Pradesh,0,4658,13,0,0,0,0,6466,16/09/20
Assam,0,116903,492,0,0,0,0,146575,16/09/20
Bihar,0,146980,836,0,0,0,0,160871,16/09/20
Chandigarh,0,5502,99,0,0,0,0,8592,16/09/20
Chhattisgarh,0,34279,589,0,0,0,0,70777,16/09/20
Dadra and Nagar Haveli and Daman and Diu,0,2552,2,0,0,0,0,2783,16/09/20
Delhi,0,191203,4806,0,0,0,0,225796,16/09/20
Goa,0,20094,315,0,0,0,0,25511,16/09/20
Gujarat,0,96582,3244,0,0,0,0,116183,16/09/20
Haryana,0,77166,1026,0,0,0,0,98622,16/09/20
Himachal Pradesh,0,6444,90,0,0,0,0,10335,16/09/20
Jammu and Kashmir,0,37062,914,0,0,0,0,56654,16/09/20
Jharkhand,0,49750,571,0,0,0,0,64439,16/09/20
Karnataka,0,369229,7481,0,0,0,0,475265,16/09/20
Kerala,0,82341,466,0,0,0,0,114033,16/09/20
Ladakh,0,2517,44,0,0,0,0,3499,16/09/20
Madhya Pradesh,0,69613,1820,0,0,0,0,93053,16/09/20
Maharashtra,0,775273,30409,0,0,0,0,1097856,16/09/20
Manipur,0,6418,47,0,0,0,0,8210,16/09/20
Meghalaya,0,2190,28,0,0,0,0,4036,16/09/20
Mizoram,0,922,0,0,0,0,0,1480,16/09/20
Nagaland,0,3945,15,0,0,0,0,5229,16/09/20
Odisha,0,125738,645,0,0,0,0,158650,16/09/20
Puducherry,0,15522,405,0,0,0,0,20601,16/09/20
Punjab,0,60814,2514,0,0,0,0,84482,16/09/20
Rajasthan,0,87873,1264,0,0,0,0,105898,16/09/20
Sikkim,0,1690,19,0,0,0,0,2173,16/09/20
Tamil Nadu,0,458900,8502,0,0,0,0,514208,16/09/20
Telengana,0,131447,996,0,0,0,0,162844,16/09/20
Tripura,0,12435,217,0,0,0,0,20150,16/09/20
Uttarakhand,0,23230,438,0,0,0,0,34407,16/09/20
Uttar Pradesh,0,252097,4604,0,0,0,0,324036,16/09/20
West Bengal,0,181142,4062,0,0,0,0,209146,16/09/20
Andaman and Nicobar Islands,0,3345,52,0,0,0,0,3593,17/09/20
Andhra Pradesh,0,497376,5105,0,0,0,0,592760,17/09/20
Arunachal Pradesh,0,4787,13,0,0,0,0,6692,17/09/20
Assam,0,119367,511,0,0,0,0,148969,17/09/20
Bihar,0,148656,848,0,0,0,0,162463,17/09/20
Chandigarh,0,5683,104,0,0,0,0,8958,17/09/20
Chhattisgarh,0,35885,611,0,0,0,0,73966,17/09/20
Dadra and Nagar Haveli and Daman and Diu,0,2575,2,0,0,0,0,2810,17/09/20
Delhi,0,194516,4839,0,0,0,0,230269,17/09/20
Goa,0,20445,319,0,0,0,0,26139,17/09/20
Gujarat,0,98029,3256,0,0,0,0,117547,17/09/20
Haryana,0,78937,1045,0,0,0,0,101316,17/09/20
Himachal Pradesh,0,6558,91,0,0,0,0,10795,17/09/20
Jammu and Kashmir,0,37809,932,0,0,0,0,58244,17/09/20
Jharkhand,0,51357,579,0,0,0,0,66074,17/09/20
Karnataka,0,375809,7536,0,0,0,0,484990,17/09/20
Kerala,0,84608,480,0,0,0,0,117863,17/09/20
Ladakh,0,2536,46,0,0,0,0,3535,17/09/20
Madhya Pradesh,0,71535,1844,0,0,0,0,95515,17/09/20
Maharashtra,0,792832,30883,0,0,0,0,1121221,17/09/20
Manipur,0,6521,48,0,0,0,0,8320,17/09/20
Meghalaya,0,2264,29,0,0,0,0,4195,17/09/20
Mizoram,0,939,0,0,0,0,0,1506,17/09/20
Nagaland,0,3987,15,0,0,0,0,5263,17/09/20
Odisha,0,129859,656,0,0,0,0,162920,17/09/20
Puducherry,0,15923,418,0,0,0,0,21111,17/09/20
Punjab,0,63570,2592,0,0,0,0,87184,17/09/20
Rajasthan,0,89352,1279,0,0,0,0,107680,17/09/20
Sikkim,0,1722,19,0,0,0,0,2221,17/09/20
Tamil Nadu,0,464668,8559,0,0,0,0,519860,17/09/20
Telengana,0,133555,1005,0,0,0,0,165003,17/09/20
Tripura,0,12956,222,0,0,0,0,20676,17/09/20
Uttarakhand,0,24432,447,0,0,0,0,35947,17/09/20
Uttar Pradesh,0,258573,4690,0,0,0,0,330265,17/09/20
West Bengal,0,184113,4123,0,0,0,0,212383,17/09/20
Andaman and Nicobar Islands,196,3345,52,174,3378,52,3604,3593,2020-09-18 20:06:09.770345
Andhra Pradesh,90279,497376,5105,88197,508088,5177,601462,592760,2020-09-18 20:06:09.770345
Arunachal Pradesh,1892,4787,13,1871,4967,13,6851,6692,2020-09-18 20:06:09.770345
Assam,29091,119367,511,28208,121613,528,150349,148969,2020-09-18 20:06:09.770345
Bihar,12959,148656,848,13156,150040,855,164051,162463,2020-09-18 20:06:09.770345
Chandigarh,3171,5683,104,3085,6062,109,9256,8958,2020-09-18 20:06:09.770345
Chhattisgarh,37470,35885,611,36036,41111,628,77775,73966,2020-09-18 20:06:09.770345
Dadra and Nagar Haveli and Daman and Diu,233,2575,2,221,2608,2,2831,2810,2020-09-18 20:06:09.770345
Delhi,30914,194516,4839,31721,198103,4877,234701,230269,2020-09-18 20:06:09.770345
Goa,5375,20445,319,5612,20844,327,26783,26139,2020-09-18 20:06:09.770345
Gujarat,16262,98029,3256,15975,99681,3270,118926,117547,2020-09-18 20:06:09.770345
Haryana,21334,78937,1045,21014,81690,1069,103773,101316,2020-09-18 20:06:09.770345
Himachal Pradesh,4146,6558,91,4146,6946,98,11190,10795,2020-09-18 20:06:09.770345
Jammu and Kashmir,19503,37809,932,20239,38521,951,59711,58244,2020-09-18 20:06:09.770345
Jharkhand,14138,51357,579,13703,52807,590,67100,66074,2020-09-18 20:06:09.770345
Karnataka,101645,375809,7536,103650,383077,7629,494356,484990,2020-09-18 20:06:09.770345
Kerala,32775,84608,480,34380,87345,489,122214,117863,2020-09-18 20:06:09.770345
Ladakh,953,2536,46,972,2558,46,3576,3535,2020-09-18 20:06:09.770345
Lakshadweep,0,0,0,0,0,0,0,0,2020-09-18 20:06:09.770345
Madhya Pradesh,22136,71535,1844,21631,74398,1877,97906,95515,2020-09-18 20:06:09.770345
Maharashtra,297506,792832,30883,302135,812354,31351,1145840,1121221,2020-09-18 20:06:09.770345
Manipur,1751,6521,48,1841,6538,51,8430,8320,2020-09-18 20:06:09.770345
Meghalaya,1902,2264,29,1983,2342,31,4356,4195,2020-09-18 20:06:09.770345
Mizoram,567,939,0,585,949,0,1534,1506,2020-09-18 20:06:09.770345
Nagaland,1261,3987,15,1193,4098,15,5306,5263,2020-09-18 20:06:09.770345
Odisha,32405,129859,656,33026,133466,669,167161,162920,2020-09-18 20:06:09.770345
Puducherry,4770,15923,418,4744,16253,431,21428,21111,2020-09-18 20:06:09.770345
Punjab,21022,63570,2592,21568,65818,2646,90032,87184,2020-09-18 20:06:09.770345
Rajasthan,17049,89352,1279,17495,90685,1293,109473,107680,2020-09-18 20:06:09.770345
Sikkim,480,1722,19,463,1789,22,2274,2221,2020-09-18 20:06:09.770345
Tamil Nadu,46633,464668,8559,46610,470192,8618,525420,519860,2020-09-18 20:06:09.770345
Telengana,30443,133555,1005,30673,135357,1016,167046,165003,2020-09-18 20:06:09.770345
Tripura,7498,12956,222,7162,13559,228,20949,20676,2020-09-18 20:06:09.770345
Uttarakhand,11068,24432,447,11714,24965,460,37139,35947,2020-09-18 20:06:09.770345
Uttar Pradesh,67002,258573,4690,68235,263288,4771,336294,330265,2020-09-18 20:06:09.770345
West Bengal,24147,184113,4123,24336,187061,4183,215580,212383,2020-09-18 20:06:09.770345
Andaman and Nicobar Islands,174,3378,52,165,3414,52,3631,3604,2020-09-19 22:59:56.071362
Andhra Pradesh,88197,508088,5177,84423,519891,5244,609558,601462,2020-09-19 22:59:56.071362
Arunachal Pradesh,1871,4967,13,1886,5106,13,7005,6851,2020-09-19 22:59:56.071362
Assam,28208,121613,528,28631,123687,540,152858,150349,2020-09-19 22:59:56.071362
Bihar,13156,150040,855,12609,151750,859,165218,164051,2020-09-19 22:59:56.071362
Chandigarh,3085,6062,109,2978,6415,113,9506,9256,2020-09-19 22:59:56.071362
Chhattisgarh,36036,41111,628,36580,44392,645,81617,77775,2020-09-19 22:59:56.071362
Dadra and Nagar Haveli and Daman and Diu,221,2608,2,218,2639,2,2859,2831,2020-09-19 22:59:56.071362
Delhi,31721,198103,4877,32250,201671,4907,238828,234701,2020-09-19 22:59:56.071362
Goa,5612,20844,327,5730,21314,335,27379,26783,2020-09-19 22:59:56.071362
Gujarat,15975,99681,3270,16076,100974,3286,120336,118926,2020-09-19 22:59:56.071362
Haryana,21014,81690,1069,21291,83878,1092,106261,103773,2020-09-19 22:59:56.071362
Himachal Pradesh,4146,6946,98,4430,7081,111,11622,11190,2020-09-19 22:59:56.071362
Jammu and Kashmir,20239,38521,951,20770,39305,966,61041,59711,2020-09-19 22:59:56.071362
Jharkhand,13703,52807,590,13924,54052,602,68578,67100,2020-09-19 22:59:56.071362
Karnataka,103650,383077,7629,101148,394026,7808,502982,494356,2020-09-19 22:59:56.071362
Kerala,34380,87345,489,35795,90085,501,126381,122214,2020-09-19 22:59:56.071362
Ladakh,972,2558,46,987,2600,48,3635,3576,2020-09-19 22:59:56.071362
Lakshadweep,0,0,0,0,0,0,0,0,2020-09-19 22:59:56.071362
Madhya Pradesh,21631,74398,1877,21605,76952,1901,100458,97906,2020-09-19 22:59:56.071362
Maharashtra,302135,812354,31351,301273,834432,31791,1167496,1145840,2020-09-19 22:59:56.071362
Manipur,1841,6538,51,1926,6629,52,8607,8430,2020-09-19 22:59:56.071362
Meghalaya,1983,2342,31,1976,2437,32,4445,4356,2020-09-19 22:59:56.071362
Mizoram,585,949,0,575,973,0,1548,1534,2020-09-19 22:59:56.071362
Nagaland,1193,4098,15,1213,4129,15,5357,5306,2020-09-19 22:59:56.071362
Odisha,33026,133466,669,33092,137567,682,171341,167161,2020-09-19 22:59:56.071362
Puducherry,4744,16253,431,4736,16715,462,21913,21428,2020-09-19 22:59:56.071362
Punjab,21568,65818,2646,21662,68463,2708,92833,90032,2020-09-19 22:59:56.071362
Rajasthan,17495,90685,1293,17717,92265,1308,111290,109473,2020-09-19 22:59:56.071362
Sikkim,463,1789,22,422,1857,24,2303,2274,2020-09-19 22:59:56.071362
Tamil Nadu,46610,470192,8618,46506,475717,8685,530908,525420,2020-09-19 22:59:56.071362
Telengana,30673,135357,1016,30636,137508,1025,169169,167046,2020-09-19 22:59:56.071362
Tripura,7162,13559,228,7107,14142,235,21484,20949,2020-09-19 22:59:56.071362
Uttarakhand,11714,24965,460,11293,26250,464,38007,37139,2020-09-19 22:59:56.071362
Uttar Pradesh,68235,263288,4771,67825,270094,4869,342788,336294,2020-09-19 22:59:56.071362
West Bengal,24336,187061,4183,24509,190021,4242,218772,215580,2020-09-19 22:59:56.071362
Andaman and Nicobar Islands,165,3414,52,156,3436,52,3644,3631,2020-09-20 21:20:31.796443
Andhra Pradesh,84423,519891,5244,81763,530711,5302,617776,609558,2020-09-20 21:20:31.796443
Arunachal Pradesh,1886,5106,13,1957,5280,13,7250,7005,2020-09-20 21:20:31.796443
Assam,28631,123687,540,29362,125543,548,155453,152858,2020-09-20 21:20:31.796443
Bihar,12609,151750,859,12629,153298,861,166788,165218,2020-09-20 21:20:31.796443
Chandigarh,2978,6415,113,2911,6766,119,9796,9506,2020-09-20 21:20:31.796443
Chhattisgarh,36580,44392,645,37489,46081,664,84234,81617,2020-09-20 21:20:31.796443
Dadra and Nagar Haveli and Daman and Diu,218,2639,2,208,2677,2,2887,2859,2020-09-20 21:20:31.796443
Delhi,32250,201671,4907,32064,205890,4945,242899,238828,2020-09-20 21:20:31.796443
Goa,5730,21314,335,5920,21760,342,28022,27379,2020-09-20 21:20:31.796443
Gujarat,16076,100974,3286,16022,102444,3302,121768,120336,2020-09-20 21:20:31.796443
Haryana,21291,83878,1092,21682,86150,1120,108952,106261,2020-09-20 21:20:31.796443
Himachal Pradesh,4430,7081,111,4308,7484,116,11908,11622,2020-09-20 21:20:31.796443
Jammu and Kashmir,20770,39305,966,21281,40265,987,62533,61041,2020-09-20 21:20:31.796443
Jharkhand,13924,54052,602,13548,55697,615,69860,68578,2020-09-20 21:20:31.796443
Karnataka,101148,394026,7808,98583,404841,7922,511346,502982,2020-09-20 21:20:31.796443
Kerala,35795,90085,501,37535,92951,519,131005,126381,2020-09-20 21:20:31.796443
Ladakh,987,2600,48,993,2666,49,3708,3635,2020-09-20 21:20:31.796443
Lakshadweep,0,0,0,0,0,0,0,0,2020-09-20 21:20:31.796443
Madhya Pradesh,21605,76952,1901,21964,79158,1943,103065,100458,2020-09-20 21:20:31.796443
Maharashtra,301273,834432,31791,297866,857933,32216,1188015,1167496,2020-09-20 21:20:31.796443
Manipur,1926,6629,52,1946,6723,55,8724,8607,2020-09-20 21:20:31.796443
Meghalaya,1976,2437,32,2038,2483,36,4557,4445,2020-09-20 21:20:31.796443
Mizoram,575,973,0,588,990,0,1578,1548,2020-09-20 21:20:31.796443
Nagaland,1213,4129,15,1206,4171,15,5392,5357,2020-09-20 21:20:31.796443
Odisha,33092,137567,682,33202,141657,691,175550,171341,2020-09-20 21:20:31.796443
Puducherry,4736,16715,462,4785,17209,462,22456,21913,2020-09-20 21:20:31.796443
Punjab,21662,68463,2708,22399,70373,2757,95529,92833,2020-09-20 21:20:31.796443
Rajasthan,17717,92265,1308,17997,93805,1322,113124,111290,2020-09-20 21:20:31.796443
Sikkim,422,1857,24,426,1972,25,2423,2303,2020-09-20 21:20:31.796443
Tamil Nadu,46506,475717,8685,46453,481273,8751,536477,530908,2020-09-20 21:20:31.796443
Telengana,30636,137508,1025,30573,139700,1033,171306,169169,2020-09-20 21:20:31.796443
Tripura,7107,14142,235,6983,14810,239,22032,21484,2020-09-20 21:20:31.796443
Uttarakhand,11293,26250,464,12465,27142,478,40085,38007,2020-09-20 21:20:31.796443
Uttar Pradesh,67825,270094,4869,66874,276690,4953,348517,342788,2020-09-20 21:20:31.796443
West Bengal,24509,190021,4242,24648,193014,4298,221960,218772,2020-09-20 21:20:31.796443
Andaman and Nicobar Islands,147,3436,52,152,3469,52,3673,3644,2020-09-21 17:39:44
Andhra Pradesh,78836,530711,5302,74518,551821,5410,631749,617776,2020-09-21 17:39:44
Arunachal Pradesh,1964,5280,13,1939,5643,13,7595,7250,2020-09-21 17:39:44
Assam,28780,125543,548,29609,129133,578,159320,155453,2020-09-21 17:39:44
Bihar,13005,153298,861,12539,156242,870,169651,166788,2020-09-21 17:39:44
Chandigarh,2821,6766,119,2761,7411,126,10298,9796,2020-09-21 17:39:44
Chhattisgarh,37853,46081,664,37927,49564,690,88181,84234,2020-09-21 17:39:44
Dadra and Nagar Haveli and Daman and Diu,229,2677,2,220,2711,2,2933,2887,2020-09-21 17:39:44
Delhi,32097,205890,4945,30941,213304,5014,249259,242899,2020-09-21 17:39:44
Goa,5781,21760,342,5667,22726,360,28753,28022,2020-09-21 17:39:44
Gujarat,16208,102444,3302,16305,104964,3336,124605,121768,2020-09-21 17:39:44
Haryana,21411,86150,1120,21014,90884,1177,113075,108952,2020-09-21 17:39:44
Himachal Pradesh,4444,7484,116,4458,7853,127,12438,11908,2020-09-21 17:39:44
Jammu and Kashmir,22032,40265,987,21887,42115,1024,65026,62533,2020-09-21 17:39:44
Jharkhand,13791,55697,615,13504,58543,626,72673,69860,2020-09-21 17:39:44
Karnataka,98062,404841,7922,95354,423377,8145,526876,511346,2020-09-21 17:39:44
Kerala,39484,92951,519,39354,98724,553,138631,131005,2020-09-21 17:39:44
Ladakh,1013,2666,49,1047,2735,50,3832,3708,2020-09-21 17:39:44
Lakshadweep,0,0,0,0,0,0,0,0,2020-09-21 17:39:44
Madhya Pradesh,22300,79158,1943,22542,83618,2007,108167,103065,2020-09-21 17:39:44
Maharashtra,291630,857933,32216,275017,916348,33015,1224380,1188015,2020-09-21 17:39:44
Manipur,2070,6723,55,2113,6838,59,9010,8724,2020-09-21 17:39:44
Meghalaya,2111,2483,36,2169,2527,37,4733,4557,2020-09-21 17:39:44
Mizoram,583,990,0,680,1012,0,1692,1578,2020-09-21 17:39:44
Nagaland,1184,4171,15,1052,4477,15,5544,5392,2020-09-21 17:39:44
Odisha,33504,141657,691,34033,149379,710,184122,175550,2020-09-21 17:39:44
Puducherry,4908,17209,462,4659,18065,467,23191,22456,2020-09-21 17:39:44
Punjab,22278,70373,2757,21661,75409,2860,99930,95529,2020-09-21 17:39:44
Rajasthan,18184,93805,1322,18245,97284,1352,116881,113124,2020-09-21 17:39:44
Sikkim,469,1972,25,513,1986,29,2528,2423,2020-09-21 17:39:44
Tamil Nadu,46703,481273,8751,46495,491971,8871,547337,536477,2020-09-21 17:39:44
Telengana,29636,139700,1033,29649,144073,1052,174774,171306,2020-09-21 17:39:44
Tripura,6566,14810,239,6700,15883,251,22834,22032,2020-09-21 17:39:44
Uttarakhand,12455,276690,4953,12075,29201,501,41777,348517,2020-09-21 17:39:44
Uttar Pradesh,65954,27142,478,64164,289594,5135,358893,40085,2020-09-21 17:39:44
West Bengal,24806,193014,4298,24898,198983,4421,228302,221960,2020-09-21 17:39:44
Andaman and Nicobar Islands,147,3452,52,152,3469,52,3673,3651,2020-09-22 17:39:43.628108
Andhra Pradesh,78836,541319,5359,74518,551821,5410,631749,625514,2020-09-22 17:39:43.628108
Arunachal Pradesh,1964,5408,13,1939,5643,13,7595,7385,2020-09-22 17:39:43.628108
Assam,28780,127338,562,29609,129133,578,159320,156680,2020-09-22 17:39:43.628108
Bihar,13005,155155,864,12539,156242,870,169651,169024,2020-09-22 17:39:43.628108
Chandigarh,2821,7138,123,2761,7411,126,10298,10082,2020-09-22 17:39:43.628108
Chhattisgarh,37853,47653,677,37927,49564,690,88181,86183,2020-09-22 17:39:43.628108
Dadra and Nagar Haveli and Daman and Diu,229,2693,2,220,2711,2,2933,2924,2020-09-22 17:39:43.628108
Delhi,32097,209632,4982,30941,213304,5014,249259,246711,2020-09-22 17:39:43.628108
Goa,5781,22297,351,5667,22726,360,28753,28429,2020-09-22 17:39:43.628108
Gujarat,16208,103648,3319,16305,104964,3336,124605,123175,2020-09-22 17:39:43.628108
Haryana,21411,88697,1149,21014,90884,1177,113075,111257,2020-09-22 17:39:43.628108
Himachal Pradesh,4444,7565,120,4458,7853,127,12438,12129,2020-09-22 17:39:43.628108
Jammu and Kashmir,22032,40957,1001,21887,42115,1024,65026,63990,2020-09-22 17:39:43.628108
Jharkhand,13791,56944,617,13504,58543,626,72673,71352,2020-09-22 17:39:43.628108
Karnataka,98062,413452,8023,95354,423377,8145,526876,519537,2020-09-22 17:39:43.628108
Kerala,39484,95702,535,39354,98724,553,138631,135721,2020-09-22 17:39:43.628108
Ladakh,1013,2691,49,1047,2735,50,3832,3753,2020-09-22 17:39:43.628108
Lakshadweep,0,0,0,0,0,0,0,0,2020-09-22 17:39:43.628108
Madhya Pradesh,22300,81374,1970,22542,83618,2007,108167,105644,2020-09-22 17:39:43.628108
Maharashtra,291630,884341,32671,275017,916348,33015,1224380,1208642,2020-09-22 17:39:43.628108
Manipur,2070,6767,57,2113,6838,59,9010,8894,2020-09-22 17:39:43.628108
Meghalaya,2111,2513,36,2169,2527,37,4733,4660,2020-09-22 17:39:43.628108
Mizoram,583,1002,0,680,1012,0,1692,1585,2020-09-22 17:39:43.628108
Nagaland,1184,4252,15,1052,4477,15,5544,5451,2020-09-22 17:39:43.628108
Odisha,33504,145675,701,34033,149379,710,184122,179880,2020-09-22 17:39:43.628108
Puducherry,4908,17556,462,4659,18065,467,23191,22926,2020-09-22 17:39:43.628108
Punjab,22278,72598,2813,21661,75409,2860,99930,97689,2020-09-22 17:39:43.628108
Rajasthan,18184,95469,1336,18245,97284,1352,116881,114989,2020-09-22 17:39:43.628108
Sikkim,469,1975,28,513,1986,29,2528,2472,2020-09-22 17:39:43.628108
Tamil Nadu,46703,486479,8811,46495,491971,8871,547337,541993,2020-09-22 17:39:43.628108
Telengana,29636,141930,1042,29649,144073,1052,174774,172608,2020-09-22 17:39:43.628108
Tripura,6566,15464,245,6700,15883,251,22834,22275,2020-09-22 17:39:43.628108
Uttarakhand,12455,28017,491,12075,29201,501,41777,40963,2020-09-22 17:39:43.628108
Uttar Pradesh,65954,283274,5047,64164,289594,5135,358893,354275,2020-09-22 17:39:43.628108
West Bengal,24806,195972,4359,24898,198983,4421,228302,225137,2020-09-22 17:39:43.628108
Andaman and Nicobar Islands,152,3469,52,160,3479,52,3691,3673,2020-09-23 19:36:09.627165
Andhra Pradesh,74518,551821,5410,71465,562376,5461,639302,631749,2020-09-23 19:36:09.627165
Arunachal Pradesh,1939,5643,13,2052,5778,14,7844,7595,2020-09-23 19:36:09.627165
Assam,29609,129133,578,29857,130950,586,161393,159320,2020-09-23 19:36:09.627165
Bihar,12539,156242,870,12928,157454,873,171255,169651,2020-09-23 19:36:09.627165
Chandigarh,2761,7411,126,2622,7794,130,10546,10298,2020-09-23 19:36:09.627165
Chhattisgarh,37927,49564,690,38198,52001,718,90917,88181,2020-09-23 19:36:09.627165
Dadra and Nagar Haveli and Daman and Diu,220,2711,2,198,2744,2,2944,2933,2020-09-23 19:36:09.627165
Delhi,30941,213304,5014,31623,216401,5051,253075,249259,2020-09-23 19:36:09.627165
Goa,5667,22726,360,5513,23462,368,29343,28753,2020-09-23 19:36:09.627165
Gujarat,16305,104964,3336,16370,106285,3352,126007,124605,2020-09-23 19:36:09.627165
Haryana,21014,90884,1177,19888,93776,1206,114870,113075,2020-09-23 19:36:09.627165
Himachal Pradesh,4458,7853,127,4124,8511,134,12769,12438,2020-09-23 19:36:09.627165
Jammu and Kashmir,21887,42115,1024,21485,43734,1042,66261,65026,2020-09-23 19:36:09.627165
Jharkhand,13504,58543,626,13280,60027,641,73948,72673,2020-09-23 19:36:09.627165
Karnataka,95354,423377,8145,93172,432450,8228,533850,526876,2020-09-23 19:36:09.627165
Kerala,39354,98724,553,40453,101731,572,142756,138631,2020-09-23 19:36:09.627165
Ladakh,1047,2735,50,1028,2809,50,3887,3832,2020-09-23 19:36:09.627165
Lakshadweep,0,0,0,0,0,0,0,0,2020-09-23 19:36:09.627165
Madhya Pradesh,22542,83618,2007,22646,86030,2035,110711,108167,2020-09-23 19:36:09.627165
Maharashtra,275017,916348,33015,272809,936554,33407,1242770,1224380,2020-09-23 19:36:09.627165
Manipur,2113,6838,59,2333,6887,60,9280,9010,2020-09-23 19:36:09.627165
Meghalaya,2169,2527,37,2047,2706,38,4791,4733,2020-09-23 19:36:09.627165
Mizoram,680,1012,0,690,1023,0,1713,1692,2020-09-23 19:36:09.627165
Nagaland,1052,4477,15,1072,4517,15,5604,5544,2020-09-23 19:36:09.627165
Odisha,34033,149379,710,34377,153213,721,188311,184122,2020-09-23 19:36:09.627165
Puducherry,4659,18065,467,4757,18454,473,23684,23191,2020-09-23 19:36:09.627165
Punjab,21661,75409,2860,21288,77127,2926,101341,99930,2020-09-23 19:36:09.627165
Rajasthan,18245,97284,1352,18614,98812,1367,118793,116881,2020-09-23 19:36:09.627165
Sikkim,513,1986,29,556,2009,29,2594,2528,2020-09-23 19:36:09.627165
Tamil Nadu,46495,491971,8871,46350,497377,8947,552674,547337,2020-09-23 19:36:09.627165
Telengana,29649,144073,1052,29873,146135,1062,177070,174774,2020-09-23 19:36:09.627165
Tripura,6700,15883,251,6599,16486,253,23338,22834,2020-09-23 19:36:09.627165
Uttarakhand,12075,29201,501,11831,30308,512,42651,41777,2020-09-23 19:36:09.627165
Uttar Pradesh,64164,289594,5135,63148,296183,5212,364543,358893,2020-09-23 19:36:09.627165
West Bengal,24898,198983,4421,24971,202030,4483,231484,228302,2020-09-23 19:36:09.627165
Andaman and Nicobar Islands,160,3479,52,166,3494,52,3712,3691,2020-09-24 19:47:04.278984
Andhra Pradesh,71465,562376,5461,70357,570667,5506,646530,639302,2020-09-24 19:47:04.278984
Arunachal Pradesh,2052,5778,14,2216,5903,14,8133,7844,2020-09-24 19:47:04.278984
Assam,29857,130950,586,30182,132712,597,163491,161393,2020-09-24 19:47:04.278984
Bihar,12928,157454,873,12958,159022,874,172854,171255,2020-09-24 19:47:04.278984
Chandigarh,2622,7794,130,2537,8049,140,10726,10546,2020-09-24 19:47:04.278984
Chhattisgarh,38198,52001,718,35850,56773,728,93351,90917,2020-09-24 19:47:04.278984
Dadra and Nagar Haveli and Daman and Diu,198,2744,2,205,2755,2,2962,2944,2020-09-24 19:47:04.278984
Delhi,31623,216401,5051,30836,220866,5087,256789,253075,2020-09-24 19:47:04.278984
Goa,5513,23462,368,5646,23857,376,29879,29343,2020-09-24 19:47:04.278984
Gujarat,16370,106285,3352,16438,107574,3367,127379,126007,2020-09-24 19:47:04.278984
Haryana,19888,93776,1206,19276,96347,1233,116856,114870,2020-09-24 19:47:04.278984
Himachal Pradesh,4124,8511,134,3950,8959,140,13049,12769,2020-09-24 19:47:04.278984
Jammu and Kashmir,21485,43734,1042,19918,46530,1062,67510,66261,2020-09-24 19:47:04.278984
Jharkhand,13280,60027,641,12882,61559,648,75089,73948,2020-09-24 19:47:04.278984
Karnataka,93172,432450,8228,94671,437910,8266,540847,533850,2020-09-24 19:47:04.278984
Kerala,40453,101731,572,42858,104682,592,148132,142756,2020-09-24 19:47:04.278984
Ladakh,1028,2809,50,1038,2844,51,3933,3887,2020-09-24 19:47:04.278984
Lakshadweep,0,0,0,0,0,0,0,0,2020-09-24 19:47:04.278984
Madhya Pradesh,22646,86030,2035,22812,88168,2077,113057,110711,2020-09-24 19:47:04.278984
Maharashtra,272809,936554,33407,273883,956030,33886,1263799,1242770,2020-09-24 19:47:04.278984
Manipur,2333,6887,60,2206,7108,62,9376,9280,2020-09-24 19:47:04.278984
Meghalaya,2047,2706,38,2060,2859,42,4961,4791,2020-09-24 19:47:04.278984
Mizoram,690,1023,0,618,1095,0,1713,1713,2020-09-24 19:47:04.278984
Nagaland,1072,4517,15,1119,4536,16,5671,5604,2020-09-24 19:47:04.278984
Odisha,34377,153213,721,34547,157265,736,192548,188311,2020-09-24 19:47:04.278984
Puducherry,4757,18454,473,4853,18893,481,24227,23684,2020-09-24 19:47:04.278984
Punjab,21288,77127,2926,21230,79244,2990,103464,101341,2020-09-24 19:47:04.278984
Rajasthan,18614,98812,1367,18992,100365,1382,120739,118793,2020-09-24 19:47:04.278984
Sikkim,556,2009,29,575,2023,30,2628,2594,2020-09-24 19:47:04.278984
Tamil Nadu,46350,497377,8947,46249,502740,9010,557999,552674,2020-09-24 19:47:04.278984
Telengana,29873,146135,1062,30037,148139,1070,179246,177070,2020-09-24 19:47:04.278984
Tripura,6599,16486,253,6551,16978,260,23789,23338,2020-09-24 19:47:04.278984
Uttarakhand,11831,30308,512,11867,31324,529,43720,42651,2020-09-24 19:47:04.278984
Uttar Pradesh,63148,296183,5212,61698,302689,5299,369686,364543,2020-09-24 19:47:04.278984
West Bengal,24971,202030,4483,25101,205028,4544,234673,231484,2020-09-24 19:47:04.278984
Andaman and Nicobar Islands,166,3494,52,189,3503,52,3744,3712,2020-09-25 21:20:48.652041
Andhra Pradesh,70357,570667,5506,69353,579474,5558,654385,646530,2020-09-25 21:20:48.652041
Arunachal Pradesh,2216,5903,14,2331,6071,14,8416,8133,2020-09-25 21:20:48.652041
Assam,30182,132712,597,29830,135144,608,165582,163491,2020-09-25 21:20:48.652041
Bihar,12958,159022,874,13015,160178,878,174071,172854,2020-09-25 21:20:48.652041
Chandigarh,2537,8049,140,2482,8342,144,10968,10726,2020-09-25 21:20:48.652041
Chhattisgarh,35850,56773,728,36038,58833,752,95623,93351,2020-09-25 21:20:48.652041
Dadra and Nagar Haveli and Daman and Diu,205,2755,2,190,2785,2,2977,2962,2020-09-25 21:20:48.652041
Delhi,30836,220866,5087,31125,224375,5123,260623,256789,2020-09-25 21:20:48.652041
Goa,5646,23857,376,5822,24347,383,30552,29879,2020-09-25 21:20:48.652041
Gujarat,16438,107574,3367,16327,109079,3381,128787,127379,2020-09-25 21:20:48.652041
Haryana,19276,96347,1233,18889,98410,1255,118554,116856,2020-09-25 21:20:48.652041
Himachal Pradesh,3950,8959,140,3984,9252,150,13386,13049,2020-09-25 21:20:48.652041
Jammu and Kashmir,19918,46530,1062,19451,48079,1084,68614,67510,2020-09-25 21:20:48.652041
Jharkhand,12882,61559,648,12841,62945,652,76438,75089,2020-09-25 21:20:48.652041
Karnataka,94671,437910,8266,95568,444658,8331,548557,540847,2020-09-25 21:20:48.652041
Kerala,42858,104682,592,45993,107850,613,154456,148132,2020-09-25 21:20:48.652041
Ladakh,1038,2844,51,1022,2893,54,3969,3933,2020-09-25 21:20:48.652041
Lakshadweep,0,0,0,0,0,0,0,0,2020-09-25 21:20:48.652041
Madhya Pradesh,22812,88168,2077,22744,90495,2122,115361,113057,2020-09-25 21:20:48.652041
Maharashtra,273883,956030,33886,275404,973214,34345,1282963,1263799,2020-09-25 21:20:48.652041
Manipur,2206,7108,62,2106,7369,62,9537,9376,2020-09-25 21:20:48.652041
Meghalaya,2060,2859,42,1977,3058,43,5078,4761,2020-09-25 21:20:48.652041
Mizoram,618,1095,0,681,1105,0,1786,1713,2020-09-25 21:20:48.652041
Nagaland,1119,4536,16,1088,4626,16,5730,5671,2020-09-25 21:20:48.652041
Odisha,34547,157265,736,35092,161044,752,196888,192548,2020-09-25 21:20:48.652041
Puducherry,4853,18893,481,5097,19311,487,24895,24227,2020-09-25 21:20:48.652041
Punjab,21230,79244,2990,20679,81475,3066,105220,103464,2020-09-25 21:20:48.652041
Rajasthan,18992,100365,1382,18993,102330,1397,122720,120739,2020-09-25 21:20:48.652041
Sikkim,575,2023,30,607,2054,31,2692,2628,2020-09-25 21:20:48.652041
Tamil Nadu,46249,502740,9010,46405,508210,9076,563691,557999,2020-09-25 21:20:48.652041
Telengana,30037,148139,1070,30387,150160,1080,181627,179246,2020-09-25 21:20:48.652041
Tripura,6551,16978,260,6378,17487,265,24130,23789,2020-09-25 21:20:48.652041
Uttarakhand,11867,31324,529,11507,32355,542,44404,43720,2020-09-25 21:20:48.652041
Uttar Pradesh,61698,302689,5299,61300,307611,5366,374277,369686,2020-09-25 21:20:48.652041
West Bengal,25101,205028,4544,25221,208042,4606,237869,234673,2020-09-25 21:20:48.652041
Andaman and Nicobar Islands,189,3503,52,179,3528,52,3759,3744,2020-09-26 19:03:53.307471
Andhra Pradesh,69353,579474,5558,67683,588169,5606,661458,654385,2020-09-26 19:03:53.307471
Arunachal Pradesh,2331,6071,14,2427,6230,14,8671,8416,2020-09-26 19:03:53.307471
Assam,29830,135144,608,30034,136715,625,167374,165582,2020-09-26 19:03:53.307471
Bihar,13015,160178,878,12773,161874,878,175525,174071,2020-09-26 19:03:53.307471
Chandigarh,2482,8342,144,2390,8677,145,11212,10968,2020-09-26 19:03:53.307471
Chhattisgarh,36038,58833,752,30928,66860,777,98565,95623,2020-09-26 19:03:53.307471
Dadra and Nagar Haveli and Daman and Diu,190,2785,2,182,2805,2,2989,2977,2020-09-26 19:03:53.307471
Delhi,31125,224375,5123,30867,228436,5147,264450,260623,2020-09-26 19:03:53.307471
Goa,5822,24347,383,5614,25071,386,31071,30552,2020-09-26 19:03:53.307471
Gujarat,16327,109079,3381,16478,110358,3393,130229,128787,2020-09-26 19:03:53.307471
Haryana,18889,98410,1255,18032,101273,1273,120578,118554,2020-09-26 19:03:53.307471
Himachal Pradesh,3984,9252,150,3976,9546,157,13679,13386,2020-09-26 19:03:53.307471
Jammu and Kashmir,19451,48079,1084,19170,49557,1105,69832,68614,2020-09-26 19:03:53.307471
Jharkhand,12841,62945,652,12533,64515,661,77709,76438,2020-09-26 19:03:53.307471
Karnataka,95568,444658,8331,98493,450302,8417,557212,548557,2020-09-26 19:03:53.307471
Kerala,45993,107850,613,48967,111331,635,160933,154456,2020-09-26 19:03:53.307471
Ladakh,1022,2893,54,998,2971,56,4025,3969,2020-09-26 19:03:53.307471
Lakshadweep,0,0,0,0,0,0,0,0,2020-09-26 19:03:53.307471
Madhya Pradesh,22744,90495,2122,22198,93238,2152,117588,115361,2020-09-26 19:03:53.307471
Maharashtra,275404,973214,34345,273190,992806,34761,1300757,1282963,2020-09-26 19:03:53.307471
Manipur,2106,7369,62,2126,7602,63,9791,9537,2020-09-26 19:03:53.307471
Meghalaya,1977,3058,43,1772,3343,43,5158,5078,2020-09-26 19:03:53.307471
Mizoram,681,1105,0,546,1289,0,1835,1786,2020-09-26 19:03:53.307471
Nagaland,1088,4626,16,1083,4669,16,5768,5730,2020-09-26 19:03:53.307471
Odisha,35092,161044,752,34897,165432,767,201096,196888,2020-09-26 19:03:53.307471
Puducherry,5097,19311,487,5214,19781,494,25489,24895,2020-09-26 19:03:53.307471
Punjab,20679,81475,3066,19937,84025,3134,107096,105220,2020-09-26 19:03:53.307471
Rajasthan,18993,102330,1397,19030,104288,1412,124730,122720,2020-09-26 19:03:53.307471
Sikkim,607,2054,31,679,2075,31,2785,2692,2020-09-26 19:03:53.307471
Tamil Nadu,46405,508210,9076,46386,513836,9148,569370,563691,2020-09-26 19:03:53.307471
Telengana,30387,150160,1080,30334,152441,1091,183866,181627,2020-09-26 19:03:53.307471
Tripura,6378,17487,265,6148,17992,268,24408,24130,2020-09-26 19:03:53.307471
Uttarakhand,11507,32355,542,10934,33843,555,45332,44404,2020-09-26 19:03:53.307471
Uttar Pradesh,61300,307611,5366,59397,313686,5450,378533,374277,2020-09-26 19:03:53.307471
West Bengal,25221,208042,4606,25374,211020,4665,241059,237869,2020-09-26 19:03:53.307471
Andaman and Nicobar Islands,179,3528,52,171,3551,52,3774,3759,2020-09-27 20:40:36.004618
Andhra Pradesh,67683,588169,5606,65794,597294,5663,668751,661458,2020-09-27 20:40:36.004618
Arunachal Pradesh,2427,6230,14,2458,6397,14,8869,8671,2020-09-27 20:40:36.004618
Assam,30034,136715,625,30162,138310,638,169110,167374,2020-09-27 20:40:36.004618
Bihar,12773,161874,878,12754,163432,886,177072,175525,2020-09-27 20:40:36.004618
Chandigarh,2390,8677,145,2298,8937,145,11380,11212,2020-09-27 20:40:36.004618
Chhattisgarh,30928,66860,777,30689,70955,817,102461,98565,2020-09-27 20:40:36.004618
Dadra and Nagar Haveli and Daman and Diu,182,2805,2,163,2831,2,2996,2989,2020-09-27 20:40:36.004618
Delhi,30867,228436,5147,29717,232912,5193,267822,264450,2020-09-27 20:40:36.004618
Goa,5614,25071,386,5424,25759,391,31574,31071,2020-09-27 20:40:36.004618
Gujarat,16478,110358,3393,16463,111777,3406,131646,130229,2020-09-27 20:40:36.004618
Haryana,18032,101273,1273,17149,103827,1291,122267,120578,2020-09-27 20:40:36.004618
Himachal Pradesh,3976,9546,157,4104,9728,164,13996,13679,2020-09-27 20:40:36.004618
Jammu and Kashmir,19170,49557,1105,18430,51494,1125,71049,69832,2020-09-27 20:40:36.004618
Jharkhand,12533,64515,661,12426,65839,670,78935,77709,2020-09-27 20:40:36.004618
Karnataka,98493,450302,8417,101801,455719,8503,566023,557212,2020-09-27 20:40:36.004618
Kerala,48967,111331,635,52753,114530,656,167939,160933,2020-09-27 20:40:36.004618
Ladakh,998,2971,56,1018,3018,57,4093,4025,2020-09-27 20:40:36.004618
Lakshadweep,0,0,0,0,0,0,0,0,2020-09-27 20:40:36.004618
Madhya Pradesh,22198,93238,2152,22228,95490,2181,119899,117588,2020-09-27 20:40:36.004618
Maharashtra,273190,992806,34761,269535,1016450,35191,1321176,1300757,2020-09-27 20:40:36.004618
Manipur,2126,7602,63,2306,7681,64,10051,9791,2020-09-27 20:40:36.004618
Meghalaya,1772,3343,43,1515,3654,43,5212,5158,2020-09-27 20:40:36.004618
Mizoram,546,1289,0,549,1316,0,1865,1835,2020-09-27 20:40:36.004618
Nagaland,1083,4669,16,1027,4819,16,5862,5768,2020-09-27 20:40:36.004618
Odisha,34897,165432,767,34476,170193,783,205452,201096,2020-09-27 20:40:36.004618
Puducherry,5214,19781,494,5327,20205,500,26032,25489,2020-09-27 20:40:36.004618
Punjab,19937,84025,3134,19483,86013,3188,108684,107096,2020-09-27 20:40:36.004618
Rajasthan,19030,104288,1412,19355,105994,1426,126775,124730,2020-09-27 20:40:36.004618
Sikkim,679,2075,31,705,2097,31,2833,2785,2020-09-27 20:40:36.004618
Tamil Nadu,46386,513836,9148,46336,519448,9233,575017,569370,2020-09-27 20:40:36.004618
Telengana,30334,152441,1091,30234,154499,1100,185833,183866,2020-09-27 20:40:36.004618
Tripura,6148,17992,268,6066,18392,270,24728,24408,2020-09-27 20:40:36.004618
Uttarakhand,10934,33843,555,10856,34859,566,46281,45332,2020-09-27 20:40:36.004618
Uttar Pradesh,59397,313686,5450,57086,320232,5517,382835,378533,2020-09-27 20:40:36.004618
West Bengal,25374,211020,4665,25544,213975,4721,244240,241059,2020-09-27 20:40:36.004618
Andaman and Nicobar Islands,171,3551,52,188,3553,53,3794,3774,2020-09-28 19:45:43.343811
Andhra Pradesh,65794,597294,5663,64876,605090,5708,675674,668751,2020-09-28 19:45:43.343811
Arunachal Pradesh,2458,6397,14,2495,6495,14,9004,8869,2020-09-28 19:45:43.343811
Assam,30162,138310,638,29350,139980,655,169985,169110,2020-09-28 19:45:43.343811
Bihar,12754,163432,886,12827,164987,888,178702,177072,2020-09-28 19:45:43.343811
Chandigarh,2298,8937,145,2303,9103,147,11553,11380,2020-09-28 19:45:43.343811
Chhattisgarh,30689,70955,817,31661,72224,848,104733,102461,2020-09-28 19:45:43.343811
Dadra and Nagar Haveli and Daman and Diu,163,2831,2,152,2848,2,3002,2996,2020-09-28 19:45:43.343811
Delhi,29717,232912,5193,29228,236651,5235,271114,267822,2020-09-28 19:45:43.343811
Goa,5424,25759,391,5097,26460,401,31958,31574,2020-09-28 19:45:43.343811
Gujarat,16463,111777,3406,16633,113008,3416,133057,131646,2020-09-28 19:45:43.343811
Haryana,17149,103827,1291,16485,105990,1307,123782,122267,2020-09-28 19:45:43.343811
Himachal Pradesh,4104,9728,164,3657,10359,175,14191,13996,2020-09-28 19:45:43.343811
Jammu and Kashmir,18430,51494,1125,18199,52859,1132,72190,71049,2020-09-28 19:45:43.343811
Jharkhand,12426,65839,670,12433,66797,679,79909,78935,2020-09-28 19:45:43.343811
Karnataka,101801,455719,8503,104743,462241,8582,575566,566023,2020-09-28 19:45:43.343811
Kerala,52753,114530,656,56786,117921,677,175384,167939,2020-09-28 19:45:43.343811
Ladakh,1018,3018,57,1013,3032,58,4103,4093,2020-09-28 19:45:43.343811
Lakshadweep,0,0,0,0,0,0,0,0,2020-09-28 19:45:43.343811
Madhya Pradesh,22228,95490,2181,22431,97571,2207,122209,119899,2020-09-28 19:45:43.343811
Maharashtra,269535,1016450,35191,273646,1030015,35571,1339232,1321176,2020-09-28 19:45:43.343811
Manipur,2306,7681,64,2359,7876,64,10299,10051,2020-09-28 19:45:43.343811
Meghalaya,1515,3654,43,1480,3779,43,5302,5212,2020-09-28 19:45:43.343811
Mizoram,549,1316,0,535,1373,0,1908,1865,2020-09-28 19:45:43.343811
Nagaland,1027,4819,16,1042,4888,16,5946,5862,2020-09-28 19:45:43.343811
Odisha,34476,170193,783,35006,173571,797,209374,205452,2020-09-28 19:45:43.343811
Puducherry,5327,20205,500,5239,20648,513,26400,26032,2020-09-28 19:45:43.343811
Punjab,19483,86013,3188,18556,88312,3238,110106,108684,2020-09-28 19:45:43.343811
Rajasthan,19355,105994,1426,19700,107718,1441,128859,126775,2020-09-28 19:45:43.343811
Sikkim,705,2097,31,692,2146,33,2871,2833,2020-09-28 19:45:43.343811
Tamil Nadu,46336,519448,9233,46341,525154,9313,580808,575017,2020-09-28 19:45:43.343811
Telengana,30234,154499,1100,29673,156431,1107,187211,185833,2020-09-28 19:45:43.343811
Tripura,6066,18392,270,5689,18959,273,24921,24728,2020-09-28 19:45:43.343811
Uttarakhand,10856,34859,566,10799,35672,574,47045,46281,2020-09-28 19:45:43.343811
Uttar Pradesh,57086,320232,5517,55603,325888,5594,387085,382835,2020-09-28 19:45:43.343811
West Bengal,25544,213975,4721,25723,216921,4781,247425,244240,2020-09-28 19:45:43.343811
Andaman and Nicobar Islands,188,3553,53,168,3582,53,3803,3794,2020-09-29 22:30:14.429708
Andhra Pradesh,64876,605090,5708,63116,612300,5745,681161,675674,2020-09-29 22:30:14.429708
Arunachal Pradesh,2495,6495,14,2725,6592,15,9332,9004,2020-09-29 22:30:14.429708
Assam,29350,139980,655,30662,142300,667,173629,169985,2020-09-29 22:30:14.429708
Bihar,12827,164987,888,12664,166276,892,179832,178702,2020-09-29 22:30:14.429708
Chandigarh,2303,9103,147,2200,9325,153,11678,11553,2020-09-29 22:30:14.429708
Chhattisgarh,31661,72224,848,33044,74537,877,108458,104733,2020-09-29 22:30:14.429708
Dadra and Nagar Haveli and Daman and Diu,152,2848,2,133,2877,2,3012,3002,2020-09-29 22:30:14.429708
Delhi,29228,236651,5235,27123,240703,5272,273098,271114,2020-09-29 22:30:14.429708
Goa,5097,26460,401,4917,27072,407,32396,31958,2020-09-29 22:30:14.429708
Gujarat,16633,113008,3416,16689,114344,3428,134461,133057,2020-09-29 22:30:14.429708
Haryana,16485,105990,1307,15670,108411,1331,125412,123782,2020-09-29 22:30:14.429708
Himachal Pradesh,3657,10359,175,3650,10627,180,14457,14191,2020-09-29 22:30:14.429708
Jammu and Kashmir,18199,52859,1132,17601,54267,1146,73014,72190,2020-09-29 22:30:14.429708
Jharkhand,12433,66797,679,12126,68603,688,81417,79909,2020-09-29 22:30:14.429708
Karnataka,104743,462241,8582,104067,469750,8641,582458,575566,2020-09-29 22:30:14.429708
Kerala,56786,117921,677,57957,121268,697,179922,175384,2020-09-29 22:30:14.429708
Ladakh,1013,3032,58,1030,3064,58,4152,4103,2020-09-29 22:30:14.429708
Lakshadweep,0,0,0,0,0,0,0,0,2020-09-29 22:30:14.429708
Madhya Pradesh,22431,97571,2207,21912,100012,2242,124166,122209,2020-09-29 22:30:14.429708
Maharashtra,273646,1030015,35571,265455,1049947,35751,1351153,1339232,2020-09-29 22:30:14.429708
Manipur,2359,7876,64,2431,7982,64,10477,10299,2020-09-29 22:30:14.429708
Meghalaya,1480,3779,43,1448,3868,46,5362,5302,2020-09-29 22:30:14.429708
Mizoram,535,1373,0,499,1459,0,1958,1908,2020-09-29 22:30:14.429708
Nagaland,1042,4888,16,1002,4938,17,5957,5946,2020-09-29 22:30:14.429708
Odisha,35006,173571,797,34211,177585,813,212609,209374,2020-09-29 22:30:14.429708
Puducherry,5239,20648,513,5014,21156,515,26685,26400,2020-09-29 22:30:14.429708
Punjab,18556,88312,3238,17746,90345,3284,111375,110106,2020-09-29 22:30:14.429708
Rajasthan,19700,107718,1441,20043,109472,1456,130971,128859,2020-09-29 22:30:14.429708
Sikkim,692,2146,33,698,2164,34,2896,2871,2020-09-29 22:30:14.429708
Tamil Nadu,46341,525154,9313,46306,530708,9383,586397,580808,2020-09-29 22:30:14.429708
Telengana,29673,156431,1107,29477,158690,1116,189283,187211,2020-09-29 22:30:14.429708
Tripura,5689,18959,273,5874,19203,276,25353,24921,2020-09-29 22:30:14.429708
Uttarakhand,10799,35672,574,10066,36856,580,47502,47045,2020-09-29 22:30:14.429708
Uttar Pradesh,55603,325888,5594,53953,331270,5652,390875,387085,2020-09-29 22:30:14.429708
West Bengal,25723,216921,4781,25899,219844,4837,250580,247425,2020-09-29 22:30:14.429708
Andaman and Nicobar Islands,168,3582,53,181,3587,53,3821,3803,2020-09-30 21:28:11.493696
Andhra Pradesh,63116,612300,5745,59435,622136,5780,687351,681161,2020-09-30 21:28:11.493696
Arunachal Pradesh,2725,6592,15,2794,6743,16,9553,9332,2020-09-30 21:28:11.493696
Assam,30662,142300,667,32539,144002,680,177221,173629,2020-09-30 21:28:11.493696
Bihar,12664,166276,892,12366,168025,894,181285,179832,2020-09-30 21:28:11.493696
Chandigarh,2200,9325,153,2060,9598,158,11816,11678,2020-09-30 21:28:11.493696
Chhattisgarh,33044,74537,877,31225,78514,916,110655,108458,2020-09-30 21:28:11.493696
Dadra and Nagar Haveli and Daman and Diu,133,2877,2,120,2910,2,3032,3012,2020-09-30 21:28:11.493696
Delhi,27123,240703,5272,27524,243481,5320,276325,273098,2020-09-30 21:28:11.493696
Goa,4917,27072,407,4577,27781,419,32777,32396,2020-09-30 21:28:11.493696
Gujarat,16689,114344,3428,16676,115727,3439,135842,134461,2020-09-30 21:28:11.493696
Haryana,15670,108411,1331,14804,110814,1356,126974,125412,2020-09-30 21:28:11.493696
Himachal Pradesh,3650,10627,180,3573,10991,183,14747,14457,2020-09-30 21:28:11.493696
Jammu and Kashmir,17601,54267,1146,17414,55517,1164,74095,73014,2020-09-30 21:28:11.493696
Jharkhand,12126,68603,688,11942,69898,700,82540,81417,2020-09-30 21:28:11.493696
Karnataka,104067,469750,8641,107756,476378,8777,592911,582458,2020-09-30 21:28:11.493696
Kerala,57957,121268,697,61869,124688,719,187276,179922,2020-09-30 21:28:11.493696
Ladakh,1030,3064,58,1030,3107,58,4195,4152,2020-09-30 21:28:11.493696
Lakshadweep,0,0,0,0,0,0,0,0,2020-09-30 21:28:11.493696
Madhya Pradesh,21912,100012,2242,21317,102445,2281,126043,124166,2020-09-30 21:28:11.493696
Maharashtra,265455,1049947,35751,260789,1069159,36181,1366129,1351153,2020-09-30 21:28:11.493696
Manipur,2431,7982,64,2642,8039,65,10746,10477,2020-09-30 21:28:11.493696
Meghalaya,1448,3868,46,1476,3940,47,5463,5362,2020-09-30 21:28:11.493696
Mizoram,499,1459,0,410,1576,0,1986,1958,2020-09-30 21:28:11.493696
Nagaland,1002,4938,17,1037,4986,17,6040,5957,2020-09-30 21:28:11.493696
Odisha,34211,177585,813,33367,181481,828,215676,212609,2020-09-30 21:28:11.493696
Puducherry,5014,21156,515,4933,21616,517,27066,26685,2020-09-30 21:28:11.493696
Punjab,17746,90345,3284,16824,92277,3359,112460,111375,2020-09-30 21:28:11.493696
Rajasthan,20043,109472,1456,20376,111272,1471,133119,130971,2020-09-30 21:28:11.493696
Sikkim,698,2164,34,667,2235,35,2937,2896,2020-09-30 21:28:11.493696
Tamil Nadu,46306,530708,9383,46281,536209,9453,591943,586397,2020-09-30 21:28:11.493696
Telengana,29477,158690,1116,29326,160933,1127,191386,189283,2020-09-30 21:28:11.493696
Tripura,5874,19203,276,5765,19692,277,25734,25353,2020-09-30 21:28:11.493696
Uttarakhand,10066,36856,580,9122,38282,591,47995,47502,2020-09-30 21:28:11.493696
Uttar Pradesh,53953,331270,5652,52160,336981,5715,394856,390875,2020-09-30 21:28:11.493696
West Bengal,25899,219844,4837,26064,222805,4899,253768,250580,2020-09-30 21:28:11.493696
Andaman and Nicobar Islands,147,3587,53,152,3469,52,3673,3821,2020-10-01 17:39:44
Andhra Pradesh,78836,622136,5780,74518,551821,5410,631749,687351,2020-10-01 17:39:44
Arunachal Pradesh,1964,6743,16,1939,5643,13,7595,9553,2020-10-01 17:39:44
Assam,28780,144002,680,29609,129133,578,159320,177221,2020-10-01 17:39:44
Bihar,13005,168025,894,12539,156242,870,169651,181285,2020-10-01 17:39:44
Chandigarh,2821,9598,158,2761,7411,126,10298,11816,2020-10-01 17:39:44
Chhattisgarh,37853,78514,916,37927,49564,690,88181,110655,2020-10-01 17:39:44
Dadra and Nagar Haveli and Daman and Diu,229,2910,2,220,2711,2,2933,3032,2020-10-01 17:39:44
Delhi,32097,243481,5320,30941,213304,5014,249259,276325,2020-10-01 17:39:44
Goa,5781,27781,419,5667,22726,360,28753,32777,2020-10-01 17:39:44
Gujarat,16208,115727,3439,16305,104964,3336,124605,135842,2020-10-01 17:39:44
Haryana,21411,110814,1356,21014,90884,1177,113075,126974,2020-10-01 17:39:44
Himachal Pradesh,4444,10991,183,4458,7853,127,12438,14747,2020-10-01 17:39:44
Jammu and Kashmir,22032,55517,1164,21887,42115,1024,65026,74095,2020-10-01 17:39:44
Jharkhand,13791,69898,700,13504,58543,626,72673,82540,2020-10-01 17:39:44
Karnataka,98062,476378,8777,95354,423377,8145,526876,592911,2020-10-01 17:39:44
Kerala,39484,124688,719,39354,98724,553,138631,187276,2020-10-01 17:39:44
Ladakh,1013,3107,58,1047,2735,50,3832,4195,2020-10-01 17:39:44
Lakshadweep,0,0,0,0,0,0,0,0,2020-10-01 17:39:44
Madhya Pradesh,22300,102445,2281,22542,83618,2007,108167,126043,2020-10-01 17:39:44
Maharashtra,291630,1069159,36181,275017,916348,33015,1224380,1366129,2020-10-01 17:39:44
Manipur,2070,8039,65,2113,6838,59,9010,10746,2020-10-01 17:39:44
Meghalaya,2111,3940,47,2169,2527,37,4733,5463,2020-10-01 17:39:44
Mizoram,583,1576,0,680,1012,0,1692,1986,2020-10-01 17:39:44
Nagaland,1184,4986,17,1052,4477,15,5544,6040,2020-10-01 17:39:44
Odisha,33504,181481,828,34033,149379,710,184122,215676,2020-10-01 17:39:44
Puducherry,4908,21616,517,4659,18065,467,23191,27066,2020-10-01 17:39:44
Punjab,22278,92277,3359,21661,75409,2860,99930,112460,2020-10-01 17:39:44
Rajasthan,18184,111272,1471,18245,97284,1352,116881,133119,2020-10-01 17:39:44
Sikkim,469,2235,35,513,1986,29,2528,2937,2020-10-01 17:39:44
Tamil Nadu,46703,536209,9453,46495,491971,8871,547337,591943,2020-10-01 17:39:44
Telengana,29636,160933,1127,29649,144073,1052,174774,191386,2020-10-01 17:39:44
Tripura,6566,19692,277,6700,15883,251,22834,25734,2020-10-01 17:39:44
Uttarakhand,12455,336981,5715,12075,29201,501,41777,394856,2020-10-01 17:39:44
Uttar Pradesh,65954,38282,591,64164,289594,5135,358893,47995,2020-10-01 17:39:44
West Bengal,24806,222805,4899,24898,198983,4421,228302,253768,2020-10-01 17:39:44
Andaman and Nicobar Islands,174,3608,53,172,3623,53,3848,3835,2020-10-02 20:00:25.133236
Andhra Pradesh,58445,629211,5828,57858,636508,5869,700235,693484,2020-10-02 20:00:25.133236
Arunachal Pradesh,2890,6890,16,2955,7049,16,10020,9796,2020-10-02 20:00:25.133236
Assam,34496,145618,697,34163,147522,711,182396,180811,2020-10-02 20:00:25.133236
Bihar,12092,169732,904,12086,171048,904,184038,182728,2020-10-02 20:00:25.133236
Chandigarh,1963,9813,162,1884,10009,164,12057,11938,2020-10-02 20:00:25.133236
Chhattisgarh,30927,81718,957,30468,84699,986,116153,113602,2020-10-02 20:00:25.133236
Dadra and Nagar Haveli and Daman and Diu,109,2929,2,113,2939,2,3054,3040,2020-10-02 20:00:25.133236
Delhi,26908,247446,5361,26738,250613,5401,282752,279715,2020-10-02 20:00:25.133236
Goa,4865,28125,428,4977,28525,440,33942,33418,2020-10-02 20:00:25.133236
Gujarat,16683,117099,3450,16690,118433,3460,138583,137232,2020-10-02 20:00:25.133236
Haryana,14340,112877,1382,13472,115038,1402,129912,128599,2020-10-02 20:00:25.133236
Himachal Pradesh,3400,11390,186,3416,11608,195,15219,14976,2020-10-02 20:00:25.133236
Jammu and Kashmir,17017,56872,1181,16413,58552,1198,76163,75070,2020-10-02 20:00:25.133236
Jharkhand,11596,71342,713,11482,72461,721,84664,83651,2020-10-02 20:00:25.133236
Karnataka,107635,485268,8864,110431,492412,8994,611837,601767,2020-10-02 20:00:25.133236
Kerala,67140,128224,742,72418,131052,771,204241,196106,2020-10-02 20:00:25.133236
Ladakh,1064,3147,58,1067,3232,61,4360,4269,2020-10-02 20:00:25.133236
Lakshadweep,0,0,0,0,0,0,0,0,2020-10-02 20:00:25.133236
Madhya Pradesh,20997,104734,2316,20473,107279,2336,130088,128047,2020-10-02 20:00:25.133236
Maharashtra,259462,1088322,36662,259440,1104426,37056,1400922,1384446,2020-10-02 20:00:25.133236
Manipur,2456,8460,67,2402,8641,68,11111,10983,2020-10-02 20:00:25.133236
Meghalaya,1615,3975,49,1750,4001,51,5802,5639,2020-10-02 20:00:25.133236
Mizoram,420,1597,0,328,1721,0,2049,2017,2020-10-02 20:00:25.133236
Nagaland,1080,5066,17,1083,5144,17,6244,6163,2020-10-02 20:00:25.133236
Odisha,32577,185700,842,31795,190080,859,222734,219119,2020-10-02 20:00:25.133236
Puducherry,4949,22074,521,4994,22505,525,28024,27544,2020-10-02 20:00:25.133236
Punjab,16814,93666,3406,15763,95937,3451,115151,113886,2020-10-02 20:00:25.133236
Rajasthan,20581,113225,1486,20807,115178,1500,137485,135292,2020-10-02 20:00:25.133236
Sikkim,672,2303,37,636,2375,39,3050,3012,2020-10-02 20:00:25.133236
Tamil Nadu,46263,541819,9520,46369,547335,9586,603290,597602,2020-10-02 20:00:25.133236
Telengana,29058,163407,1135,28620,165844,1145,195609,193600,2020-10-02 20:00:25.133236
Tripura,5691,20092,283,5480,20596,286,26362,26066,2020-10-02 20:00:25.133236
Uttarakhand,9111,39278,611,8544,40079,625,49248,49000,2020-10-02 20:00:25.133236
Uttar Pradesh,50883,342415,5784,50378,346859,5864,403101,399082,2020-10-02 20:00:25.133236
West Bengal,26332,225759,4958,26552,228755,5017,260324,257049,2020-10-02 20:00:25.133236
Andaman and Nicobar Islands,172,3623,53,174,3631,53,3858,3848,2020-10-03 21:15:49.713512
Andhra Pradesh,57858,636508,5869,56897,643993,5900,706790,700235,2020-10-03 21:15:49.713512
Arunachal Pradesh,2955,7049,16,3019,7183,18,10220,10020,2020-10-03 21:15:49.713512
Assam,34163,147522,711,34128,148963,721,183812,182396,2020-10-03 21:15:49.713512
Bihar,12086,171048,904,12077,172449,910,185436,184038,2020-10-03 21:15:49.713512
Chandigarh,1884,10009,164,1881,10162,169,12212,12057,2020-10-03 21:15:49.713512
Chhattisgarh,30468,84699,986,29693,88095,1002,118790,116153,2020-10-03 21:15:49.713512
Dadra and Nagar Haveli and Daman and Diu,113,2939,2,100,2959,2,3061,3054,2020-10-03 21:15:49.713512
Delhi,26738,250613,5401,26450,253784,5438,285672,282752,2020-10-03 21:15:49.713512
Goa,4977,28525,440,5009,29004,442,34455,33942,2020-10-03 21:15:49.713512
Gujarat,16690,118433,3460,16735,119683,3475,139893,138583,2020-10-03 21:15:49.713512
Haryana,13472,115038,1402,13247,116716,1425,131388,129912,2020-10-03 21:15:49.713512
Himachal Pradesh,3416,11608,195,3256,11996,202,15454,15219,2020-10-03 21:15:49.713512
Jammu and Kashmir,16413,58552,1198,16089,59952,1212,77253,76163,2020-10-03 21:15:49.713512
Jharkhand,11482,72461,721,11243,73428,729,85400,84664,2020-10-03 21:15:49.713512
Karnataka,110431,492412,8994,112005,499506,9119,620630,611837,2020-10-03 21:15:49.713512
Kerala,72418,131052,771,77564,135144,791,213499,204241,2020-10-03 21:15:49.713512
Ladakh,1067,3232,61,1094,3274,61,4429,4360,2020-10-03 21:15:49.713512
Lakshadweep,0,0,0,0,0,0,0,0,2020-10-03 21:15:49.713512
Madhya Pradesh,20473,107279,2336,20124,109611,2372,132107,130088,2020-10-03 21:15:49.713512
Maharashtra,259440,1104426,37056,261313,1117720,37480,1416513,1400922,2020-10-03 21:15:49.713512
Manipur,2402,8641,68,2336,8992,69,11397,11111,2020-10-03 21:15:49.713512
Meghalaya,1750,4001,51,1755,4226,52,6033,5802,2020-10-03 21:15:49.713512
Mizoram,328,1721,0,344,1759,0,2103,2049,2020-10-03 21:15:49.713512
Nagaland,1083,5144,17,1090,5211,17,6318,6244,2020-10-03 21:15:49.713512
Odisha,31795,190080,859,31331,194128,875,226334,222734,2020-10-03 21:15:49.713512
Puducherry,4994,22505,525,5054,22948,532,28534,28024,2020-10-03 21:15:49.713512
Punjab,15763,95937,3451,14935,97777,3501,116213,115151,2020-10-03 21:15:49.713512
Rajasthan,20807,115178,1500,20942,117238,1516,139696,137485,2020-10-03 21:15:49.713512
Sikkim,636,2375,39,642,2409,41,3092,3050,2020-10-03 21:15:49.713512
Tamil Nadu,46369,547335,9586,46294,552938,9653,608885,603290,2020-10-03 21:15:49.713512
Telengana,28620,165844,1145,28328,167846,1153,197327,195609,2020-10-03 21:15:49.713512
Tripura,5480,20596,286,5366,20897,289,26552,26362,2020-10-03 21:15:49.713512
Uttarakhand,8544,40079,625,8504,40419,636,49559,49248,2020-10-03 21:15:49.713512
Uttar Pradesh,50378,346859,5864,49112,351966,5917,406995,403101,2020-10-03 21:15:49.713512
West Bengal,26552,228755,5017,26865,231699,5070,263634,260324,2020-10-03 21:15:49.713512
Andaman and Nicobar Islands,174,3631,53,173,3642,53,3868,3858,2020-10-04 20:00:15.048209
Andhra Pradesh,56897,643993,5900,55282,651791,5941,713014,706790,2020-10-04 20:00:15.048209
Arunachal Pradesh,3019,7183,18,3015,7388,18,10421,10220,2020-10-04 20:00:15.048209
Assam,34128,148963,721,33933,150776,735,185444,183812,2020-10-04 20:00:15.048209
Bihar,12077,172449,910,11597,173932,912,186441,185436,2020-10-04 20:00:15.048209
Chandigarh,1881,10162,169,1792,10396,172,12360,12212,2020-10-04 20:00:15.048209
Chhattisgarh,29693,88095,1002,29292,91077,1031,121400,118790,2020-10-04 20:00:15.048209
Dadra and Nagar Haveli and Daman and Diu,100,2959,2,101,2967,2,3070,3061,2020-10-04 20:00:15.048209
Delhi,26450,253784,5438,25234,257224,5472,287930,285672,2020-10-04 20:00:15.048209
Goa,5009,29004,442,4923,29527,450,34900,34455,2020-10-04 20:00:15.048209
Gujarat,16735,119683,3475,16762,120987,3487,141236,139893,2020-10-04 20:00:15.048209
Haryana,13247,116716,1425,12868,118258,1450,132576,131388,2020-10-04 20:00:15.048209
Himachal Pradesh,3256,11996,202,3292,12193,210,15695,15454,2020-10-04 20:00:15.048209
Jammu and Kashmir,16089,59952,1212,15646,61351,1231,78228,77253,2020-10-04 20:00:15.048209
Jharkhand,11243,73428,729,10939,74604,734,86277,85400,2020-10-04 20:00:15.048209
Karnataka,112005,499506,9119,112802,508495,9219,630516,620630,2020-10-04 20:00:15.048209
Kerala,77564,135144,791,80900,139620,813,221333,213499,2020-10-04 20:00:15.048209
Ladakh,1094,3274,61,1101,3315,61,4477,4429,2020-10-04 20:00:15.048209
Lakshadweep,0,0,0,0,0,0,0,0,2020-10-04 20:00:15.048209
Madhya Pradesh,20124,109611,2372,19807,111712,2399,133918,132107,2020-10-04 20:00:15.048209
Maharashtra,261313,1117720,37480,258548,1134555,37758,1430861,1416513,2020-10-04 20:00:15.048209
Manipur,2336,8992,69,2497,9081,71,11649,11397,2020-10-04 20:00:15.048209
Meghalaya,1755,4226,52,2083,4319,54,6456,6033,2020-10-04 20:00:15.048209
Mizoram,344,1759,0,348,1772,0,2120,2103,2020-10-04 20:00:15.048209
Nagaland,1090,5211,17,1155,5257,17,6429,6318,2020-10-04 20:00:15.048209
Odisha,31331,194128,875,30301,198194,892,229387,226334,2020-10-04 20:00:15.048209
Puducherry,5054,22948,532,4874,23344,534,28752,28534,2020-10-04 20:00:15.048209
Punjab,14935,97777,3501,14289,99468,3562,117319,116213,2020-10-04 20:00:15.048209
Rajasthan,20942,117238,1516,21075,119241,1530,141846,139696,2020-10-04 20:00:15.048209
Sikkim,642,2409,41,640,2448,43,3131,3092,2020-10-04 20:00:15.048209
Tamil Nadu,46294,552938,9653,46255,558534,9718,614507,608885,2020-10-04 20:00:15.048209
Telengana,28328,167846,1153,27901,170212,1163,199276,197327,2020-10-04 20:00:15.048209
Tripura,5366,20897,289,5171,21410,293,26874,26552,2020-10-04 20:00:15.048209
Uttarakhand,8504,40419,636,8076,41338,648,50062,49559,2020-10-04 20:00:15.048209
Uttar Pradesh,49112,351966,5917,47823,356826,5977,410626,406995,2020-10-04 20:00:15.048209
West Bengal,26865,231699,5070,27130,234712,5132,266974,263634,2020-10-04 20:00:15.048209
Andaman and Nicobar Islands,173,3642,53,182,3649,53,3884,3868,2020-10-05 21:09:01.661255
Andhra Pradesh,55282,651791,5941,54400,658875,5981,719256,713014,2020-10-05 21:09:01.661255
Arunachal Pradesh,3015,7388,18,2953,7577,18,10548,10421,2020-10-05 21:09:01.661255
Assam,33933,150776,735,33324,152127,749,186200,185444,2020-10-05 21:09:01.661255
Bihar,11597,173932,912,11795,175458,915,188168,186441,2020-10-05 21:09:01.661255
Chandigarh,1792,10396,172,1673,10598,174,12445,12360,2020-10-05 21:09:01.661255
Chhattisgarh,29292,91077,1031,28548,93731,1045,123324,121400,2020-10-05 21:09:01.661255
Dadra and Nagar Haveli and Daman and Diu,101,2967,2,105,2980,2,3087,3070,2020-10-05 21:09:01.661255
Delhi,25234,257224,5472,24753,260350,5510,290613,287930,2020-10-05 21:09:01.661255
Goa,4923,29527,450,4839,30033,456,35328,34900,2020-10-05 21:09:01.661255
Gujarat,16762,120987,3487,16809,122233,3496,142538,141236,2020-10-05 21:09:01.661255
Haryana,12868,118258,1450,12067,120341,1470,133878,132576,2020-10-05 21:09:01.661255
Himachal Pradesh,3292,12193,210,3273,12361,217,15851,15695,2020-10-05 21:09:01.661255
Jammu and Kashmir,15646,61351,1231,15460,62404,1242,79106,78228,2020-10-05 21:09:01.661255
Jharkhand,10939,74604,734,10936,75531,743,87210,86277,2020-10-05 21:09:01.661255
Karnataka,112802,508495,9219,115593,515782,9286,640661,630516,2020-10-05 21:09:01.661255
Kerala,80900,139620,813,84579,144471,836,229886,221333,2020-10-05 21:09:01.661255
Ladakh,1101,3315,61,1106,3354,61,4521,4477,2020-10-05 21:09:01.661255
Lakshadweep,0,0,0,0,0,0,0,0,2020-10-05 21:09:01.661255
Madhya Pradesh,19807,111712,2399,19372,113832,2434,135638,133918,2020-10-05 21:09:01.661255
Maharashtra,258548,1134555,37758,255722,1149603,38084,1443409,1430861,2020-10-05 21:09:01.661255
Manipur,2497,9081,71,2576,9205,74,11855,11649,2020-10-05 21:09:01.661255
Meghalaya,2083,4319,54,2209,4393,54,6656,6456,2020-10-05 21:09:01.661255
Mizoram,348,1772,0,313,1807,0,2120,2120,2020-10-05 21:09:01.661255
Nagaland,1155,5257,17,1226,5309,17,6552,6429,2020-10-05 21:09:01.661255
Odisha,30301,198194,892,29504,202302,907,232713,229387,2020-10-05 21:09:01.661255
Puducherry,4874,23344,534,4787,23763,539,29089,28752,2020-10-05 21:09:01.661255
Punjab,14289,99468,3562,13577,100977,3603,118157,117319,2020-10-05 21:09:01.661255
Rajasthan,21075,119241,1530,21154,121331,1545,144030,141846,2020-10-05 21:09:01.661255
Sikkim,640,2448,43,649,2480,45,3174,3131,2020-10-05 21:09:01.661255
Tamil Nadu,46255,558534,9718,46120,564092,9784,619996,614507,2020-10-05 21:09:01.661255
Telengana,27901,170212,1163,27052,172388,1171,200611,199276,2020-10-05 21:09:01.661255
Tripura,5171,21410,293,4858,21876,299,27033,26874,2020-10-05 21:09:01.661255
Uttarakhand,8076,41338,648,9089,41740,652,51481,50062,2020-10-05 21:09:01.661255
Uttar Pradesh,47823,356826,5977,46385,362052,6029,414466,410626,2020-10-05 21:09:01.661255
West Bengal,27130,234712,5132,27439,237698,5194,270331,266974,2020-10-05 21:09:01.661255
Andaman and Nicobar Islands,182,3649,53,186,3659,54,3899,3884,2020-10-06 20:00:15.260793
Andhra Pradesh,54400,658875,5981,51060,666433,6019,723512,719256,2020-10-06 20:00:15.260793
Arunachal Pradesh,2953,7577,18,2989,7775,19,10783,10548,2020-10-06 20:00:15.260793
Assam,33324,152127,749,33467,153491,760,187718,186200,2020-10-06 20:00:15.260793
Bihar,11795,175458,915,11523,176995,924,189442,188168,2020-10-06 20:00:15.260793
Chandigarh,1673,10598,174,1604,10797,177,12578,12445,2020-10-06 20:00:15.260793
Chhattisgarh,28548,93731,1045,27857,97067,1081,126005,123324,2020-10-06 20:00:15.260793
Dadra and Nagar Haveli and Daman and Diu,105,2980,2,99,2991,2,3092,3087,2020-10-06 20:00:15.260793
Delhi,24753,260350,5510,23080,263938,5542,292560,290613,2020-10-06 20:00:15.260793
Goa,4839,30033,456,4803,30456,460,35719,35328,2020-10-06 20:00:15.260793
Gujarat,16809,122233,3496,16718,123638,3509,143865,142538,2020-10-06 20:00:15.260793
Haryana,12067,120341,1470,11822,121596,1491,134909,133878,2020-10-06 20:00:15.260793
Himachal Pradesh,3273,12361,217,3156,12653,224,16033,15851,2020-10-06 20:00:15.260793
Jammu and Kashmir,15460,62404,1242,14696,63790,1252,79738,79106,2020-10-06 20:00:15.260793
Jharkhand,10936,75531,743,10436,76843,747,88026,87210,2020-10-06 20:00:15.260793
Karnataka,115593,515782,9286,115496,522846,9370,647712,640661,2020-10-06 20:00:15.260793
Kerala,84579,144471,836,84958,149111,859,234928,229886,2020-10-06 20:00:15.260793
Ladakh,1106,3354,61,1166,3414,61,4641,4521,2020-10-06 20:00:15.260793
Lakshadweep,0,0,0,0,0,0,0,0,2020-10-06 20:00:15.260793
Madhya Pradesh,19372,113832,2434,18757,115878,2463,137098,135638,2020-10-06 20:00:15.260793
Maharashtra,255722,1149603,38084,252721,1162585,38347,1453653,1443409,2020-10-06 20:00:15.260793
Manipur,2576,9205,74,2696,9334,75,12105,11855,2020-10-06 20:00:15.260793
Meghalaya,2209,4393,54,2217,4491,59,6767,6656,2020-10-06 20:00:15.260793
Mizoram,313,1807,0,291,1837,0,2128,2120,2020-10-06 20:00:15.260793
Nagaland,1226,5309,17,1155,5422,17,6594,6552,2020-10-06 20:00:15.260793
Odisha,29504,202302,907,28006,206400,924,235330,232713,2020-10-06 20:00:15.260793
Puducherry,4787,23763,539,4513,24221,543,29277,29089,2020-10-06 20:00:15.260793
Punjab,13577,100977,3603,12895,102648,3641,119184,118157,2020-10-06 20:00:15.260793
Rajasthan,21154,121331,1545,21215,123421,1559,146195,144030,2020-10-06 20:00:15.260793
Sikkim,649,2480,45,598,2547,46,3191,3174,2020-10-06 20:00:15.260793
Tamil Nadu,46120,564092,9784,45881,569664,9846,625391,619996,2020-10-06 20:00:15.260793
Telengana,27052,172388,1171,26644,174769,1181,202594,200611,2020-10-06 20:00:15.260793
Tripura,4858,21876,299,4876,22131,301,27308,27033,2020-10-06 20:00:15.260793
Uttarakhand,9089,41740,652,8701,42621,669,51991,51481,2020-10-06 20:00:15.260793
Uttar Pradesh,46385,362052,6029,45024,366321,6092,417437,414466,2020-10-06 20:00:15.260793
West Bengal,27439,237698,5194,27717,240707,5255,273679,270331,2020-10-06 20:00:15.260793
Andaman and Nicobar Islands,186,3659,54,180,3678,54,3912,3899,2020-10-07 21:53:31.730856
Andhra Pradesh,51060,666433,6019,50776,672479,6052,729307,723512,2020-10-07 21:53:31.730856
Arunachal Pradesh,2989,7775,19,3022,7965,20,11007,10783,2020-10-07 21:53:31.730856
Assam,33467,153491,760,33047,155077,778,188902,187718,2020-10-07 21:53:31.730856
Bihar,11523,176995,924,11420,178395,925,190740,189442,2020-10-07 21:53:31.730856
Chandigarh,1604,10797,177,1492,11035,180,12707,12578,2020-10-07 21:53:31.730856
Chhattisgarh,27857,97067,1081,27238,100551,1104,128893,126005,2020-10-07 21:53:31.730856
Dadra and Nagar Haveli and Daman and Diu,99,2991,2,101,3000,2,3103,3092,2020-10-07 21:53:31.730856
Delhi,23080,263938,5542,22720,266935,5581,295236,292560,2020-10-07 21:53:31.730856
Goa,4803,30456,460,4720,31050,468,36238,35719,2020-10-07 21:53:31.730856
Gujarat,16718,123638,3509,16570,125111,3519,145200,143865,2020-10-07 21:53:31.730856
Haryana,11822,121596,1491,11320,123286,1509,136115,134909,2020-10-07 21:53:31.730856
Himachal Pradesh,3156,12653,224,3136,12918,229,16283,16033,2020-10-07 21:53:31.730856
Jammu and Kashmir,14696,63790,1252,13712,65496,1268,80476,79738,2020-10-07 21:53:31.730856
Jharkhand,10436,76843,747,10027,78089,757,88873,8026,2020-10-07 21:53:31.730856
Karnataka,115496,522846,9370,115170,533074,9461,657705,647712,2020-10-07 21:53:31.730856
Kerala,84958,149111,859,87823,154092,884,242799,234928,2020-10-07 21:53:31.730856
Ladakh,1166,3414,61,1195,3464,61,4720,4641,2020-10-07 21:53:31.730856
Lakshadweep,0,0,0,0,0,0,0,0,2020-10-07 21:53:31.730856
Madhya Pradesh,18757,115878,2463,18141,118039,2488,138668,137098,2020-10-07 21:53:31.730856
Maharashtra,252721,1162585,38347,247468,1179726,38717,1465911,1453653,2020-10-07 21:53:31.730856
Manipur,2696,9334,75,2680,9482,78,12240,12105,2020-10-07 21:53:31.730856
Meghalaya,2217,4491,59,2371,4606,60,7037,6767,2020-10-07 21:53:31.730856
Mizoram,291,1837,0,261,1887,0,2148,2128,2020-10-07 21:53:31.730856
Nagaland,1155,5422,17,1185,5460,17,6662,6594,2020-10-07 21:53:31.730856
Odisha,28006,206400,924,26846,210217,940,238003,235330,2020-10-07 21:53:31.730856
Puducherry,4513,24221,543,4522,24614,546,29682,29277,2020-10-07 21:53:31.730856
Punjab,12895,102648,3641,11982,104355,3679,120016,119184,2020-10-07 21:53:31.730856
Rajasthan,21215,123421,1559,21294,125448,1574,148316,146195,2020-10-07 21:53:31.730856
Sikkim,598,2547,46,580,2587,49,3216,3191,2020-10-07 21:53:31.730856
Tamil Nadu,45881,569664,9846,45279,575212,9917,630408,625391,2020-10-07 21:53:31.730856
Telengana,26644,174769,1181,26551,177008,1189,204748,202594,2020-10-07 21:53:31.730856
Tripura,4876,22131,301,4621,22623,301,27545,27308,2020-10-07 21:53:31.730856
Uttarakhand,8701,42621,669,8414,43238,677,52329,51991,2020-10-07 21:53:31.730856
Uttar Pradesh,45024,366321,6092,44031,370753,6153,420937,417437,2020-10-07 21:53:31.730856
West Bengal,27717,240707,5255,27988,243743,5318,277049,273679,2020-10-07 21:53:31.730856
Andaman and Nicobar Islands,180,3678,54,185,3696,54,3935,3912,2020-10-08 10:57:57.838895
Andhra Pradesh,50776,672479,6052,49513,678828,6086,734427,729307,2020-10-08 10:57:57.838895
Arunachal Pradesh,3022,7965,20,2850,8396,21,11267,11007,2020-10-08 10:57:57.838895
Assam,33047,155077,778,31786,157638,785,190209,188902,2020-10-08 10:57:57.838895
Bihar,11420,178395,925,11326,179732,927,191985,190740,2020-10-08 10:57:57.838895
Chandigarh,1492,11035,180,1448,11190,182,12820,12707,2020-10-08 10:57:57.838895
Chhattisgarh,27238,100551,1104,26777,103828,1134,131739,128893,2020-10-08 10:57:57.838895
Dadra and Nagar Haveli and Daman and Diu,101,3000,2,108,3010,2,3120,3103,2020-10-08 10:57:57.838895
Delhi,22720,266935,5581,22186,270305,5616,298107,295236,2020-10-08 10:57:57.838895
Goa,4720,31050,468,4749,31444,477,36670,36238,2020-10-08 10:57:57.838895
Gujarat,16570,125111,3519,16485,126657,3531,146673,145200,2020-10-08 10:57:57.838895
Haryana,11320,123286,1509,11029,124841,1528,137398,136115,2020-10-08 10:57:57.838895
Himachal Pradesh,3136,12918,229,2996,13338,231,16565,16283,2020-10-08 10:57:57.838895
Jammu and Kashmir,13712,65496,1268,12131,67684,1282,81097,80746,2020-10-08 10:57:57.838895
Jharkhand,10027,78089,757,9759,79176,767,89702,88873,2020-10-08 10:57:57.838895
Karnataka,115170,533074,9461,116172,542906,9574,668652,657705,2020-10-08 10:57:57.838895
Kerala,87823,154092,884,92246,160253,906,253405,242799,2020-10-08 10:57:57.838895
Ladakh,1195,3464,61,1228,3511,63,4802,4720,2020-10-08 10:57:57.838895
Lakshadweep,0,0,0,0,0,0,0,0,2020-10-08 10:57:57.838895
Madhya Pradesh,18141,118039,2488,17522,120267,2518,140307,138668,2020-10-08 10:57:57.838895
Maharashtra,247468,1179726,38717,244976,1196441,39072,1480489,1465911,2020-10-08 10:57:57.838895
Manipur,2680,9482,78,2805,9604,80,12489,12240,2020-10-08 10:57:57.838895
Meghalaya,2371,4606,60,2411,4694,60,7165,7037,2020-10-08 10:57:57.838895
Mizoram,261,1887,0,231,1919,0,2150,2148,2020-10-08 10:57:57.838895
Nagaland,1185,5460,17,1200,5498,17,6715,6662,2020-10-08 10:57:57.838895
Odisha,26846,210217,940,26368,213672,958,240998,238003,2020-10-08 10:57:57.838895
Puducherry,4522,24614,546,4680,24930,551,30161,29682,2020-10-08 10:57:57.838895
Punjab,11982,104355,3679,11563,105585,3712,120860,120016,2020-10-08 10:57:57.838895
Rajasthan,21294,125448,1574,21351,127526,1590,150467,148316,2020-10-08 10:57:57.838895
Sikkim,580,2587,49,570,2615,49,3234,3216,2020-10-08 10:57:57.838895
Tamil Nadu,45279,575212,9917,45135,580736,9984,635855,630408,2020-10-08 10:57:57.838895
Telengana,26551,177008,1189,26368,179075,1201,206644,204748,2020-10-08 10:57:57.838895
Tripura,4621,22623,301,4389,23066,304,27759,27545,2020-10-08 10:57:57.838895
Uttarakhand,8414,43238,677,8367,43904,688,52959,52329,2020-10-08 10:57:57.838895
Uttar Pradesh,44031,370753,6153,43154,374972,6200,424326,420937,2020-10-08 10:57:57.838895
West Bengal,27988,243743,5318,28361,246767,5376,280504,277049,2020-10-08 10:57:57.838895
Andaman and Nicobar Islands,185,3696,54,190,3707,55,3952,3935,2020-10-09 20:14:18.134337
Andhra Pradesh,49513,678828,6086,48661,684930,6128,739719,734427,2020-10-09 20:14:18.134337
Arunachal Pradesh,2850,8396,21,2778,8679,22,11479,11267,2020-10-09 20:14:18.134337
Assam,31786,157638,785,30767,159836,794,191397,190209,2020-10-09 20:14:18.134337
Bihar,11326,179732,927,11447,180696,929,193072,191985,2020-10-09 20:14:18.134337
Chandigarh,1448,11190,182,1392,11344,186,12922,12820,2020-10-09 20:14:18.134337
Chhattisgarh,26777,103828,1134,27427,106027,1158,134612,131739,2020-10-09 20:14:18.134337
Dadra and Nagar Haveli and Daman and Diu,108,3010,2,105,3025,2,3132,3120,2020-10-09 20:14:18.134337
Delhi,22186,270305,5616,22232,272948,5653,300833,298107,2020-10-09 20:14:18.134337
Goa,4749,31444,477,4716,31902,484,37102,36670,2020-10-09 20:14:18.134337
Gujarat,16485,126657,3531,16465,127786,3538,147789,146673,2020-10-09 20:14:18.134337
Haryana,11029,124841,1528,10867,126267,1548,138682,137389,2020-10-09 20:14:18.134337
Himachal Pradesh,2996,13338,231,2943,13597,238,16778,16565,2020-10-09 20:14:18.134337
Jammu and Kashmir,12131,67684,1282,11482,69020,1291,81793,81097,2020-10-09 20:14:18.134337
Jharkhand,9759,79176,767,9272,80439,775,90486,89702,2020-10-09 20:14:18.134337
Karnataka,116172,542906,9574,117162,552519,9675,679356,668652,2020-10-09 20:14:18.134337
Kerala,92246,160253,906,90664,167256,930,258850,253405,2020-10-09 20:14:18.134337
Ladakh,1228,3511,63,1299,3540,63,4902,4802,2020-10-09 20:14:18.134337
Lakshadweep,0,0,0,0,0,0,0,0,2020-10-09 20:14:18.134337
Madhya Pradesh,17522,120267,2518,16788,122687,2547,142022,140307,2020-10-09 20:14:18.134337
Maharashtra,244976,1196441,39072,242438,1212016,39430,149388,1480489,2020-10-09 20:14:18.134337
Manipur,2805,9604,80,2877,9719,83,12679,12489,2020-10-09 20:14:18.134337
Meghalaya,2411,4694,60,2369,4832,60,7261,7165,2020-10-09 20:14:18.134337
Mizoram,231,1919,0,220,1937,0,2157,2150,2020-10-09 20:14:18.134337
Nagaland,1200,5498,17,1155,5564,17,6736,6715,2020-10-09 20:14:18.134337
Odisha,26368,213672,958,26184,216984,974,244142,240998,2020-10-09 20:14:18.134337
Puducherry,4680,24930,551,4727,25256,556,30539,30161,2020-10-09 20:14:18.134337
Punjab,11563,105585,3712,10775,107200,3741,121716,120860,2020-10-09 20:14:18.134337
Rajasthan,21351,127526,1590,21382,129618,1605,152605,150467,2020-10-09 20:14:18.134337
Sikkim,570,2615,49,545,2650,51,3246,3234,2020-10-09 20:14:18.134337
Tamil Nadu,45135,580736,9984,44437,586454,10052,640943,635855,2020-10-09 20:14:18.134337
Telengana,26368,179075,1201,26374,180953,1208,208535,206644,2020-10-09 20:14:18.134337
Tripura,4389,23066,304,4197,23474,311,27982,27759,2020-10-09 20:14:18.134337
Uttarakhand,8367,43904,688,7849,44808,702,53359,52959,2020-10-09 20:14:18.134337
Uttar Pradesh,43154,374972,6200,42552,378662,6245,427459,424326,2020-10-09 20:14:18.134337
West Bengal,28361,246767,5376,28854,249737,5439,284030,280504,2020-10-09 20:14:18.134337
Andaman and Nicobar Islands,190,3707,55,197,3724,55,3976,3952,2020-10-10 20:00:14
Andhra Pradesh,48661,684930,6128,47665,691040,6159,744864,739719,2020-10-10 20:00:14
Arunachal Pradesh,2778,8679,22,2860,8877,23,11760,11479,2020-10-10 20:00:14
Assam,30767,159836,794,29710,161904,802,192416,191397,2020-10-10 20:00:14
Bihar,11447,180696,929,11274,182121,934,194329,193072,2020-10-10 20:00:14
Chandigarh,1392,11344,186,1292,11505,188,12985,12922,2020-10-10 20:00:14
Chhattisgarh,27427,106027,1158,27439,108935,1196,137570,134612,2020-10-10 20:00:14
Dadra and Nagar Haveli and Daman and Diu,105,3025,2,101,3037,2,3140,3132,2020-10-10 20:00:14
Delhi,22232,272948,5653,21955,276046,5692,303693,300833,2020-10-10 20:00:14
Goa,4716,31902,484,4783,32317,491,37591,37102,2020-10-10 20:00:14
Gujarat,16465,127786,3538,16181,129304,3547,149032,147789,2020-10-10 20:00:14
Haryana,10867,126267,1548,10830,127540,1562,139932,138682,2020-10-10 20:00:14
Himachal Pradesh,2943,13597,238,2856,13876,245,16977,16778,2020-10-10 20:00:14
Jammu and Kashmir,11482,69020,1291,11144,69979,1306,82429,81793,2020-10-10 20:00:14
Jharkhand,9272,80439,775,8819,81654,781,91254,90486,2020-10-10 20:00:14
Karnataka,117162,552519,9675,118870,561610,9789,690269,679356,2020-10-10 20:00:14
Kerala,90664,167256,930,91841,175304,955,268100,258850,2020-10-10 20:00:14
Ladakh,1299,3540,63,1038,3886,63,4987,4902,2020-10-10 20:00:14
Lakshadweep,0,0,0,0,0,0,0,0,2020-10-10 20:00:14
Madhya Pradesh,16788,122687,2547,16168,124887,2574,143629,142022,2020-10-10 20:00:14
Maharashtra,242438,1212016,39430,236947,1229339,39732,1506018,1493880,2020-10-10 20:00:14
Manipur,2877,9719,83,2858,9866,86,12810,12679,2020-10-10 20:00:14
Meghalaya,2369,4832,60,2424,4903,61,7388,7261,2020-10-10 20:00:14
Mizoram,220,1937,0,188,1974,0,2162,2157,2020-10-10 20:00:14
Nagaland,1155,5564,17,1215,5656,17,6888,6736,2020-10-10 20:00:14
Odisha,26184,216984,974,25460,220388,991,246839,244142,2020-10-10 20:00:14
Puducherry,4727,25256,556,4803,25543,558,30904,30539,2020-10-10 20:00:14
Punjab,10775,107200,3741,10153,108533,3773,122459,121716,2020-10-10 20:00:14
Rajasthan,21382,129618,1605,21398,131766,1621,154785,152605,2020-10-10 20:00:14
Sikkim,545,2650,51,504,2721,53,3278,3246,2020-10-10 20:00:14
Tamil Nadu,44437,586454,10052,44197,591811,10120,646128,640943,2020-10-10 20:00:14
Telengana,26374,180953,1208,26104,183025,1217,210346,208535,2020-10-10 20:00:14
Tripura,4197,23474,311,4039,23801,313,28153,27982,2020-10-10 20:00:14
Uttarakhand,7849,44808,702,7289,46058,716,54063,53359,2020-10-10 20:00:14
Uttar Pradesh,42552,378662,6245,41287,383086,6293,430666,427459,2020-10-10 20:00:14
West Bengal,28854,249737,5439,29296,252806,5501,287603,284030,2020-10-10 20:00:14
Andaman and Nicobar Islands,197,3724,55,193,3744,55,3992,3976,2020-10-11 18:40:12.957432
Andhra Pradesh,47665,691040,6159,46624,697699,6194,750517,744864,2020-10-11 18:40:12.957432
Arunachal Pradesh,2860,8877,23,2940,9035,23,11998,11760,2020-10-11 18:40:12.957432
Assam,29710,161904,802,29221,163355,811,193387,192416,2020-10-11 18:40:12.957432
Bihar,11274,182121,934,11165,183390,944,195499,194329,2020-10-11 18:40:12.957432
Chandigarh,1292,11505,188,1229,11662,190,13081,12985,2020-10-11 18:40:12.957432
Chhattisgarh,27439,108935,1196,27369,111654,1235,140258,137570,2020-10-11 18:40:12.957432
Dadra and Nagar Haveli and Daman and Diu,101,3037,2,100,3050,2,3152,3140,2020-10-11 18:40:12.957432
Delhi,21955,276046,5692,22007,278812,5740,306559,303693,2020-10-11 18:40:12.957432
Goa,4783,32317,491,4658,32777,499,37934,37591,2020-10-11 18:40:12.957432
Gujarat,16181,129304,3547,15936,130760,3557,150253,149032,2020-10-11 18:40:12.957432
Haryana,10830,127540,1562,10677,128841,1572,141090,139932,2020-10-11 18:40:12.957432
Himachal Pradesh,2856,13876,245,2718,14278,248,17244,16977,2020-10-11 18:40:12.957432
Jammu and Kashmir,11144,69979,1306,10796,70955,1313,83064,82429,2020-10-11 18:40:12.957432
Jharkhand,8819,81654,781,8362,82805,784,91951,91254,2020-10-11 18:40:12.957432
Karnataka,118870,561610,9789,120948,569947,9891,700786,690269,2020-10-11 18:40:12.957432
Kerala,91841,175304,955,96003,182874,978,279855,268100,2020-10-11 18:40:12.957432
Ladakh,1038,3886,63,1022,3973,64,5059,4987,2020-10-11 18:40:12.957432
Lakshadweep,0,0,0,0,0,0,0,0,2020-10-11 18:40:12.957432
Madhya Pradesh,16168,124887,2574,15612,127034,2599,145245,143629,2020-10-11 18:40:12.957432
Maharashtra,236947,1229339,39732,221615,1255779,40040,1517434,1506018,2020-10-11 18:40:12.957432
Manipur,2858,9866,86,2608,10396,88,13092,12810,2020-10-11 18:40:12.957432
Meghalaya,2424,4903,61,2437,5045,62,7544,7388,2020-10-11 18:40:12.957432
Mizoram,188,1974,0,191,1984,0,2175,2162,2020-10-11 18:40:12.957432
Nagaland,1215,5656,17,1238,5694,17,6949,6888,2020-10-11 18:40:12.957432
Odisha,25460,220388,991,24414,224273,1006,249693,246839,2020-10-11 18:40:12.957432
Puducherry,4803,25543,558,4719,25955,559,31233,30904,2020-10-11 18:40:12.957432
Punjab,10153,108533,3773,9752,109767,3798,123317,122459,2020-10-11 18:40:12.957432
Rajasthan,21398,131766,1621,21354,133918,1636,156908,154785,2020-10-11 18:40:12.957432
Sikkim,504,2721,53,450,2816,55,3321,3278,2020-10-11 18:40:12.957432
Tamil Nadu,44197,591811,10120,44150,597033,10187,651370,646128,2020-10-11 18:40:12.957432
Telengana,26104,183025,1217,25713,185128,1222,212063,210346,2020-10-11 18:40:12.957432
Tripura,4039,23801,313,3951,24086,315,28352,28153,2020-10-11 18:40:12.957432
Uttarakhand,7289,46058,716,7321,46470,734,54525,54063,2020-10-11 18:40:12.957432
Uttar Pradesh,41287,383086,6293,40210,387149,6353,433712,430666,2020-10-11 18:40:12.957432
West Bengal,29296,252806,5501,29793,255838,5563,291194,287603,2020-10-11 18:40:12.957432
Andaman and Nicobar Islands,193,3744,55,186,3764,55,4005,3992,2020-10-12 21:45:33.728960
Andhra Pradesh,46624,697699,6194,46295,703208,6224,755727,750517,2020-10-12 21:45:33.728960
Arunachal Pradesh,2940,9035,23,2891,9232,24,12147,11998,2020-10-12 21:45:33.728960
Assam,29221,163355,811,28385,164582,816,193783,193387,2020-10-12 21:45:33.728960
Bihar,11165,183390,944,11044,184541,946,196531,195499,2020-10-12 21:45:33.728960
Chandigarh,1229,11662,190,1184,11787,191,13162,13081,2020-10-12 21:45:33.728960
Chhattisgarh,27369,111654,1235,27348,113771,1253,142372,140258,2020-10-12 21:45:33.728960
Dadra and Nagar Haveli and Daman and Diu,100,3050,2,102,3059,2,3163,3152,2020-10-12 21:45:33.728960
Delhi,22007,278812,5740,21701,281869,5769,309339,306559,2020-10-12 21:45:33.728960
Goa,4658,32777,499,4656,33203,507,38366,37934,2020-10-12 21:45:33.728960
Gujarat,15936,130760,3557,15695,132173,3566,151434,150253,2020-10-12 21:45:33.728960
Haryana,10677,128841,1572,10573,130003,1579,142155,141090,2020-10-12 21:45:33.728960
Himachal Pradesh,2718,14278,248,2687,14471,250,17408,17244,2020-10-12 21:45:33.728960
Jammu and Kashmir,10796,70955,1313,10466,71845,1322,83633,83064,2020-10-12 21:45:33.728960
Jharkhand,8362,82805,784,8167,83571,787,92525,91951,2020-10-12 21:45:33.728960
Karnataka,120948,569947,9891,120289,580054,9966,710309,700786,2020-10-12 21:45:33.728960
Kerala,96003,182874,978,96401,191798,1003,289202,279855,2020-10-12 21:45:33.728960
Ladakh,1022,3973,64,980,4037,64,5081,5059,2020-10-12 21:45:33.728960
Lakshadweep,0,0,0,0,0,0,0,0,2020-10-12 21:45:33.728960
Madhya Pradesh,15612,127034,2599,15177,129019,2624,146820,145245,2020-10-12 21:45:33.728960
Maharashtra,221615,1255779,40040,221637,1266240,40349,1528226,1517434,2020-10-12 21:45:33.728960
Manipur,2608,10396,88,2731,10504,91,13326,13092,2020-10-12 21:45:33.728960
Meghalaya,2437,5045,62,2478,5142,63,7683,7544,2020-10-12 21:45:33.728960
Mizoram,191,1984,0,174,2010,0,2184,2175,2020-10-12 21:45:33.728960
Nagaland,1238,5694,17,1259,5743,17,7019,6949,2020-10-12 21:45:33.728960
Odisha,24414,224273,1006,23602,227615,1022,252239,249693,2020-10-12 21:45:33.728960
Puducherry,4719,25955,559,4695,26291,563,31549,31233,2020-10-12 21:45:33.728960
Punjab,9752,109767,3798,9275,110865,3833,123973,123317,2020-10-12 21:45:33.728960
Rajasthan,21354,133918,1636,21412,135990,1650,159052,156908,2020-10-12 21:45:33.728960
Sikkim,450,2816,55,384,2920,55,3359,3321,2020-10-12 21:45:33.728960
Tamil Nadu,44150,597033,10187,44095,602038,10252,656385,651370,2020-10-12 21:45:33.728960
Telengana,25713,185128,1222,24514,187342,1228,213084,212063,2020-10-12 21:45:33.728960
Tripura,3951,24086,315,3742,24403,316,28461,28352,2020-10-12 21:45:33.728960
Uttarakhand,7321,46470,734,7373,46931,747,55051,54525,2020-10-12 21:45:33.728960
Uttar Pradesh,40210,387149,6353,40019,390566,6394,436979,433712,2020-10-12 21:45:33.728960
West Bengal,29793,255838,5563,30236,258948,5622,294806,291194,2020-10-12 21:45:33.728960
Andaman and Nicobar Islands,186,3764,55,198,3770,55,4023,4005,2020-10-13 20:00:14.890266
Andhra Pradesh,46295,703208,6224,43983,708712,6256,758951,755727,2020-10-13 20:00:14.890266
Arunachal Pradesh,2891,9232,24,2940,9403,24,12367,12147,2020-10-13 20:00:14.890266
Assam,28385,164582,816,28439,166039,826,195304,193783,2020-10-13 20:00:14.890266
Bihar,11044,184541,946,10669,185911,955,197535,196531,2020-10-13 20:00:14.890266
Chandigarh,1184,11787,191,1170,11898,192,13260,13162,2020-10-13 20:00:14.890266
Chhattisgarh,27348,113771,1253,27421,116540,1286,145247,142372,2020-10-13 20:00:14.890266
Dadra and Nagar Haveli and Daman and Diu,102,3059,2,102,3064,2,3168,3163,2020-10-13 20:00:14.890266
Delhi,21701,281869,5769,20535,284844,5809,311188,309339,2020-10-13 20:00:14.890266
Goa,4656,33203,507,4465,33698,511,38674,38366,2020-10-13 20:00:14.890266
Gujarat,15695,132173,3566,15414,133615,3574,152603,151434,2020-10-13 20:00:14.890266
Haryana,10573,130003,1579,10401,131228,1592,143221,142155,2020-10-13 20:00:14.890266
Himachal Pradesh,2687,14471,250,2637,14690,251,17578,17408,2020-10-13 20:00:14.890266
Jammu and Kashmir,10466,71845,1322,9992,72706,1333,84031,83633,2020-10-13 20:00:14.890266
Jharkhand,8167,83571,787,7776,84461,798,93035,92525,2020-10-13 20:00:14.890266
Karnataka,120289,580054,9966,115795,592084,10036,717915,710309,2020-10-13 20:00:14.890266
Kerala,96401,191798,1003,94473,199634,1025,295132,289202,2020-10-13 20:00:14.890266
Ladakh,980,4037,64,961,4126,64,5151,5081,2020-10-13 20:00:14.890266
Lakshadweep,0,0,0,0,0,0,0,0,2020-10-13 20:00:14.890266
Madhya Pradesh,15177,129019,2624,14932,130721,2645,148298,146820,2020-10-13 20:00:14.890266
Maharashtra,221637,1266240,40349,212905,1281896,40514,1535315,1528226,2020-10-13 20:00:14.890266
Manipur,2731,10504,91,2756,10707,93,13556,13326,2020-10-13 20:00:14.890266
Meghalaya,2478,5142,63,2434,5273,64,7771,7683,2020-10-13 20:00:14.890266
Mizoram,174,2010,0,156,2046,0,2202,2184,2020-10-13 20:00:14.890266
Nagaland,1259,5743,17,1409,5813,18,7240,7019,2020-10-13 20:00:14.890266
Odisha,23602,227615,1022,23430,230192,1040,254662,252239,2020-10-13 20:00:14.890266
Puducherry,4695,26291,563,4617,26555,565,31737,31549,2020-10-13 20:00:14.890266
Punjab,9275,110865,3833,8576,112099,3860,124535,123973,2020-10-13 20:00:14.890266
Rajasthan,21412,135990,1650,21671,137848,1665,161184,159052,2020-10-13 20:00:14.890266
Sikkim,384,2920,55,384,2925,57,3366,3359,2020-10-13 20:00:14.890266
Tamil Nadu,44095,602038,10252,43747,607203,10314,661264,656385,2020-10-13 20:00:14.890266
Telengana,24514,187342,1228,24208,189351,1233,214792,213084,2020-10-13 20:00:14.890266
Tripura,3742,24403,316,3738,24623,317,28678,28461,2020-10-13 20:00:14.890266
Uttarakhand,7373,46931,747,6976,47609,762,55347,55051,2020-10-13 20:00:14.890266
Uttar Pradesh,40019,390566,6394,38815,393908,6438,439161,436979,2020-10-13 20:00:14.890266
West Bengal,30236,258948,5622,30604,262103,5682,298389,294806,2020-10-13 20:00:14.890266
Andaman and Nicobar Islands,198,3770,55,199,3782,55,4036,4023,2020-10-14 20:00:18.495332
Andhra Pradesh,43983,708712,6256,42855,714427,6291,763573,758951,2020-10-14 20:00:18.495332
Arunachal Pradesh,2940,9403,24,2960,9573,28,12561,12367,2020-10-14 20:00:18.495332
Assam,28439,166039,826,28897,167059,830,196786,195304,2020-10-14 20:00:18.495332
Bihar,10669,185911,955,10835,187059,961,198855,197535,2020-10-14 20:00:18.495332
Chandigarh,1170,11898,192,1127,12007,197,13331,13260,2020-10-14 20:00:18.495332
Chhattisgarh,27421,116540,1286,27208,119352,1306,147866,145247,2020-10-14 20:00:18.495332
Dadra and Nagar Haveli and Daman and Diu,102,3064,2,85,3081,2,3168,3168,2020-10-14 20:00:18.495332
Delhi,20535,284844,5809,21490,286880,5854,314224,311188,2020-10-14 20:00:18.495332
Goa,4465,33698,511,4316,34252,514,39082,38674,2020-10-14 20:00:18.495332
Gujarat,15414,133615,3574,15187,134990,3584,153761,152603,2020-10-14 20:00:18.495332
Haryana,10401,131228,1592,10319,132382,1601,144302,143221,2020-10-14 20:00:18.495332
Himachal Pradesh,2637,14690,251,2507,15001,254,17762,17578,2020-10-14 20:00:18.495332
Jammu and Kashmir,9992,72706,1333,9866,73502,1340,84708,84031,2020-10-14 20:00:18.495332
Jharkhand,7776,84461,798,7617,85314,805,93736,93035,2020-10-14 20:00:18.495332
Karnataka,115795,592084,10036,113478,602505,10123,726106,717915,2020-10-14 20:00:18.495332
Kerala,94473,199634,1025,95493,207357,1046,303896,295132,2020-10-14 20:00:18.495332
Ladakh,961,4126,64,969,4205,64,5238,5151,2020-10-14 20:00:18.495332
Lakshadweep,0,0,0,0,0,0,0,0,2020-10-14 20:00:18.495332
Madhya Pradesh,14932,130721,2645,14661,132429,2671,149761,148298,2020-10-14 20:00:18.495332
Maharashtra,212905,1281896,40514,205884,1297252,40701,1543837,1535315,2020-10-14 20:00:18.495332
Manipur,2756,10707,93,2867,10829,97,13793,13556,2020-10-14 20:00:18.495332
Meghalaya,2434,5273,64,2367,5406,65,7838,7771,2020-10-14 20:00:18.495332
Mizoram,156,2046,0,119,2093,0,2212,2202,2020-10-14 20:00:18.495332
Nagaland,1409,5813,18,1513,5831,19,7363,7240,2020-10-14 20:00:18.495332
Odisha,23430,230192,1040,22892,232988,1057,256937,254662,2020-10-14 20:00:18.495332
Puducherry,4617,26555,565,4572,26865,567,32004,31737,2020-10-14 20:00:18.495332
Punjab,8576,112099,3860,8212,113105,3894,125211,124535,2020-10-14 20:00:18.495332
Rajasthan,21671,137848,1665,21924,139616,1679,163219,161184,2020-10-14 20:00:18.495332
Sikkim,384,2925,57,344,3014,59,3417,3366,2020-10-14 20:00:18.495332
Tamil Nadu,43747,607203,10314,43239,612320,10371,665930,661264,2020-10-14 20:00:18.495332
Telengana,24208,189351,1233,23728,191269,1241,216238,214792,2020-10-14 20:00:18.495332
Tripura,3738,24623,317,3500,25041,318,28859,28678,2020-10-14 20:00:18.495332
Uttarakhand,6976,47609,762,6576,48283,782,55641,55347,2020-10-14 20:00:18.495332
Uttar Pradesh,38815,393908,6438,38082,397570,6466,442118,439161,2020-10-14 20:00:18.495332
West Bengal,30604,262103,5682,30988,265288,5744,302020,298389,2020-10-14 20:00:18.495332
Andaman and Nicobar Islands,199,3782,55,195,3796,55,4046,4036,2020-10-15 20:00:12.684775
Andhra Pradesh,42855,714427,6291,41669,719477,6319,767465,763573,2020-10-15 20:00:12.684775
Arunachal Pradesh,2960,9573,28,3045,9694,29,12768,12561,2020-10-15 20:00:12.684775
Assam,28897,167059,830,29307,168072,834,198213,196786,2020-10-15 20:00:12.684775
Bihar,10835,187059,961,10756,188380,967,200103,198855,2020-10-15 20:00:12.684775
Chandigarh,1127,12007,197,1085,12119,199,13403,13331,2020-10-15 20:00:12.684775
Chhattisgarh,27208,119352,1306,27809,121548,1339,150696,147866,2020-10-15 20:00:12.684775
Dadra and Nagar Haveli and Daman and Diu,85,3081,2,79,3090,2,3171,3168,2020-10-15 20:00:12.684775
Delhi,21490,286880,5854,21903,289747,5898,317548,314224,2020-10-15 20:00:12.684775
Goa,4316,34252,514,4188,34731,519,39438,39082,2020-10-15 20:00:12.684775
Gujarat,15187,134990,3584,14937,136404,3595,154936,153761,2020-10-15 20:00:12.684775
Haryana,10319,132382,1601,10187,133706,1614,145507,144302,2020-10-15 20:00:12.684775
Himachal Pradesh,2507,15001,254,2520,15233,255,18008,17762,2020-10-15 20:00:12.684775
Jammu and Kashmir,9866,73502,1340,9739,74318,1352,85409,84708,2020-10-15 20:00:12.684775
Jharkhand,7617,85314,805,7191,86367,811,94369,93736,2020-10-15 20:00:12.684775
Karnataka,113478,602505,10123,114006,611167,10198,735371,726106,2020-10-15 20:00:12.684775
Kerala,95493,207357,1046,93925,215149,1066,310140,303896,2020-10-15 20:00:12.684775
Ladakh,969,4205,64,979,4261,64,5304,5238,2020-10-15 20:00:12.684775
Lakshadweep,0,0,0,0,0,0,0,0,2020-10-15 20:00:12.684775
Madhya Pradesh,14661,132429,2671,14432,138158,2686,155276,149761,2020-10-15 20:00:12.684775
Maharashtra,205884,1297252,40701,196761,1316769,40859,1554389,1543837,2020-10-15 20:00:12.684775
Manipur,2867,10829,97,3076,10915,103,14094,13793,2020-10-15 20:00:12.684775
Meghalaya,2367,5406,65,2339,5582,70,7991,7838,2020-10-15 20:00:12.684775
Mizoram,119,2093,0,112,2108,0,2220,2212,2020-10-15 20:00:12.684775
Nagaland,1513,5831,19,1478,5916,22,7416,7363,2020-10-15 20:00:12.684775
Odisha,22892,232988,1057,22716,235763,1062,259541,256937,2020-10-15 20:00:12.684775
Puducherry,4572,26865,567,4525,27152,568,32245,32004,2020-10-15 20:00:12.684775
Punjab,8212,113105,3894,7760,114075,3925,125760,125211,2020-10-15 20:00:12.684775
Rajasthan,21924,139616,1679,21711,141835,1694,165240,163219,2020-10-15 20:00:12.684775
Sikkim,344,3014,59,325,3075,59,3459,3417,2020-10-15 20:00:12.684775
Tamil Nadu,43239,612320,10371,42566,617403,10423,670392,665930,2020-10-15 20:00:12.684775
Telengana,23728,191269,1241,23203,193218,1249,217670,216238,2020-10-15 20:00:12.684775
Tripura,3500,25041,318,3318,25394,319,29031,28859,2020-10-15 20:00:12.684775
Uttarakhand,6576,48283,782,6145,49129,796,56070,55641,2020-10-15 20:00:12.684775
Uttar Pradesh,38082,397570,6466,36898,401306,6507,444711,442118,2020-10-15 20:00:12.684775
West Bengal,30988,265288,5744,31505,268384,5808,305697,302020,2020-10-15 20:00:12.684775
Andaman and Nicobar Islands,195,3796,55,190,3817,55,4062,4046,2020-10-16 20:13:26.030089
Andhra Pradesh,41669,719477,6319,40047,725099,6357,771503,767465,2020-10-16 20:13:26.030089
Arunachal Pradesh,3045,9694,29,3052,9889,30,12971,12768,2020-10-16 20:13:26.030089
Assam,29307,168072,834,28804,169335,843,198982,198213,2020-10-16 20:13:26.030089
Bihar,10756,188380,967,11038,189186,972,201196,200103,2020-10-16 20:13:26.030089
Chandigarh,1085,12119,199,1044,12232,201,13477,13403,2020-10-16 20:13:26.030089
Chhattisgarh,27809,121548,1339,28187,123943,1385,153515,150696,2020-10-16 20:13:26.030089
Dadra and Nagar Haveli and Daman and Diu,79,3090,2,71,3099,2,3172,3171,2020-10-16 20:13:26.030089
Delhi,21903,289747,5898,22605,292502,5924,321031,317548,2020-10-16 20:13:26.030089
Goa,4188,34731,519,4084,35161,525,39770,39438,2020-10-16 20:13:26.030089
Gujarat,14937,136404,3595,14782,137733,3606,156121,154936,2020-10-16 20:13:26.030089
Haryana,10187,133706,1614,10364,134719,1623,146706,145507,2020-10-16 20:13:26.030089
Himachal Pradesh,2520,15233,255,2654,15389,260,18303,18008,2020-10-16 20:13:26.030089
Jammu and Kashmir,9739,74318,1352,9058,75641,1358,86057,85409,2020-10-16 20:13:26.030089
Jharkhand,7191,86367,811,6892,87240,820,94952,94369,2020-10-16 20:13:26.030089
Karnataka,114006,611167,10198,113557,620008,10283,743848,735371,2020-10-16 20:13:26.030089
Kerala,93925,215149,1066,94609,222231,1089,317929,310140,2020-10-16 20:13:26.030089
Ladakh,979,4261,64,1018,4310,65,5393,5304,2020-10-16 20:13:26.030089
Lakshadweep,0,0,0,0,0,0,0,0,2020-10-16 20:13:26.030089
Madhya Pradesh,14432,138158,2686,14157,139717,2710,156584,155276,2020-10-16 20:13:26.030089
Maharashtra,196761,1316769,40859,192936,1330483,41196,1564615,1554389,2020-10-16 20:13:26.030089
Manipur,3076,10915,103,3193,11081,104,14378,14094,2020-10-16 20:13:26.030089
Meghalaya,2339,5582,70,2445,5646,73,8164,7991,2020-10-16 20:13:26.030089
Mizoram,112,2108,0,108,2121,0,2229,2220,2020-10-16 20:13:26.030089
Nagaland,1478,5916,22,1453,6017,22,7492,7416,2020-10-16 20:13:26.030089
Odisha,22716,235763,1062,22387,238535,1089,262011,259541,2020-10-16 20:13:26.030089
Puducherry,4525,27152,568,4551,27365,570,32486,32245,2020-10-16 20:13:26.030089
Punjab,7760,114075,3925,7090,115186,3954,126230,125760,2020-10-16 20:13:26.030089
Rajasthan,21711,141835,1694,21587,143984,1708,167279,165240,2020-10-16 20:13:26.030089
Sikkim,325,3075,59,312,3129,59,3500,3459,2020-10-16 20:13:26.030089
Tamil Nadu,42566,617403,10423,41872,622458,10472,674802,670392,2020-10-16 20:13:26.030089
Telengana,23203,193218,1249,23315,194653,1256,219224,217670,2020-10-16 20:13:26.030089
Tripura,3318,25394,319,3105,25765,323,29193,29031,2020-10-16 20:13:26.030089
Uttarakhand,6145,49129,796,5682,49997,814,56493,56070,2020-10-16 20:13:26.030089
Uttar Pradesh,36898,401306,6507,36295,404545,6543,447383,444711,2020-10-16 20:13:26.030089
West Bengal,31505,268384,5808,31984,271563,5870,309417,305697,2020-10-16 20:13:26.030089
Andaman and Nicobar Islands,190,3817,55,185,3831,56,4072,4062,2020-10-17 20:32:20.666464
Andhra Pradesh,40047,725099,6357,38979,730109,6382,775470,771503,2020-10-17 20:32:20.666464
Arunachal Pradesh,3052,9889,30,3068,10071,30,13169,12971,2020-10-17 20:32:20.666464
Assam,28804,169335,843,28631,170265,853,199749,198982,2020-10-17 20:32:20.666464
Bihar,11038,189186,972,10884,190425,981,202290,201196,2020-10-17 20:32:20.666464
Chandigarh,1044,12232,201,974,12352,206,13532,13477,2020-10-17 20:32:20.666464
Chhattisgarh,28187,123943,1385,27693,126869,1425,155987,153515,2020-10-17 20:32:20.666464
Dadra and Nagar Haveli and Daman and Diu,71,3099,2,66,3109,2,3177,3172,2020-10-17 20:32:20.666464
Delhi,22605,292502,5924,22814,295699,5946,324459,321031,2020-10-17 20:32:20.666464
Goa,4084,35161,525,3950,35610,531,40091,39770,2020-10-17 20:32:20.666464
Gujarat,14782,137733,3606,14683,139012,3617,157312,156121,2020-10-17 20:32:20.666464
Haryana,10364,134719,1623,10441,135858,1634,147933,146706,2020-10-17 20:32:20.666464
Himachal Pradesh,2654,15389,260,2642,15618,262,18522,18303,2020-10-17 20:32:20.666464
Jammu and Kashmir,9058,75641,1358,8909,76479,1366,86754,86057,2020-10-17 20:32:20.666464
Jharkhand,6892,87240,820,6543,88058,824,95425,94952,2020-10-17 20:32:20.666464
Karnataka,113557,620008,10283,112446,628588,10356,751390,743848,2020-10-17 20:32:20.666464
Kerala,94609,222231,1089,95101,228998,1113,325212,317929,2020-10-17 20:32:20.666464
Ladakh,1018,4310,65,915,4461,65,5441,5393,2020-10-17 20:32:20.666464
Lakshadweep,0,0,0,0,0,0,0,0,2020-10-17 20:32:20.666464
Madhya Pradesh,14157,139717,2710,13928,141273,2735,157936,156584,2020-10-17 20:32:20.666464
Maharashtra,192936,1330483,41196,190192,1344368,41502,1576062,1564615,2020-10-17 20:32:20.666464
Manipur,3193,11081,104,3361,11245,109,14715,14378,2020-10-17 20:32:20.666464
Meghalaya,2445,5646,73,2493,5735,75,8303,864,2020-10-17 20:32:20.666464
Mizoram,108,2121,0,112,2133,0,2245,2229,2020-10-17 20:32:20.666464
Nagaland,1453,6017,22,1471,6111,22,7604,7492,2020-10-17 20:32:20.666464
Odisha,22387,238535,1089,21660,241385,1104,264149,262011,2020-10-17 20:32:20.666464
Puducherry,4551,27365,570,4524,27671,571,32766,32486,2020-10-17 20:32:20.666464
Punjab,7090,115186,3954,6592,116165,3980,126737,126230,2020-10-17 20:32:20.666464
Rajasthan,21587,143984,1708,21381,146185,1723,169289,167279,2020-10-17 20:32:20.666464
Sikkim,312,3129,59,295,3177,59,3531,3500,2020-10-17 20:32:20.666464
Tamil Nadu,41872,622458,10472,40959,627703,10529,679191,674802,2020-10-17 20:32:20.666464
Telengana,23315,194653,1256,22774,196636,1265,220675,219224,2020-10-17 20:32:20.666464
Tripura,3105,25765,323,2966,26035,326,29327,29193,2020-10-17 20:32:20.666464
Uttarakhand,5682,49997,814,5692,50521,829,57042,56493,2020-10-17 20:32:20.666464
Uttar Pradesh,36295,404545,6543,35263,408083,6589,449935,447383,2020-10-17 20:32:20.666464
West Bengal,31984,271563,5870,32500,274757,5931,313188,309417,2020-10-17 20:32:20.666464
Andaman and Nicobar Islands,185,3831,56,179,3848,56,4083,4072,2020-10-18 21:27:13.847218
Andhra Pradesh,38979,730109,6382,37102,735638,6406,779146,775470,2020-10-18 21:27:13.847218
Arunachal Pradesh,3068,10071,30,3003,10315,30,13348,13169,2020-10-18 21:27:13.847218
Assam,28631,170265,853,28442,171084,865,200391,199749,2020-10-18 21:27:13.847218
Bihar,10884,190425,981,10848,191619,990,203457,202290,2020-10-18 21:27:13.847218
Chandigarh,974,12352,206,915,12460,207,13582,13532,2020-10-18 21:27:13.847218
Chhattisgarh,27693,126869,1425,27180,129883,1439,158502,155987,2020-10-18 21:27:13.847218
Dadra and Nagar Haveli and Daman and Diu,66,3109,2,59,3119,2,3180,3177,2020-10-18 21:27:13.847218
Delhi,22814,295699,5946,22884,298853,5981,327718,324459,2020-10-18 21:27:13.847218
Goa,3950,35610,531,3827,36035,538,40400,40091,2020-10-18 21:27:13.847218
Gujarat,14683,139012,3617,14565,140282,3626,158473,157312,2020-10-18 21:27:13.847218
Haryana,10441,135858,1634,10265,137176,1640,149081,147933,2020-10-18 21:27:13.847218
Himachal Pradesh,2642,15618,262,2680,15852,265,18797,18522,2020-10-18 21:27:13.847218
Jammu and Kashmir,8909,76479,1366,8704,77288,1372,87364,86754,2020-10-18 21:27:13.847218
Jharkhand,6543,88058,824,6576,88559,832,95967,95425,2020-10-18 21:27:13.847218
Karnataka,112446,628588,10356,110666,637481,10427,758574,751390,2020-10-18 21:27:13.847218
Kerala,95101,228998,1113,96100,236989,1139,334228,325212,2020-10-18 21:27:13.847218
Ladakh,915,4461,65,933,4535,66,5534,5441,2020-10-18 21:27:13.847218
Lakshadweep,0,0,0,0,0,0,0,0,2020-10-18 21:27:13.847218
Madhya Pradesh,13928,141273,2735,13698,142707,2753,159158,157936,2020-10-18 21:27:13.847218
Maharashtra,190192,1344368,41502,185750,1358606,41965,1586321,1576062,2020-10-18 21:27:13.847218
Manipur,3361,11245,109,3587,11443,111,15141,14715,2020-10-18 21:27:13.847218
Meghalaya,2493,5735,75,2295,6034,75,8404,8303,2020-10-18 21:27:13.847218
Mizoram,112,2133,0,108,2145,0,2253,2245,2020-10-18 21:27:13.847218
Nagaland,1471,6111,22,1530,6141,27,7698,7604,2020-10-18 21:27:13.847218
Odisha,21660,241385,1104,20997,244227,1121,266345,264149,2020-10-18 21:27:13.847218
Puducherry,4524,27671,571,4420,27984,574,32978,32766,2020-10-18 21:27:13.847218
Punjab,6592,116165,3980,6230,116925,3999,127154,126737,2020-10-18 21:27:13.847218
Rajasthan,21381,146185,1723,21255,148291,1735,171281,169289,2020-10-18 21:27:13.847218
Sikkim,295,3177,59,275,3233,59,3567,3531,2020-10-18 21:27:13.847218
Tamil Nadu,40959,627703,10529,40192,632708,10586,683486,679191,2020-10-18 21:27:13.847218
Telengana,22774,196636,1265,22050,198790,1271,222111,220675,2020-10-18 21:27:13.847218
Tripura,2966,26035,326,2917,26222,329,29468,29327,2020-10-18 21:27:13.847218
Uttarakhand,5692,50521,829,5538,51186,924,57648,57042,2020-10-18 21:27:13.847218
Uttar Pradesh,35263,408083,6589,34420,411611,6629,452660,449935,2020-10-18 21:27:13.847218
West Bengal,32500,274757,5931,33121,277940,5992,317053,313188,2020-10-18 21:27:13.847218
Andaman and Nicobar Islands,179,3848,56,184,3868,56,4108,4083,2020-10-19 20:43:18.494816
Andhra Pradesh,37102,735638,6406,36474,740229,6429,783132,779146,2020-10-19 20:43:18.494816
Arunachal Pradesh,3003,10315,30,2824,10552,30,13406,13348,2020-10-19 20:43:18.494816
Assam,28442,171084,865,28158,171683,868,200709,200391,2020-10-19 20:43:18.494816
Bihar,10848,191619,990,10584,192783,996,204363,203457,2020-10-19 20:43:18.494816
Chandigarh,915,12460,207,884,12554,208,13646,13582,2020-10-19 20:43:18.494816
Chhattisgarh,27180,129883,1439,26750,132168,1478,160396,158502,2020-10-19 20:43:18.494816
Dadra and Nagar Haveli and Daman and Diu,59,3119,2,54,3127,2,3183,3180,2020-10-19 20:43:18.494816
Delhi,22884,298853,5981,23292,301716,6009,331017,327718,2020-10-19 20:43:18.494816
Goa,3827,36035,538,3648,36395,544,40587,40400,2020-10-19 20:43:18.494816
Gujarat,14565,140282,3626,14414,141515,3635,159564,158473,2020-10-19 20:43:18.494816
Haryana,10265,137176,1640,10042,138351,1640,150033,149081,2020-10-19 20:43:18.494816
Himachal Pradesh,2680,15852,265,2630,16069,268,18967,18797,2020-10-19 20:43:18.494816
Jammu and Kashmir,8704,77288,1372,8677,77886,1379,87942,87364,2020-10-19 20:43:18.494816
Jharkhand,6576,88559,832,6502,89011,839,96352,95967,2020-10-19 20:43:18.494816
Karnataka,110666,637481,10427,109283,645825,10478,765586,758574,2020-10-19 20:43:18.494816
Kerala,96100,236989,1139,95299,245399,1161,341859,334228,2020-10-19 20:43:18.494816
Ladakh,933,4535,66,917,4615,66,5598,5534,2020-10-19 20:43:18.494816
Lakshadweep,0,0,0,0,0,0,0,0,2020-10-19 20:43:18.494816
Madhya Pradesh,13698,142707,2753,13281,144134,2773,160188,159158,2020-10-19 20:43:18.494816
Maharashtra,185750,1358606,41965,183456,1369810,42115,1595381,1586321,2020-10-19 20:43:18.494816
Manipur,3587,11443,111,3606,11741,116,15463,15141,2020-10-19 20:43:18.494816
Meghalaya,2295,6034,75,2151,6282,75,8508,8404,2020-10-19 20:43:18.494816
Mizoram,108,2145,0,105,2148,0,2253,2253,2020-10-19 20:43:18.494816
Nagaland,1530,6141,27,1583,6206,27,7816,7698,2020-10-19 20:43:18.494816
Odisha,20997,244227,1121,20392,246837,1135,268364,266345,2020-10-19 20:43:18.494816
Puducherry,4420,27984,574,4277,28290,574,33141,32978,2020-10-19 20:43:18.494816
Punjab,6230,116925,3999,5735,117883,4012,127630,127154,2020-10-19 20:43:18.494816
Rajasthan,21255,148291,1735,21139,150379,1748,173266,171281,2020-10-19 20:43:18.494816
Sikkim,275,3233,59,272,3265,60,3597,3567,2020-10-19 20:43:18.494816
Tamil Nadu,40192,632708,10586,39121,637637,10642,687400,683486,2020-10-19 20:43:18.494816
Telengana,22050,198790,1271,21098,200686,1275,223059,222111,2020-10-19 20:43:18.494816
Tripura,2917,26222,329,2672,26550,331,29553,29468,2020-10-19 20:43:18.494816
Uttarakhand,5538,51186,924,5728,51369,927,58024,57648,2020-10-19 20:43:18.494816
Uttar Pradesh,34420,411611,6629,32896,415592,6658,455146,452660,2020-10-19 20:43:18.494816
West Bengal,33121,277940,5992,33927,281053,6056,321036,317053,2020-10-19 20:43:18.494816
Andaman and Nicobar Islands,184,3868,56,178,3892,56,4126,4108,2020-10-20 20:00:14.691672
Andhra Pradesh,36474,740229,6429,35065,744532,6453,786050,783132,2020-10-20 20:00:14.691672
Arunachal Pradesh,2824,10552,30,2833,10780,30,13643,13406,2020-10-20 20:00:14.691672
Assam,28158,171683,868,27319,173213,875,201407,200709,2020-10-20 20:00:14.691672
Bihar,10584,192783,996,10937,194005,1003,205945,204363,2020-10-20 20:00:14.691672
Chandigarh,884,12554,208,861,12617,208,13686,13646,2020-10-20 20:00:14.691672
Chhattisgarh,26750,132168,1478,25979,135259,1534,162772,160396,2020-10-20 20:00:14.691672
Dadra and Nagar Haveli and Daman and Diu,54,3127,2,43,3140,2,3185,3183,2020-10-20 20:00:14.691672
Delhi,23292,301716,6009,22570,304561,6040,333171,331017,2020-10-20 20:00:14.691672
Goa,3648,36395,544,3283,36914,549,40746,40587,2020-10-20 20:00:14.691672
Gujarat,14414,141515,3635,14255,142662,3643,160560,159564,2020-10-20 20:00:14.691672
Haryana,10042,138351,1640,10075,139511,1648,151234,150033,2020-10-20 20:00:14.691672
Himachal Pradesh,2630,16069,268,2593,16270,272,19135,18967,2020-10-20 20:00:14.691672
Jammu and Kashmir,8677,77886,1379,8314,78667,1388,88369,87942,2020-10-20 20:00:14.691672
Jharkhand,6502,89011,839,6220,89780,842,96842,96352,2020-10-20 20:00:14.691672
Karnataka,109283,645825,10478,106233,653829,10542,770604,765586,2020-10-20 20:00:14.691672
Kerala,95299,245399,1161,92831,252868,1182,346881,341859,2020-10-20 20:00:14.691672
Ladakh,917,4615,66,880,4701,66,5647,5598,2020-10-20 20:00:14.691672
Lakshadweep,0,0,0,0,0,0,0,0,2020-10-20 20:00:14.691672
Madhya Pradesh,13281,144134,2773,12996,145421,2786,161203,160188,2020-10-20 20:00:14.691672
Maharashtra,183456,1369810,42115,174246,1384879,42240,1601365,1595381,2020-10-20 20:00:14.691672
Manipur,3606,11741,116,3748,11913,117,15778,15463,2020-10-20 20:00:14.691672
Meghalaya,2151,6282,75,2069,6392,75,8536,8508,2020-10-20 20:00:14.691672
Mizoram,105,2148,0,129,2151,0,2280,2253,2020-10-20 20:00:14.691672
Nagaland,1583,6206,27,1653,6273,27,7953,7816,2020-10-20 20:00:14.691672
Odisha,20392,246837,1135,19619,249575,1152,270346,268364,2020-10-20 20:00:14.691672
Puducherry,4277,28290,574,4152,28520,575,33247,33141,2020-10-20 20:00:14.691672
Punjab,5735,117883,4012,5307,118767,4029,128103,127630,2020-10-20 20:00:14.691672
Rajasthan,21139,150379,1748,20893,152573,1760,175226,173266,2020-10-20 20:00:14.691672
Sikkim,272,3265,60,263,3276,62,3601,3597,2020-10-20 20:00:14.691672
Tamil Nadu,39121,637637,10642,38093,642152,10691,690936,687400,2020-10-20 20:00:14.691672
Telengana,21098,200686,1275,20686,202577,1282,224545,223059,2020-10-20 20:00:14.691672
Tripura,2672,26550,331,2609,26748,331,29688,29553,2020-10-20 20:00:14.691672
Uttarakhand,5728,51369,927,5527,51900,933,58360,58024,2020-10-20 20:00:14.691672
Uttar Pradesh,32896,415592,6658,31495,418685,6685,456865,455146,2020-10-20 20:00:14.691672
West Bengal,33927,281053,6056,34584,284325,6119,325028,321036,2020-10-20 20:00:14.691672
Andaman and Nicobar Islands,178,3892,56,183,3902,56,4141,4126,2020-10-21 20:19:43.827168
Andhra Pradesh,35065,744532,6453,33396,749676,6481,789553,786050,2020-10-21 20:19:43.827168
Arunachal Pradesh,2833,10780,30,2712,11035,31,13778,13643,2020-10-21 20:19:43.827168
Assam,27319,173213,875,26775,174414,884,202073,201407,2020-10-21 20:19:43.827168
Bihar,10937,194005,1003,11348,195046,1011,207405,205945,2020-10-21 20:19:43.827168
Chandigarh,861,12617,208,810,12724,209,13743,13686,2020-10-21 20:19:43.827168
Chhattisgarh,25979,135259,1534,25709,137986,1584,165279,162772,2020-10-21 20:19:43.827168
Dadra and Nagar Haveli and Daman and Diu,43,3140,2,39,3153,2,3194,3185,2020-10-21 20:19:43.827168
Delhi,22570,304561,6040,23922,306747,6081,336750,333171,2020-10-21 20:19:43.827168
Goa,3283,36914,549,3201,37275,555,41031,40746,2020-10-21 20:19:43.827168
Gujarat,14255,142662,3643,14245,143790,3651,161686,160560,2020-10-21 20:19:43.827168
Haryana,10075,139511,1648,10078,140436,1660,152174,151234,2020-10-21 20:19:43.827168
Himachal Pradesh,2593,16270,272,2596,16487,274,19357,19135,2020-10-21 20:19:43.827168
Jammu and Kashmir,8314,78667,1388,8124,79437,1397,88958,88369,2020-10-21 20:19:43.827168
Jharkhand,6220,89780,842,6180,90385,849,97414,96842,2020-10-21 20:19:43.827168
Karnataka,106233,653829,10542,103964,662329,10608,776901,770604,2020-10-21 20:19:43.827168
Kerala,92831,252868,1182,92023,260243,1206,353472,346881,2020-10-21 20:19:43.827168
Ladakh,880,4701,66,841,4787,67,5695,5647,2020-10-21 20:19:43.827168
Lakshadweep,0,0,0,0,0,0,0,0,2020-10-21 20:19:43.827168
Madhya Pradesh,12996,145421,2786,12507,146860,2811,162178,161203,2020-10-21 20:19:43.827168
Maharashtra,174246,1384879,42240,174755,1392308,42453,1609516,1601365,2020-10-21 20:19:43.827168
Manipur,3748,11913,117,3882,12059,121,16062,15778,2020-10-21 20:19:43.827168
Meghalaya,2069,6392,75,2020,6497,76,8593,8536,2020-10-21 20:19:43.827168
Mizoram,129,2151,0,145,2165,0,2310,2280,2020-10-21 20:19:43.827168
Nagaland,1653,6273,27,1658,6334,28,8020,7953,2020-10-21 20:19:43.827168
Odisha,19619,249575,1152,18885,252197,1168,272250,270346,2020-10-21 20:19:43.827168
Puducherry,4152,28520,575,4101,28774,577,33452,33247,2020-10-21 20:19:43.827168
Punjab,5307,118767,4029,4895,119658,4037,128590,128103,2020-10-21 20:19:43.827168
Rajasthan,20893,152573,1760,20254,155095,1774,177123,175226,2020-10-21 20:19:43.827168
Sikkim,263,3276,62,254,3326,63,3643,3601,2020-10-21 20:19:43.827168
Tamil Nadu,38093,642152,10691,36734,646555,10741,694030,690936,2020-10-21 20:19:43.827168
Telengana,20686,202577,1282,20449,204388,1287,226124,224545,2020-10-21 20:19:43.827168
Tripura,2609,26748,331,2455,27013,332,29800,29688,2020-10-21 20:19:43.827168
Uttarakhand,5527,51900,933,5364,52291,946,58601,58360,2020-10-21 20:19:43.827168
Uttar Pradesh,31495,418685,6685,30416,422024,6714,459154,456865,2020-10-21 20:19:43.827168
West Bengal,34584,284325,6119,35170,287707,6180,329057,325028,2020-10-21 20:19:43.827168
Andaman and Nicobar Islands,183,3902,56,199,3913,56,4168,4141,2020-10-22 18:43:02.934161
Andhra Pradesh,33396,749676,6481,32376,754415,6508,793299,789553,2020-10-22 18:43:02.934161
Arunachal Pradesh,2712,11035,31,2682,11199,31,13912,13778,2020-10-22 18:43:02.934161
Assam,26775,174414,884,25807,176078,889,202774,202073,2020-10-22 18:43:02.934161
Bihar,11348,195046,1011,11118,196240,1019,208377,207405,2020-10-22 18:43:02.934161
Chandigarh,810,12724,209,744,12842,209,13795,13743,2020-10-22 18:43:02.934161
Chhattisgarh,25709,137986,1584,25795,140216,1628,167639,165279,2020-10-22 18:43:02.934161
Dadra and Nagar Haveli and Daman and Diu,39,3153,2,44,3161,2,3207,3194,2020-10-22 18:43:02.934161
Delhi,23922,306747,6081,24117,310191,6128,340436,336750,2020-10-22 18:43:02.934161
Goa,3201,37275,555,3099,37683,557,41339,41031,2020-10-22 18:43:02.934161
Gujarat,14245,143790,3651,14193,144970,3660,162823,161686,2020-10-22 18:43:02.934161
Haryana,10078,140436,1660,10187,141506,1674,153367,152174,2020-10-22 18:43:02.934161
Himachal Pradesh,2596,16487,274,2636,16706,279,19621,19357,2020-10-22 18:43:02.934161
Jammu and Kashmir,8124,79437,1397,8088,80092,1402,89582,88958,2020-10-22 18:43:02.934161
Jharkhand,6180,90385,849,6206,91004,851,98061,97414,2020-10-22 18:43:02.934161
Karnataka,103964,662329,10608,100459,671618,10696,782773,776901,2020-10-22 18:43:02.934161
Kerala,92023,260243,1206,93527,267082,1232,361841,353472,2020-10-22 18:43:02.934161
Ladakh,841,4787,67,848,4865,68,5781,5695,2020-10-22 18:43:02.934161
Lakshadweep,0,0,0,0,0,0,0,0,2020-10-22 18:43:02.934161
Madhya Pradesh,12507,146860,2811,12386,148082,2828,163296,162178,2020-10-22 18:43:02.934161
Maharashtra,174755,1392308,42453,159346,1415679,42633,1617658,1609516,2020-10-22 18:43:02.934161
Manipur,3882,12059,121,3846,12297,124,16267,16062,2020-10-22 18:43:02.934161
Meghalaya,2020,6497,76,1870,6674,77,8621,8593,2020-10-22 18:43:02.934161
Mizoram,145,2165,0,167,2174,0,2341,2310,2020-10-22 18:43:02.934161
Nagaland,1658,6334,28,1683,6428,28,8139,8020,2020-10-22 18:43:02.934161
Odisha,18885,252197,1168,18087,254913,1181,274181,272250,2020-10-22 18:43:02.934161
Puducherry,4101,28774,577,4026,29016,580,33622,33452,2020-10-22 18:43:02.934161
Punjab,4895,119658,4037,4808,120220,4060,129088,128590,2020-10-22 18:43:02.934161
Rajasthan,20254,155095,1774,19185,157960,1788,178933,177123,2020-10-22 18:43:02.934161
Sikkim,254,3326,63,253,3361,63,3677,3643,2020-10-22 18:43:02.934161
Tamil Nadu,36734,646555,10741,35480,650856,10780,697116,694030,2020-10-22 18:43:02.934161
Telengana,20449,204388,1287,20183,206105,1292,227580,226124,2020-10-22 18:43:02.934161
Tripura,2455,27013,332,2339,27252,334,29925,29800,2020-10-22 18:43:02.934161
Uttarakhand,5364,52291,946,5085,53061,960,59106,58601,2020-10-22 18:43:02.934161
Uttar Pradesh,30416,422024,6714,29364,425356,6755,461475,459154,2020-10-22 18:43:02.934161
West Bengal,35170,287707,6180,35579,291303,6244,333126,329057,2020-10-22 18:43:02.934161
Andaman and Nicobar Islands,199,3913,56,190,3937,57,4184,4168,2020-10-23 20:00:13.635397
Andhra Pradesh,32376,754415,6508,32257,758138,6524,796919,793299,2020-10-23 20:00:13.635397
Arunachal Pradesh,2682,11199,31,2638,11407,32,14077,13912,2020-10-23 20:00:13.635397
Assam,25807,176078,889,24724,177662,896,203282,202774,2020-10-23 20:00:13.635397
Bihar,11118,196240,1019,11213,197208,1026,209447,208377,2020-10-23 20:00:13.635397
Chandigarh,744,12842,209,712,12924,212,13848,13795,2020-10-23 20:00:13.635397
Chhattisgarh,25795,140216,1628,25238,143212,1680,170130,167639,2020-10-23 20:00:13.635397
Dadra and Nagar Haveli and Daman and Diu,44,3161,2,47,3164,2,3213,3207,2020-10-23 20:00:13.635397
Delhi,24117,310191,6128,25237,312918,6163,344318,340436,2020-10-23 20:00:13.635397
Goa,3099,37683,557,2991,38031,564,41586,41339,2020-10-23 20:00:13.635397
Gujarat,14193,144970,3660,14121,146171,3667,163959,162823,2020-10-23 20:00:13.635397
Haryana,10187,141506,1674,10009,142798,1688,154495,153367,2020-10-23 20:00:13.635397
Himachal Pradesh,2636,16706,279,2623,16937,284,19844,19621,2020-10-23 20:00:13.635397
Jammu and Kashmir,8088,80092,1402,7952,80802,1412,90166,89582,2020-10-23 20:00:13.635397
Jharkhand,6206,91004,851,6122,91629,859,98610,98061,2020-10-23 20:00:13.635397
Karnataka,100459,671618,10696,92946,684835,10770,788551,782773,2020-10-23 20:00:13.635397
Kerala,93527,267082,1232,93393,274675,1255,369323,361841,2020-10-23 20:00:13.635397
Ladakh,848,4865,68,842,4902,68,5812,5781,2020-10-23 20:00:13.635397
Lakshadweep,0,0,0,0,0,0,0,0,2020-10-23 20:00:13.635397
Madhya Pradesh,12386,148082,2828,12146,149353,2842,164341,163296,2020-10-23 20:00:13.635397
Maharashtra,159346,1415679,42633,150510,1431856,42831,1625197,1617658,2020-10-23 20:00:13.635397
Manipur,3846,12297,124,4101,12393,127,16621,16267,2020-10-23 20:00:13.635397
Meghalaya,1870,6674,77,1661,6981,78,8720,8621,2020-10-23 20:00:13.635397
Mizoram,167,2174,0,184,2175,0,2359,2341,2020-10-23 20:00:13.635397
Nagaland,1683,6428,28,1799,6469,28,8296,8139,2020-10-23 20:00:13.635397
Odisha,18087,254913,1181,17857,257041,1196,276094,274181,2020-10-23 20:00:13.635397
Puducherry,4026,29016,580,4039,29211,582,33832,33622,2020-10-23 20:00:13.635397
Punjab,4808,120220,4060,4466,121155,4072,129693,129088,2020-10-23 20:00:13.635397
Rajasthan,19185,157960,1788,18341,160614,1800,180755,178933,2020-10-23 20:00:13.635397
Sikkim,253,3361,63,254,3410,63,3727,3677,2020-10-23 20:00:13.635397
Tamil Nadu,35480,650856,10780,34198,655170,10825,700193,697116,2020-10-23 20:00:13.635397
Telengana,20183,206105,1292,20377,207326,1298,229001,227580,2020-10-23 20:00:13.635397
Tripura,2339,27252,334,2229,27502,339,30070,29925,2020-10-23 20:00:13.635397
Uttarakhand,5085,53061,960,4897,53643,968,59508,59106,2020-10-23 20:00:13.635397
Uttar Pradesh,29364,425356,6755,29131,427937,6790,463858,461475,2020-10-23 20:00:13.635397
West Bengal,35579,291303,6244,36064,294911,6308,337283,333126,2020-10-23 20:00:13.635397
Andaman and Nicobar Islands,190,3937,57,204,3945,58,4207,4184,2020-10-24 20:16:23.369625
Andhra Pradesh,32257,758138,6524,31721,762419,6544,800684,796919,2020-10-24 20:16:23.369625
Arunachal Pradesh,2638,11407,32,2499,11613,33,14145,14077,2020-10-24 20:16:23.369625
Assam,24724,177662,896,22963,179846,900,203709,203282,2020-10-24 20:16:23.369625
Bihar,11213,197208,1026,10630,198532,1034,210196,209447,2020-10-24 20:16:23.369625
Chandigarh,712,12924,212,697,13009,214,13920,13848,2020-10-24 20:16:23.369625
Chhattisgarh,25238,143212,1680,24620,146222,1738,172580,170130,2020-10-24 20:16:23.369625
Dadra and Nagar Haveli and Daman and Diu,47,3164,2,51,3167,2,3220,3213,2020-10-24 20:16:23.369625
Delhi,25237,312918,6163,26001,316214,6189,348404,344318,2020-10-24 20:16:23.369625
Goa,2991,38031,564,2824,38421,568,41813,41586,2020-10-24 20:16:23.369625
Gujarat,14121,146171,3667,13963,147435,3673,165071,163959,2020-10-24 20:16:23.369625
Haryana,10009,142798,1688,10082,143978,1705,155765,154495,2020-10-24 20:16:23.369625
Himachal Pradesh,2623,16937,284,2620,17135,285,20040,19844,2020-10-24 20:16:23.369625
Jammu and Kashmir,7952,80802,1412,7842,81486,1424,90752,90166,2020-10-24 20:16:23.369625
Jharkhand,6122,91629,859,6055,92128,862,99045,98610,2020-10-24 20:16:23.369625
Karnataka,92946,684835,10770,89502,693584,10821,793907,788551,2020-10-24 20:16:23.369625
Kerala,93393,274675,1255,95760,280793,1281,377834,369323,2020-10-24 20:16:23.369625
Ladakh,842,4902,68,788,4984,68,5840,5812,2020-10-24 20:16:23.369625
Lakshadweep,0,0,0,0,0,0,0,0,2020-10-24 20:16:23.369625
Madhya Pradesh,12146,149353,2842,11761,150678,2855,165294,164341,2020-10-24 20:16:23.369625
Maharashtra,150510,1431856,42831,144426,1445103,43015,1632544,1625197,2020-10-24 20:16:23.369625
Manipur,4101,12393,127,4083,12562,132,16777,16621,2020-10-24 20:16:23.369625
Meghalaya,1661,6981,78,1631,7091,79,8801,8720,2020-10-24 20:16:23.369625
Mizoram,184,2175,0,198,2189,0,2387,2359,2020-10-24 20:16:23.369625
Nagaland,1799,6469,28,1838,6570,28,8436,8296,2020-10-24 20:16:23.369625
Odisha,17857,257041,1196,17255,259418,1214,277887,276094,2020-10-24 20:16:23.369625
Puducherry,4039,29211,582,3975,29427,584,33986,33832,2020-10-24 20:16:23.369625
Punjab,4466,121155,4072,4327,121735,4095,130157,129693,2020-10-24 20:16:23.369625
Rajasthan,18341,160614,1800,17775,162981,1814,182570,180755,2020-10-24 20:16:23.369625
Sikkim,254,3410,63,242,3465,63,3770,3727,2020-10-24 20:16:23.369625
Tamil Nadu,34198,655170,10825,32960,659432,10858,703250,700193,2020-10-24 20:16:23.369625
Telengana,20377,207326,1298,19937,209034,1303,230274,229001,2020-10-24 20:16:23.369625
Tripura,2229,27502,339,2055,27740,340,30135,30070,2020-10-24 20:16:23.369625
Uttarakhand,4897,53643,968,4656,54161,979,59796,59508,2020-10-24 20:16:23.369625
Uttar Pradesh,29131,427937,6790,28268,430962,6830,466060,463858,2020-10-24 20:16:23.369625
West Bengal,36064,294911,6308,36471,298587,6368,341426,337283,2020-10-24 20:16:23.369625
Andaman and Nicobar Islands,204,3945,58,199,3968,58,4225,4207,2020-10-25 18:15:19.693115
Andhra Pradesh,31721,762419,6544,31469,765991,6566,804026,800684,2020-10-25 18:15:19.693115
Arunachal Pradesh,2499,11613,33,2397,11781,33,14211,14145,2020-10-25 18:15:19.693115
Assam,22963,179846,900,20271,182794,902,203967,203709,2020-10-25 18:15:19.693115
Bihar,10630,198532,1034,10459,199757,1042,211258,210196,2020-10-25 18:15:19.693115
Chandigarh,697,13009,214,674,13087,216,13977,13920,2020-10-25 18:15:19.693115
Chhattisgarh,24620,146222,1738,23899,148899,1793,174591,172580,2020-10-25 18:15:19.693115
Dadra and Nagar Haveli and Daman and Diu,51,3167,2,50,3173,2,3225,3220,2020-10-25 18:15:19.693115
Delhi,26001,316214,6189,26467,319828,6225,352520,348404,2020-10-25 18:15:19.693115
Goa,2824,38421,568,2692,38769,570,42031,41813,2020-10-25 18:15:19.693115
Gujarat,13963,147435,3673,13965,148448,3679,166092,165071,2020-10-25 18:15:19.693115
Haryana,10082,143978,1705,10148,145196,1720,157064,155765,2020-10-25 18:15:19.693115
Himachal Pradesh,2620,17135,285,2605,17318,290,20213,20040,2020-10-25 18:15:19.693115
Jammu and Kashmir,7842,81486,1424,7680,82219,1430,91329,90752,2020-10-25 18:15:19.693115
Jharkhand,6055,92128,862,5966,92598,864,99428,99045,2020-10-25 18:15:19.693115
Karnataka,89502,693584,10821,86768,700737,10873,798378,793907,2020-10-25 18:15:19.693115
Kerala,95760,280793,1281,97520,287261,1306,386087,377834,2020-10-25 18:15:19.693115
Ladakh,788,4984,68,790,5052,71,5913,5840,2020-10-25 18:15:19.693115
Lakshadweep,0,0,0,0,0,0,0,0,2020-10-25 18:15:19.693115
Madhya Pradesh,11761,150678,2855,11477,151946,2875,166298,165294,2020-10-25 18:15:19.693115
Maharashtra,144426,1445103,43015,140702,1455107,43152,1638961,1632544,2020-10-25 18:15:19.693115
Manipur,4083,12562,132,4165,12719,138,17022,16777,2020-10-25 18:15:19.693115
Meghalaya,1631,7091,79,1574,7228,80,8882,8801,2020-10-25 18:15:19.693115
Mizoram,198,2189,0,249,2198,0,2447,2387,2020-10-25 18:15:19.693115
Nagaland,1838,6570,28,1817,6668,30,8515,8436,2020-10-25 18:15:19.693115
Odisha,17255,259418,1214,16322,262031,1229,279582,277887,2020-10-25 18:15:19.693115
Puducherry,3975,29427,584,3912,29614,586,34112,33986,2020-10-25 18:15:19.693115
Punjab,4327,121735,4095,4277,122256,4107,130640,130157,2020-10-25 18:15:19.693115
Rajasthan,17775,162981,1814,17100,165496,1826,184422,182570,2020-10-25 18:15:19.693115
Sikkim,242,3465,63,266,3490,63,3819,3770,2020-10-25 18:15:19.693115
Tamil Nadu,32960,659432,10858,31787,663456,10893,706136,703250,2020-10-25 18:15:19.693115
Telengana,19937,209034,1303,19465,210480,1307,231252,230274,2020-10-25 18:15:19.693115
Tripura,2055,27740,340,1992,27886,343,30221,30135,2020-10-25 18:15:19.693115
Uttarakhand,4656,54161,979,4542,54629,984,60155,59796,2020-10-25 18:15:19.693115
Uttar Pradesh,28268,430962,6830,27681,433703,6854,468238,466060,2020-10-25 18:15:19.693115
West Bengal,36471,298587,6368,36807,302340,6427,345574,341426,2020-10-25 18:15:19.693115
Andaman and Nicobar Islands,199,3968,58,204,3983,58,4245,4225,2020-10-26 21:44:12.604600
Andhra Pradesh,31469,765991,6566,30860,769576,6587,807023,804026,2020-10-26 21:44:12.604600
Arunachal Pradesh,2397,11781,33,2260,11951,33,14244,14211,2020-10-26 21:44:12.604600
Assam,20271,182794,902,17510,185755,906,204171,203967,2020-10-26 21:44:12.604600
Bihar,10459,199757,1042,9722,200918,1049,211689,211258,2020-10-26 21:44:12.604600
Chandigarh,674,13087,216,653,13167,218,14038,13977,2020-10-26 21:44:12.604600
Chhattisgarh,23899,148899,1793,23743,150398,1818,175959,174591,2020-10-26 21:44:12.604600
Dadra and Nagar Haveli and Daman and Diu,50,3173,2,51,3175,2,3228,3225,2020-10-26 21:44:12.604600
Delhi,26467,319828,6225,26744,323654,6258,356656,352520,2020-10-26 21:44:12.604600
Goa,2692,38769,570,2576,39090,576,42242,42031,2020-10-26 21:44:12.604600
Gujarat,13965,148448,3679,13914,149411,3686,167011,166092,2020-10-26 21:44:12.604600
Haryana,10148,145196,1720,10295,146282,1727,158304,157064,2020-10-26 21:44:12.604600
Himachal Pradesh,2605,17318,290,2489,17590,291,20370,20213,2020-10-26 21:44:12.604600
Jammu and Kashmir,7680,82219,1430,7565,82858,1438,91861,91329,2020-10-26 21:44:12.604600
Jharkhand,5966,92598,864,5844,92976,866,99686,99428,2020-10-26 21:44:12.604600
Karnataka,86768,700737,10873,81069,710843,10905,802817,798378,2020-10-26 21:44:12.604600
Kerala,97520,287261,1306,96688,294910,1332,392930,386087,2020-10-26 21:44:12.604600
Ladakh,790,5052,71,736,5126,71,5933,5913,2020-10-26 21:44:12.604600
Lakshadweep,0,0,0,0,0,0,0,0,2020-10-26 21:44:12.604600
Madhya Pradesh,11477,151946,2875,11237,153127,2885,167249,166298,2020-10-26 21:44:12.604600
Maharashtra,140702,1455107,43152,141001,1460755,43264,1645020,1638961,2020-10-26 21:44:12.604600
Manipur,4165,12719,138,4166,12857,139,17162,17022,2020-10-26 21:44:12.604600
Meghalaya,1574,7228,80,1605,7332,81,9018,8882,2020-10-26 21:44:12.604600
Mizoram,249,2198,0,290,2203,0,2493,2447,2020-10-26 21:44:12.604600
Nagaland,1817,6668,30,1871,6724,31,8626,8515,2020-10-26 21:44:12.604600
Odisha,16322,262031,1229,15868,264102,1245,281215,279582,2020-10-26 21:44:12.604600
Puducherry,3912,29614,586,3804,29801,588,34193,34112,2020-10-26 21:44:12.604600
Punjab,4277,122256,4107,4217,122721,4117,131055,130640,2020-10-26 21:44:12.604600
Rajasthan,17100,165496,1826,16668,167736,1839,186243,184422,2020-10-26 21:44:12.604600
Sikkim,266,3490,63,246,3525,64,3835,3819,2020-10-26 21:44:12.604600
Tamil Nadu,31787,663456,10893,30606,667475,10924,709005,706136,2020-10-26 21:44:12.604600
Telengana,19465,210480,1307,18611,211912,1311,231834,231252,2020-10-26 21:44:12.604600
Tripura,1992,27886,343,1845,28069,343,30257,30221,2020-10-26 21:44:12.604600
Uttarakhand,4542,54629,984,4425,54958,993,60376,60155,2020-10-26 21:44:12.604600
Uttar Pradesh,27681,433703,6854,27317,436071,6882,470270,468238,2020-10-26 21:44:12.604600
West Bengal,36807,302340,6427,37017,306197,6487,349701,345574,2020-10-26 21:44:12.604600
Andaman and Nicobar Islands,204,3983,58,198,3997,58,4253,4245,2020-10-27 09:35:58.201964
Andhra Pradesh,30860,769576,6587,28770,773548,6606,808924,807023,2020-10-27 09:35:58.201964
Arunachal Pradesh,2260,11951,33,2174,12182,35,14391,14244,2020-10-27 09:35:58.201964
Assam,17510,185755,906,14891,188587,908,204386,204171,2020-10-27 09:35:58.201964
Bihar,9722,200918,1049,9355,201942,1058,212355,211689,2020-10-27 09:35:58.201964
Chandigarh,653,13167,218,633,13230,222,14085,14038,2020-10-27 09:35:58.201964
Chhattisgarh,23743,150398,1818,22093,153654,1861,177608,175959,2020-10-27 09:35:58.201964
Dadra and Nagar Haveli and Daman and Diu,51,3175,2,50,3176,2,3228,3228,2020-10-27 09:35:58.201964
Delhi,26744,323654,6258,25786,327390,6312,359488,356656,2020-10-27 09:35:58.201964
Goa,2576,39090,576,2517,39433,582,42532,42242,2020-10-27 09:35:58.201964
Gujarat,13914,149411,3686,13716,150513,3690,167919,167011,2020-10-27 09:35:58.201964
Haryana,10295,146282,1727,10154,147566,1737,159457,158304,2020-10-27 09:35:58.201964
Himachal Pradesh,2489,17590,291,2511,17782,293,20586,20370,2020-10-27 09:35:58.201964
Jammu and Kashmir,7565,82858,1438,7296,83485,1444,92225,91861,2020-10-27 09:35:58.201964
Jharkhand,5844,92976,866,5666,93368,872,99906,99686,2020-10-27 09:35:58.201964
Karnataka,81069,710843,10905,75442,719558,10947,805947,802817,2020-10-27 09:35:58.201964
Kerala,96688,294910,1332,93848,302017,1352,397217,392930,2020-10-27 09:35:58.201964
Ladakh,736,5126,71,691,5216,71,5978,5933,2020-10-27 09:35:58.201964
Lakshadweep,0,0,0,0,0,0,0,0,2020-10-27 09:35:58.201964
Madhya Pradesh,11237,153127,2885,10857,154222,2890,167969,167249,2020-10-27 09:35:58.201964
Maharashtra,141001,1460755,43264,134657,1470660,43348,1648665,1645020,2020-10-27 09:35:58.201964
Manipur,4166,12857,139,4223,13057,144,17424,17162,2020-10-27 09:35:58.201964
Meghalaya,1605,7332,81,1514,7471,81,9066,9018,2020-10-27 09:35:58.201964
Mizoram,290,2203,0,315,2212,0,2527,2493,2020-10-27 09:35:58.201964
Nagaland,1871,6724,31,1838,6792,33,8663,8626,2020-10-27 09:35:58.201964
Odisha,15868,264102,1245,15331,266105,1259,282695,281215,2020-10-27 09:35:58.201964
Puducherry,3804,29801,588,3758,29990,588,34336,34193,2020-10-27 09:35:58.201964
Punjab,4217,122721,4117,4219,123047,4125,131391,131055,2020-10-27 09:35:58.201964
Rajasthan,16668,167736,1839,16233,169962,1853,188048,186243,2020-10-27 09:35:58.201964
Sikkim,246,3525,64,245,3530,65,3840,3835,2020-10-27 09:35:58.201964
Tamil Nadu,30606,667475,10924,29268,671489,10956,711713,709005,2020-10-27 09:35:58.201964
Telengana,18611,211912,1311,17890,213466,1315,232671,231834,2020-10-27 09:35:58.201964
Tripura,1845,28069,343,1796,28153,344,30293,30257,2020-10-27 09:35:58.201964
Uttarakhand,4425,54958,993,4080,55663,1001,60744,60376,2020-10-27 09:35:58.201964
Uttar Pradesh,27317,436071,6882,26652,438521,6904,472077,470270,2020-10-27 09:35:58.201964
West Bengal,37017,306197,6487,37190,310086,6546,353822,349701,2020-10-27 09:35:58.201964
Andaman and Nicobar Islands,198,3997,58,197,4019,58,4274,4253,2020-10-28 20:33:42.418845
Andhra Pradesh,28770,773548,6606,27300,777900,6625,811825,808924,2020-10-28 20:33:42.418845
Arunachal Pradesh,2174,12182,35,2139,12297,36,14472,14391,2020-10-28 20:33:42.418845
Assam,14891,188587,908,12845,191030,914,204789,204386,2020-10-28 20:33:42.418845
Bihar,9355,201942,1058,8846,203174,1065,213085,212355,2020-10-28 20:33:42.418845
Chandigarh,633,13230,222,650,13279,223,14152,14085,2020-10-28 20:33:42.418845
Chhattisgarh,22093,153654,1861,21693,156080,1881,179654,177608,2020-10-28 20:33:42.418845
Dadra and Nagar Haveli and Daman and Diu,50,3176,2,48,3181,2,3231,3228,2020-10-28 20:33:42.418845
Delhi,25786,327390,6312,27873,330112,6356,364341,359488,2020-10-28 20:33:42.418845
Goa,2517,39433,582,2384,39778,585,42747,42532,2020-10-28 20:33:42.418845
Gujarat,13716,150513,3690,13465,151751,3695,168911,167919,2020-10-28 20:33:42.418845
Haryana,10154,147566,1737,10452,148503,1750,160705,159457,2020-10-28 20:33:42.418845
Himachal Pradesh,2511,17782,293,2521,17998,298,20817,20586,2020-10-28 20:33:42.418845
Jammu and Kashmir,7296,83485,1444,6990,84236,1451,92677,92225,2020-10-28 20:33:42.418845
Jharkhand,5666,93368,872,5474,93874,876,100224,99906,2020-10-28 20:33:42.418845
Karnataka,75442,719558,10947,71349,727298,10991,809638,805947,2020-10-28 20:33:42.418845
Kerala,93848,302017,1352,92266,309032,1376,402674,397217,2020-10-28 20:33:42.418845
Ladakh,691,5216,71,689,5262,73,6024,5978,2020-10-28 20:33:42.418845
Lakshadweep,0,0,0,0,0,0,0,0,2020-10-28 20:33:42.418845
Madhya Pradesh,10857,154222,2890,10353,155232,2898,168483,167969,2020-10-28 20:33:42.418845
Maharashtra,134657,1470660,43348,132069,1478496,43463,1654028,1648665,2020-10-28 20:33:42.418845
Manipur,4223,13057,144,4246,13208,150,17604,17424,2020-10-28 20:33:42.418845
Meghalaya,1514,7471,81,1411,7643,82,9136,9066,2020-10-28 20:33:42.418845
Mizoram,315,2212,0,374,2233,0,2607,2527,2020-10-28 20:33:42.418845
Nagaland,1838,6792,33,1865,6828,33,8726,8663,2020-10-28 20:33:42.418845
Odisha,15331,266105,1259,14555,268115,1272,283942,282695,2020-10-28 20:33:42.418845
Puducherry,3758,29990,588,3741,30153,588,34482,34336,2020-10-28 20:33:42.418845
Punjab,4219,123047,4125,4089,123510,4138,131737,131391,2020-10-28 20:33:42.418845
Rajasthan,16233,169962,1853,15949,172028,1867,189844,188048,2020-10-28 20:33:42.418845
Sikkim,245,3530,65,262,3534,67,3863,3840,2020-10-28 20:33:42.418845
Tamil Nadu,29268,671489,10956,27734,675518,10983,714235,711713,2020-10-28 20:33:42.418845
Telengana,17890,213466,1315,17916,214917,1319,234152,232671,2020-10-28 20:33:42.418845
Tripura,1796,28153,344,1754,28355,344,30453,30293,2020-10-28 20:33:42.418845
Uttarakhand,4080,55663,1001,3865,56085,1007,60957,60744,2020-10-28 20:33:42.418845
Uttar Pradesh,26652,438521,6904,26267,440847,6940,474054,472077,2020-10-28 20:33:42.418845
West Bengal,37190,310086,6546,37172,314003,6604,357779,353822,2020-10-28 20:33:42.418845
Andaman and Nicobar Islands,197,4019,58,192,4039,58,4289,4274,2020-10-29 19:03:02.972269
Andhra Pradesh,27300,777900,6625,26622,781509,6643,814774,811825,2020-10-29 19:03:02.972269
Arunachal Pradesh,2139,12297,36,2064,12480,36,14580,14472,2020-10-29 19:03:02.972269
Assam,12845,191030,914,11803,192517,917,205237,204789,2020-10-29 19:03:02.972269
Bihar,8846,203174,1065,8329,204178,1069,213576,213085,2020-10-29 19:03:02.972269
Chandigarh,650,13279,223,629,13359,224,14212,14152,2020-10-29 19:03:02.972269
Chhattisgarh,21693,156080,1881,22167,157480,1936,181583,179654,2020-10-29 19:03:02.972269
Dadra and Nagar Haveli and Daman and Diu,48,3181,2,51,3184,2,3237,3231,2020-10-29 19:03:02.972269
Delhi,27873,330112,6356,29378,334240,6396,370014,364341,2020-10-29 19:03:02.972269
Goa,2384,39778,585,2402,39974,592,42968,42747,2020-10-29 19:03:02.972269
Gujarat,13465,151751,3695,13332,152858,3701,169891,168911,2020-10-29 19:03:02.972269
Haryana,10452,148503,1750,11014,149451,1758,162223,160705,2020-10-29 19:03:02.972269
Himachal Pradesh,2521,17998,298,2646,18203,300,21149,20817,2020-10-29 19:03:02.972269
Jammu and Kashmir,6990,84236,1451,6976,84782,1455,93213,92677,2020-10-29 19:03:02.972269
Jharkhand,5474,93874,876,5363,94326,880,100569,100224,2020-10-29 19:03:02.972269
Karnataka,71349,727298,10991,68180,733558,11046,812784,809638,2020-10-29 19:03:02.972269
Kerala,92266,309032,1376,93369,316692,1403,411464,402674,2020-10-29 19:03:02.972269
Ladakh,689,5262,73,642,5369,74,6085,6024,2020-10-29 19:03:02.972269
Lakshadweep,0,0,0,0,0,0,0,0,2020-10-29 19:03:02.972269
Madhya Pradesh,10353,155232,2898,10094,156264,2913,169271,168483,2020-10-29 19:03:02.972269
Maharashtra,132069,1478496,43463,130286,1486926,43554,1660766,1654028,2020-10-29 19:03:02.972269
Manipur,4246,13208,150,4233,13420,156,17809,17604,2020-10-29 19:03:02.972269
Meghalaya,1411,7643,82,1364,7777,85,9226,9136,2020-10-29 19:03:02.972269
Mizoram,374,2233,0,417,2238,1,2656,2607,2020-10-29 19:03:02.972269
Nagaland,1865,6828,33,1845,6945,34,8824,8726,2020-10-29 19:03:02.972269
Odisha,14555,268115,1272,14068,270130,1284,285482,283942,2020-10-29 19:03:02.972269
Puducherry,3741,30153,588,3686,30307,590,34583,34482,2020-10-29 19:03:02.972269
Punjab,4089,123510,4138,4239,123866,4158,132263,131737,2020-10-29 19:03:02.972269
Rajasthan,15949,172028,1867,15708,174044,1877,191629,189844,2020-10-29 19:03:02.972269
Sikkim,262,3534,67,263,3545,67,3875,3863,2020-10-29 19:03:02.972269
Tamil Nadu,27734,675518,10983,26356,679377,11018,716751,714235,2020-10-29 19:03:02.972269
Telengana,17916,214917,1319,17979,216353,1324,235656,234152,2020-10-29 19:03:02.972269
Tripura,1754,28355,344,1696,28525,345,30566,30453,2020-10-29 19:03:02.972269
Uttarakhand,3865,56085,1007,3696,56556,1009,61261,60957,2020-10-29 19:03:02.972269
Uttar Pradesh,26267,440847,6940,25487,443589,6958,476034,474054,2020-10-29 19:03:02.972269
West Bengal,37172,314003,6604,37111,317928,6664,361703,357779,2020-10-29 19:03:02.972269
Andaman and Nicobar Islands,192,4039,58,192,4054,59,4305,4289,2020-10-30 20:20:27.693142
Andhra Pradesh,26622,781509,6643,26268,784752,6659,817679,814774,2020-10-30 20:20:27.693142
Arunachal Pradesh,2064,12480,36,2008,12623,37,14668,14580,2020-10-30 20:20:27.693142
Assam,11803,192517,917,11138,193574,923,205635,205237,2020-10-30 20:20:27.693142
Bihar,8329,204178,1069,8058,205108,1076,214242,213576,2020-10-30 20:20:27.693142
Chandigarh,629,13359,224,665,13402,225,14292,14212,2020-10-30 20:20:27.693142
Chhattisgarh,22167,157480,1936,22331,159268,1989,183588,181583,2020-10-30 20:20:27.693142
Dadra and Nagar Haveli and Daman and Diu,51,3184,2,49,3192,2,3243,3237,2020-10-30 20:20:27.693142
Delhi,29378,334240,6396,30952,338378,6423,375753,370014,2020-10-30 20:20:27.693142
Goa,2402,39974,592,2436,40168,597,43201,42968,2020-10-30 20:20:27.693142
Gujarat,13332,152858,3701,13232,153941,3705,170878,169891,2020-10-30 20:20:27.693142
Haryana,11014,149451,1758,11391,150660,1766,163817,162223,2020-10-30 20:20:27.693142
Himachal Pradesh,2646,18203,300,2768,18402,306,21476,21149,2020-10-30 20:20:27.693142
Jammu and Kashmir,6976,84782,1455,6928,85370,1466,93764,93213,2020-10-30 20:20:27.693142
Jharkhand,5363,94326,880,5294,94787,883,100964,100569,2020-10-30 20:20:27.693142
Karnataka,68180,733558,11046,64499,741219,11091,816809,812784,2020-10-30 20:20:27.693142
Kerala,93369,316692,1403,91889,325166,1429,418484,411464,2020-10-30 20:20:27.693142
Ladakh,642,5369,74,627,5438,74,6139,6085,2020-10-30 20:20:27.693142
Lakshadweep,0,0,0,0,0,0,0,0,2020-10-30 20:20:27.693142
Madhya Pradesh,10094,156264,2913,9689,157381,2929,169999,169271,2020-10-30 20:20:27.693142
Maharashtra,130286,1486926,43554,128149,1494809,43710,1666668,1660766,2020-10-30 20:20:27.693142
Manipur,4233,13420,156,4308,13583,160,18051,17809,2020-10-30 20:20:27.693142
Meghalaya,1364,7777,85,1326,7890,87,9303,9226,2020-10-30 20:20:27.693142
Mizoram,417,2238,1,435,2258,1,2694,2656,2020-10-30 20:20:27.693142
Nagaland,1845,6945,34,1763,7096,35,8894,8824,2020-10-30 20:20:27.693142
Odisha,14068,270130,1284,13764,272038,1297,287099,285482,2020-10-30 20:20:27.693142
Puducherry,3686,30307,590,3720,30449,592,34761,34583,2020-10-30 20:20:27.693142
Punjab,4239,123866,4158,4266,124293,4168,132727,132263,2020-10-30 20:20:27.693142
Rajasthan,15708,174044,1877,15554,175977,1888,193419,191629,2020-10-30 20:20:27.693142
Sikkim,263,3545,67,268,3558,67,3893,3875,2020-10-30 20:20:27.693142
Tamil Nadu,26356,679377,11018,24886,683464,11053,719403,716751,2020-10-30 20:20:27.693142
Telengana,17979,216353,1324,18456,217401,1330,237187,235656,2020-10-30 20:20:27.693142
Tripura,1696,28525,345,1580,28737,346,30663,30566,2020-10-30 20:20:27.693142
Uttarakhand,3696,56556,1009,3545,57012,1009,61566,61261,2020-10-30 20:20:27.693142
Uttar Pradesh,25487,443589,6958,24858,446054,6983,477895,476034,2020-10-30 20:20:27.693142
West Bengal,37111,317928,6664,37094,321873,6725,365692,361703,2020-10-30 20:20:27.693142
Andaman and Nicobar Islands,192,4054,59,182,4076,59,4317,4305,2020-10-31 20:00:14.837449
Andhra Pradesh,26268,784752,6659,25514,788375,6676,820565,817679,2020-10-31 20:00:14.837449
Arunachal Pradesh,2008,12623,37,1938,12777,37,14752,14668,2020-10-31 20:00:14.837449
Assam,11138,193574,923,10421,194668,926,206015,205635,2020-10-31 20:00:14.837449
Bihar,8058,205108,1076,7897,206346,1084,215327,214242,2020-10-31 20:00:14.837449
Chandigarh,665,13402,225,657,13469,225,14351,14292,2020-10-31 20:00:14.837449
Chhattisgarh,22331,159268,1989,22350,160918,2038,185306,183588,2020-10-31 20:00:14.837449
Dadra and Nagar Haveli and Daman and Diu,49,3192,2,49,3197,2,3248,3243,2020-10-31 20:00:14.837449
Delhi,30952,338378,6423,32363,342811,6470,381644,375753,2020-10-31 20:00:14.837449
Goa,2436,40168,597,2405,40409,602,43416,43201,2020-10-31 20:00:14.837449
Gujarat,13232,153941,3705,13168,154968,3711,171847,170878,2020-10-31 20:00:14.837449
Haryana,11391,150660,1766,11851,151839,1777,165467,163817,2020-10-31 20:00:14.837449
Himachal Pradesh,2768,18402,306,2891,18595,312,21798,21476,2020-10-31 20:00:14.837449
Jammu and Kashmir,6928,85370,1466,6835,86024,1471,94330,93764,2020-10-31 20:00:14.837449
Jharkhand,5294,94787,883,5196,95208,883,101287,100964,2020-10-31 20:00:14.837449
Karnataka,64499,741219,11091,59518,749740,11140,820398,816809,2020-10-31 20:00:14.837449
Kerala,91889,325166,1429,90671,332994,1457,425122,418484,2020-10-31 20:00:14.837449
Ladakh,627,5438,74,627,5493,74,6194,6139,2020-10-31 20:00:14.837449
Lakshadweep,0,0,0,0,0,0,0,0,2020-10-31 20:00:14.837449
Madhya Pradesh,9689,157381,2929,9294,158455,2941,170690,169999,2020-10-31 20:00:14.837449
Maharashtra,128149,1494809,43710,125971,1503050,43837,1672858,1666668,2020-10-31 20:00:14.837449
Manipur,4308,13583,160,4303,13805,164,18272,18051,2020-10-31 20:00:14.837449
Meghalaya,1326,7890,87,1170,8125,87,9382,9303,2020-10-31 20:00:14.837449
Mizoram,435,2258,1,437,2284,1,2722,2694,2020-10-31 20:00:14.837449
Nagaland,1763,7096,35,1598,7308,39,8945,8894,2020-10-31 20:00:14.837449
Odisha,13764,272038,1297,13500,273838,1308,288646,287099,2020-10-31 20:00:14.837449
Puducherry,3720,30449,592,3739,30577,592,34908,34761,2020-10-31 20:00:14.837449
Punjab,4266,124293,4168,4101,124870,4187,133158,132727,2020-10-31 20:00:14.837449
Rajasthan,15554,175977,1888,15251,178064,1898,195213,193419,2020-10-31 20:00:14.837449
Sikkim,268,3558,67,254,3591,68,3913,3893,2020-10-31 20:00:14.837449
Tamil Nadu,24886,683464,11053,23532,687388,11091,722011,719403,2020-10-31 20:00:14.837449
Telengana,18456,217401,1330,18409,218887,1336,238632,237187,2020-10-31 20:00:14.837449
Tripura,1580,28737,346,1493,28878,346,30717,30663,2020-10-31 20:00:14.837449
Uttarakhand,3545,57012,1009,3634,57270,1011,61915,61566,2020-10-31 20:00:14.837449
Uttar Pradesh,24858,446054,6983,24431,448644,7007,480082,477895,2020-10-31 20:00:14.837449
West Bengal,37094,321873,6725,36999,325888,6784,369671,365692,2020-10-31 20:00:14.837449
Andaman and Nicobar Islands,182,4076,59,173,4100,59,4332,4317,2020-11-01 21:10:12.742271
Andhra Pradesh,25514,788375,6676,24575,792083,6690,823348,820565,2020-11-01 21:10:12.742271
Arunachal Pradesh,1938,12777,37,1856,12959,37,14852,14752,2020-11-01 21:10:12.742271
Assam,10421,194668,926,9367,196054,930,206351,206015,2020-11-01 21:10:12.742271
Bihar,7897,206346,1084,7516,207480,1090,216086,215327,2020-11-01 21:10:12.742271
Chandigarh,657,13469,225,641,13551,226,14418,14351,2020-11-01 21:10:12.742271
Chhattisgarh,22350,160918,2038,22090,163079,2101,187270,185306,2020-11-01 21:10:12.742271
Dadra and Nagar Haveli and Daman and Diu,49,3197,2,39,3210,2,3251,3248,2020-11-01 21:10:12.742271
Delhi,32363,342811,6470,32719,347476,6511,386706,381644,2020-11-01 21:10:12.742271
Goa,2405,40409,602,2344,40678,604,43626,43416,2020-11-01 21:10:12.742271
Gujarat,13168,154968,3711,13084,155982,3716,172782,171847,2020-11-01 21:10:12.742271
Haryana,11851,151839,1777,12191,153230,1789,167210,165467,2020-11-01 21:10:12.742271
Himachal Pradesh,2891,18595,312,2880,18862,317,22059,21798,2020-11-01 21:10:12.742271
Jammu and Kashmir,6835,86024,1471,6419,86888,1478,94785,94330,2020-11-01 21:10:12.742271
Jharkhand,5196,95208,883,5302,95575,884,101761,101287,2020-11-01 21:10:12.742271
Karnataka,59518,749740,11140,55036,757208,11168,823412,820398,2020-11-01 21:10:12.742271
Kerala,90671,332994,1457,91297,340324,1484,433105,425122,2020-11-01 21:10:12.742271
Ladakh,627,5493,74,656,5539,75,6270,6194,2020-11-01 21:10:12.742271
Lakshadweep,0,0,0,0,0,0,0,0,2020-11-01 21:10:12.742271
Madhya Pradesh,9294,158455,2941,8929,159479,2951,171359,170690,2020-11-01 21:10:12.742271
Maharashtra,125971,1503050,43837,124142,1510353,43911,1678406,1672858,2020-11-01 21:10:12.742271
Manipur,4303,13805,164,3472,14862,168,18502,18272,2020-11-01 21:10:12.742271
Meghalaya,1170,8125,87,1019,8345,88,9452,9382,2020-11-01 21:10:12.742271
Mizoram,437,2284,1,461,2291,1,2753,2722,2020-11-01 21:10:12.742271
Nagaland,1598,7308,39,1554,7454,39,9047,8945,2020-11-01 21:10:12.742271
Odisha,13500,273838,1308,13047,275749,1320,290116,288646,2020-11-01 21:10:12.742271
Puducherry,3739,30577,592,3697,30724,592,35013,34908,2020-11-01 21:10:12.742271
Punjab,4101,124870,4187,4257,125198,4203,133658,133158,2020-11-01 21:10:12.742271
Rajasthan,15251,178064,1898,15102,179984,1907,196993,195213,2020-11-01 21:10:12.742271
Sikkim,254,3591,68,251,3617,72,3940,3913,2020-11-01 21:10:12.742271
Tamil Nadu,23532,687388,11091,22164,691236,11122,724522,722011,2020-11-01 21:10:12.742271
Telengana,18409,218887,1336,18241,220466,1341,240048,238632,2020-11-01 21:10:12.742271
Tripura,1493,28878,346,1400,29048,346,30794,30717,2020-11-01 21:10:12.742271
Uttarakhand,3634,57270,1011,3883,57422,1023,62328,61915,2020-11-01 21:10:12.742271
Uttar Pradesh,24431,448644,7007,23768,451070,7025,481863,480082,2020-11-01 21:10:12.742271
West Bengal,36999,325888,6784,36886,329937,6841,373664,369671,2020-11-01 21:10:12.742271
Andaman and Nicobar Islands,173,4100,59,168,4112,60,4340,4332,2020-11-02 20:00:14.049224
Andhra Pradesh,24575,792083,6690,23668,795592,6706,825966,823348,2020-11-02 20:00:14.049224
Arunachal Pradesh,1856,12959,37,1771,13073,37,14881,14852,2020-11-02 20:00:14.049224
Assam,9367,196054,930,8802,196784,931,206517,206351,2020-11-02 20:00:14.049224
Bihar,7516,207480,1090,6966,208644,1097,216707,216086,2020-11-02 20:00:14.049224
Chandigarh,641,13551,226,618,13632,226,14476,14418,2020-11-02 20:00:14.049224
Chhattisgarh,22090,163079,2101,22126,164537,2150,188813,187270,2020-11-02 20:00:14.049224
Dadra and Nagar Haveli and Daman and Diu,39,3210,2,34,3219,2,3255,3251,2020-11-02 20:00:14.049224
Delhi,32719,347476,6511,34173,351635,6562,392370,386706,2020-11-02 20:00:14.049224
Goa,2344,40678,604,2244,40915,609,43768,43626,2020-11-02 20:00:14.049224
Gujarat,13084,155982,3716,12811,157110,3721,173642,172782,2020-11-02 20:00:14.049224
Haryana,12191,153230,1789,12634,154451,1795,168880,167210,2020-11-02 20:00:14.049224
Himachal Pradesh,2880,18862,317,2973,18965,326,22264,22059,2020-11-02 20:00:14.049224
Jammu and Kashmir,6419,86888,1478,6326,87517,1482,95325,94785,2020-11-02 20:00:14.049224
Jharkhand,5302,95575,884,5229,95973,885,102087,101761,2020-11-02 20:00:14.049224
Karnataka,55036,757208,11168,50611,765261,11192,827064,823412,2020-11-02 20:00:14.049224
Kerala,91297,340324,1484,89783,348835,1512,440130,433105,2020-11-02 20:00:14.049224
Ladakh,656,5539,75,583,5629,75,6287,6270,2020-11-02 20:00:14.049224
Lakshadweep,0,0,0,0,0,0,0,0,2020-11-02 20:00:14.049224
Madhya Pradesh,8929,159479,2951,8538,160586,2958,172082,171359,2020-11-02 20:00:14.049224
Maharashtra,124142,1510353,43911,125672,1514079,44024,1683775,1678406,2020-11-02 20:00:14.049224
Manipur,3472,14862,168,3514,15065,171,18750,18502,2020-11-02 20:00:14.049224
Meghalaya,1019,8345,88,1055,8462,90,9607,9452,2020-11-02 20:00:14.049224
Mizoram,461,2291,1,433,2323,1,2757,2753,2020-11-02 20:00:14.049224
Nagaland,1554,7454,39,1501,7535,39,9075,9047,2020-11-02 20:00:14.049224
Odisha,13047,275749,1320,12930,277564,1331,291825,290116,2020-11-02 20:00:14.049224
Puducherry,3697,30724,592,3169,31345,595,35109,35013,2020-11-02 20:00:14.049224
Punjab,4257,125198,4203,4195,125566,4214,133975,133658,2020-11-02 20:00:14.049224
Rajasthan,15102,179984,1907,15255,181575,1917,198747,196993,2020-11-02 20:00:14.049224
Sikkim,251,3617,72,234,3651,73,3958,3940,2020-11-02 20:00:14.049224
Tamil Nadu,22164,691236,11122,20994,694880,11152,727026,724522,2020-11-02 20:00:14.049224
Telengana,18241,220466,1341,17630,221992,1348,240970,240048,2020-11-02 20:00:14.049224
Tripura,1400,29048,346,1270,29234,348,30852,30794,2020-11-02 20:00:14.049224
Uttarakhand,3883,57422,1023,3914,57609,1027,62550,62328,2020-11-02 20:00:14.049224
Uttar Pradesh,23768,451070,7025,23323,453458,7051,483832,481863,2020-11-02 20:00:14.049224
West Bengal,36886,329937,6841,36761,333990,6900,377651,373664,2020-11-02 20:00:14.049224
Andaman and Nicobar Islands,168,4112,60,160,4132,60,4352,4340,2020-11-03 20:26:40.977596
Andhra Pradesh,23668,795592,6706,22538,798625,6719,827882,825966,2020-11-03 20:26:40.977596
Arunachal Pradesh,1771,13073,37,1722,13238,38,14998,14881,2020-11-03 20:26:40.977596
Assam,8802,196784,931,8481,197569,932,206982,206517,2020-11-03 20:26:40.977596
Bihar,6966,208644,1097,6594,209582,1101,217277,216707,2020-11-03 20:26:40.977596
Chandigarh,618,13632,226,593,13708,227,14528,14476,2020-11-03 20:26:40.977596
Chhattisgarh,22126,164537,2150,21914,166391,2208,190513,188813,2020-11-03 20:26:40.977596
Dadra and Nagar Haveli and Daman and Diu,34,3219,2,34,3221,2,3257,3255,2020-11-03 20:26:40.977596
Delhi,34173,351635,6562,33308,356459,6604,396371,392370,2020-11-03 20:26:40.977596
Goa,2244,40915,609,2215,41123,616,43954,43768,2020-11-03 20:26:40.977596
Gujarat,12811,157110,3721,12678,158114,3725,174517,173642,2020-11-03 20:26:40.977596
Haryana,12634,154451,1795,12919,155717,1810,170446,168880,2020-11-03 20:26:40.977596
Himachal Pradesh,2973,18965,326,2958,19304,336,22598,22264,2020-11-03 20:26:40.977596
Jammu and Kashmir,6326,87517,1482,6080,88140,1490,95710,95325,2020-11-03 20:26:40.977596
Jharkhand,5229,95973,885,5119,96485,886,102490,102087,2020-11-03 20:26:40.977596
Karnataka,50611,765261,11192,44824,773595,11221,829640,827064,2020-11-03 20:26:40.977596
Kerala,89783,348835,1512,86792,355943,1533,444268,440130,2020-11-03 20:26:40.977596
Ladakh,583,5629,75,610,5671,76,6357,6287,2020-11-03 20:26:40.977596
Lakshadweep,0,0,0,0,0,0,0,0,2020-11-03 20:26:40.977596
Madhya Pradesh,8538,160586,2958,8298,161454,2965,172717,172082,2020-11-03 20:26:40.977596
Maharashtra,125672,1514079,44024,119352,1524304,44128,1687784,1683775,2020-11-03 20:26:40.977596
Manipur,3514,15065,171,3568,15343,180,19091,18750,2020-11-03 20:26:40.977596
Meghalaya,1055,8462,90,1009,8579,90,9678,9607,2020-11-03 20:26:40.977596
Mizoram,433,2323,1,444,2347,1,2792,2757,2020-11-03 20:26:40.977596
Nagaland,1501,7535,39,1365,7689,42,9096,9075,2020-11-03 20:26:40.977596
Odisha,12930,277564,1331,12783,279091,1340,293214,291825,2020-11-03 20:26:40.977596
Puducherry,3169,31345,595,2756,31827,595,35178,35109,2020-11-03 20:26:40.977596
Punjab,4195,125566,4214,4183,125961,4227,134371,133975,2020-11-03 20:26:40.977596
Rajasthan,15255,181575,1917,15889,182680,1926,200495,198747,2020-11-03 20:26:40.977596
Sikkim,234,3651,73,239,3655,73,3967,3958,2020-11-03 20:26:40.977596
Tamil Nadu,20994,694880,11152,19504,698820,11183,729507,727026,2020-11-03 20:26:40.977596
Telengana,17630,221992,1348,17742,223413,1351,242506,240970,2020-11-03 20:26:40.977596
Tripura,1270,29234,348,1321,29318,350,30989,30852,2020-11-03 20:26:40.977596
Uttarakhand,3914,57609,1027,3802,58050,1029,62881,62550,2020-11-03 20:26:40.977596
Uttar Pradesh,23323,453458,7051,23035,455498,7076,485609,483832,2020-11-03 20:26:40.977596
West Bengal,36761,333990,6900,36576,338075,6957,381608,377651,2020-11-03 20:26:40.977596
Andaman and Nicobar Islands,160,4132,60,159,4153,60,4372,4352,2020-11-04 17:30:34.287704
Andhra Pradesh,22538,798625,6719,21672,802325,6734,830731,827882,2020-11-04 17:30:34.287704
Arunachal Pradesh,1722,13238,38,1674,13367,42,15083,14998,2020-11-04 17:30:34.287704
Assam,8481,197569,932,8385,198042,934,207361,206982,2020-11-04 17:30:34.287704
Bihar,6594,209582,1101,6423,210672,1108,218203,217277,2020-11-04 17:30:34.287704
Chandigarh,593,13708,227,629,13751,228,14608,14528,2020-11-04 17:30:34.287704
Chhattisgarh,21914,166391,2208,21770,168201,2266,192237,190513,2020-11-04 17:30:34.287704
Dadra and Nagar Haveli and Daman and Diu,34,3221,2,30,3225,2,3257,3257,2020-11-04 17:30:34.287704
Delhi,33308,356459,6604,36375,360069,6652,403096,396371,2020-11-04 17:30:34.287704
Goa,2215,41123,616,2209,41362,618,44189,43954,2020-11-04 17:30:34.287704
Gujarat,12678,158114,3725,12429,159311,3731,175471,174517,2020-11-04 17:30:34.287704
Haryana,12919,155717,1810,13338,156975,1817,172130,170446,2020-11-04 17:30:34.287704
Himachal Pradesh,2958,19304,336,3119,19469,344,22932,22598,2020-11-04 17:30:34.287704
Jammu and Kashmir,6080,88140,1490,5968,88718,1502,96188,95710,2020-11-04 17:30:34.287704
Jharkhand,5119,96485,886,5021,96975,891,102887,102490,2020-11-04 17:30:34.287704
Karnataka,44824,773595,11221,40414,780735,11247,832396,829640,2020-11-04 17:30:34.287704
Kerala,86792,355943,1533,84826,364745,1559,451130,444268,2020-11-04 17:30:34.287704
Ladakh,610,5671,76,664,5701,76,6441,6357,2020-11-04 17:30:34.287704
Lakshadweep,0,0,0,0,0,0,0,0,2020-11-04 17:30:34.287704
Madhya Pradesh,8298,161454,2965,8044,162366,2974,173384,172717,2020-11-04 17:30:34.287704
Maharashtra,119352,1524304,44128,117168,1531277,44248,1692693,1687784,2020-11-04 17:30:34.287704
Manipur,3568,15343,180,3597,15460,184,19241,19091,2020-11-04 17:30:34.287704
Meghalaya,1009,8579,90,971,8680,90,9741,9678,2020-11-04 17:30:34.287704
Mizoram,444,2347,1,516,2376,1,2893,2792,2020-11-04 17:30:34.287704
Nagaland,1365,7689,42,1240,7869,42,9151,9096,2020-11-04 17:30:34.287704
Odisha,12783,279091,1340,12510,280553,1352,294415,293214,2020-11-04 17:30:34.287704
Puducherry,2756,31827,595,2445,32284,596,35325,35178,2020-11-04 17:30:34.287704
Punjab,4183,125961,4227,4226,126315,4245,134786,134371,2020-11-04 17:30:34.287704
Rajasthan,15889,182680,1926,16385,183899,1936,202220,200495,2020-11-04 17:30:34.287704
Sikkim,239,3655,73,271,3660,73,4004,3967,2020-11-04 17:30:34.287704
Tamil Nadu,19504,698820,11183,19201,701527,11214,731942,729507,2020-11-04 17:30:34.287704
Telengana,17742,223413,1351,18100,224686,1357,244143,242506,2020-11-04 17:30:34.287704
Tripura,1321,29318,350,1322,29430,353,31105,30989,2020-11-04 17:30:34.287704
Uttarakhand,3802,58050,1029,3705,58459,1033,63197,62881,2020-11-04 17:30:34.287704
Uttar Pradesh,23035,455498,7076,22538,457708,7089,487335,485609,2020-11-04 17:30:34.287704
West Bengal,36576,338075,6957,36443,342133,7013,385589,381608,2020-11-04 17:30:34.287704
Andaman and Nicobar Islands,159,4153,60,166,4163,60,4389,4372,2020-11-05 20:02:27.183840
Andhra Pradesh,21672,802325,6734,21438,805026,6744,833208,830731,2020-11-05 20:02:27.183840
Arunachal Pradesh,1674,13367,42,1645,13472,43,15160,15083,2020-11-05 20:02:27.183840
Assam,8385,198042,934,8110,198697,934,207741,207361,2020-11-05 20:02:27.183840
Bihar,6423,210672,1108,6094,211398,1113,218605,218203,2020-11-05 20:02:27.183840
Chandigarh,629,13751,228,671,13802,229,14702,14608,2020-11-05 20:02:27.183840
Chhattisgarh,21770,168201,2266,22773,169410,2316,194499,192237,2020-11-05 20:02:27.183840
Dadra and Nagar Haveli and Daman and Diu,30,3225,2,32,3228,2,3262,3257,2020-11-05 20:02:27.183840
Delhi,36375,360069,6652,37369,365866,6703,409938,403096,2020-11-05 20:02:27.183840
Goa,2209,41362,618,2135,41611,626,44372,44189,2020-11-05 20:02:27.183840
Gujarat,12429,159311,3731,12376,160333,3737,176446,175471,2020-11-05 20:02:27.183840
Haryana,13338,156975,1817,14110,158136,1836,174082,172130,2020-11-05 20:02:27.183840
Himachal Pradesh,3119,19469,344,3431,19579,355,23365,22932,2020-11-05 20:02:27.183840
Jammu and Kashmir,5968,88718,1502,5935,89254,1511,96700,96188,2020-11-05 20:02:27.183840
Jharkhand,5021,96975,891,4814,97480,894,103188,102887,2020-11-05 20:02:27.183840
Karnataka,40414,780735,11247,35712,788780,11281,835773,832396,2020-11-05 20:02:27.183840
Kerala,84826,364745,1559,85108,372951,1587,459646,451130,2020-11-05 20:02:27.183840
Ladakh,664,5701,76,702,5772,79,6553,6441,2020-11-05 20:02:27.183840
Lakshadweep,0,0,0,0,0,0,0,0,2020-11-05 20:02:27.183840
Madhya Pradesh,8044,162366,2974,7854,163250,2987,174091,173384,2020-11-05 20:02:27.183840
Maharashtra,117168,1531277,44248,113645,1540005,44548,1698198,1692693,2020-11-05 20:02:27.183840
Manipur,3597,15460,184,3698,15618,187,19503,19241,2020-11-05 20:02:27.183840
Meghalaya,971,8680,90,959,8752,90,9801,9741,2020-11-05 20:02:27.183840
Mizoram,516,2376,1,521,2435,2,2958,2893,2020-11-05 20:02:27.183840
Nagaland,1240,7869,42,1146,8017,44,9207,9151,2020-11-05 20:02:27.183840
Odisha,12510,280553,1352,12452,282073,1364,295889,294415,2020-11-05 20:02:27.183840
Puducherry,2445,32284,596,2129,32703,597,35429,35325,2020-11-05 20:02:27.183840
Punjab,4226,126315,4245,4471,126583,4259,135313,134786,2020-11-05 20:02:27.183840
Rajasthan,16385,183899,1936,16323,185722,1945,203990,202220,2020-11-05 20:02:27.183840
Sikkim,271,3660,73,254,3740,73,4067,4004,2020-11-05 20:02:27.183840
Tamil Nadu,19201,701527,11214,19154,704031,11244,734429,731942,2020-11-05 20:02:27.183840
Telengana,18100,224686,1357,18656,225664,1362,245682,244143,2020-11-05 20:02:27.183840
Tripura,1322,29430,353,1339,29545,353,31237,31105,2020-11-05 20:02:27.183840
Uttarakhand,3705,58459,1033,3818,58729,1038,63585,63197,2020-11-05 20:02:27.183840
Uttar Pradesh,22538,457708,7089,22676,459722,7104,489502,487335,2020-11-05 20:02:27.183840
West Bengal,36443,342133,7013,36246,346262,7068,389576,385589,2020-11-05 20:02:27.183840
Andaman and Nicobar Islands,166,4163,60,168,4175,60,4403,4389,2020-11-06 20:00:14.877203
Andhra Pradesh,21438,805026,6744,21878,807318,6757,835953,833208,2020-11-06 20:00:14.877203
Arunachal Pradesh,1645,13472,43,1621,13580,43,15244,15160,2020-11-06 20:00:14.877203
Assam,8110,198697,934,7662,199458,934,208054,207741,2020-11-06 20:00:14.877203
Bihar,6094,211398,1113,6356,211872,1121,219349,218605,2020-11-06 20:00:14.877203
Chandigarh,671,13802,229,703,13862,229,14794,14702,2020-11-06 20:00:14.877203
Chhattisgarh,22773,169410,2316,23113,170760,2360,196233,194499,2020-11-06 20:00:14.877203
Dadra and Nagar Haveli and Daman and Diu,32,3228,2,36,3230,2,3268,3262,2020-11-06 20:00:14.877203
Delhi,37369,365866,6703,38729,371155,6769,416653,409938,2020-11-06 20:00:14.877203
Goa,2135,41611,626,2065,41849,630,44544,44372,2020-11-06 20:00:14.877203
Gujarat,12376,160333,3737,12304,161388,3744,177436,176446,2020-11-06 20:00:14.877203
Haryana,14110,158136,1836,14644,159643,1859,176146,174082,2020-11-06 20:00:14.877203
Himachal Pradesh,3431,19579,355,3668,19780,361,23809,23365,2020-11-06 20:00:14.877203
Jammu and Kashmir,5935,89254,1511,5802,89905,1517,97224,96700,2020-11-06 20:00:14.877203
Jharkhand,4814,97480,894,4685,97964,894,103543,103188,2020-11-06 20:00:14.877203
Karnataka,35712,788780,11281,33114,794503,11312,838929,835773,2020-11-06 20:00:14.877203
Kerala,85108,372951,1587,84203,380650,1613,466466,459646,2020-11-06 20:00:14.877203
Ladakh,702,5772,79,752,5802,79,6633,6553,2020-11-06 20:00:14.877203
Lakshadweep,0,0,0,0,0,0,0,0,2020-11-06 20:00:14.877203
Madhya Pradesh,7854,163250,2987,7766,164067,2992,174825,174091,2020-11-06 20:00:14.877203
Maharashtra,113645,1540005,44548,107358,1551282,44804,1703444,1698198,2020-11-06 20:00:14.877203
Manipur,3698,15618,187,3786,15750,189,19725,19503,2020-11-06 20:00:14.877203
Meghalaya,959,8752,90,989,8813,91,9893,9801,2020-11-06 20:00:14.877203
Mizoram,521,2435,2,515,2473,2,2990,2958,2020-11-06 20:00:14.877203
Nagaland,1146,8017,44,1058,8161,45,9264,9207,2020-11-06 20:00:14.877203
Odisha,12452,282073,1364,12363,283533,1378,297274,295889,2020-11-06 20:00:14.877203
Puducherry,2129,32703,597,1830,33123,597,35550,35429,2020-11-06 20:00:14.877203
Punjab,4471,126583,4259,4621,126932,4281,135834,135313,2020-11-06 20:00:14.877203
Rajasthan,16323,185722,1945,16301,187544,1955,205800,203990,2020-11-06 20:00:14.877203
Sikkim,254,3740,73,240,3778,75,4093,4067,2020-11-06 20:00:14.877203
Tamil Nadu,19154,704031,11244,19061,706444,11272,736777,734429,2020-11-06 20:00:14.877203
Telengana,18656,225664,1362,19272,226646,1366,247284,245682,2020-11-06 20:00:14.877203
Tripura,1339,29545,353,1327,29666,354,31347,31237,2020-11-06 20:00:14.877203
Uttarakhand,3818,58729,1038,3680,59338,1047,64065,63585,2020-11-06 20:00:14.877203
Uttar Pradesh,22676,459722,7104,23150,461073,7131,491354,489502,2020-11-06 20:00:14.877203
West Bengal,36246,346262,7068,35953,350449,7122,393524,389576,2020-11-06 20:00:14.877203
Andaman and Nicobar Islands,168,4175,60,166,4194,60,4420,4403,2020-11-07 20:00:16.927752
Andhra Pradesh,21878,807318,6757,21825,809770,6768,838363,835953,2020-11-07 20:00:16.927752
Arunachal Pradesh,1621,13580,43,1603,13679,43,15325,15244,2020-11-07 20:00:16.927752
Assam,7662,199458,934,7067,200384,938,208389,208054,2020-11-07 20:00:16.927752
Bihar,6356,211872,1121,6518,212452,1129,220099,219349,2020-11-07 20:00:16.927752
Chandigarh,703,13862,229,772,13925,230,14927,14794,2020-11-07 20:00:16.927752
Chhattisgarh,23113,170760,2360,23066,172513,2412,197991,196233,2020-11-07 20:00:16.927752
Dadra and Nagar Haveli and Daman and Diu,36,3230,2,37,3233,2,3272,3268,2020-11-07 20:00:16.927752
Delhi,38729,371155,6769,39722,377276,6833,423831,416653,2020-11-07 20:00:16.927752
Goa,2065,41849,630,2058,42056,633,44747,44544,2020-11-07 20:00:16.927752
Gujarat,12304,161388,3744,12014,162709,3748,178471,177436,2020-11-07 20:00:16.927752
Haryana,14644,159643,1859,15357,161176,1880,178413,176146,2020-11-07 20:00:16.927752
Himachal Pradesh,3668,19780,361,3845,20033,361,24239,23809,2020-11-07 20:00:16.927752
Jammu and Kashmir,5802,89905,1517,5745,90537,1523,97805,97224,2020-11-07 20:00:16.927752
Jharkhand,4685,97964,894,4639,98365,895,103899,103543,2020-11-07 20:00:16.927752
Karnataka,33114,794503,11312,33338,797204,11347,841889,838929,2020-11-07 20:00:16.927752
Kerala,84203,380650,1613,83324,388504,1640,473468,466466,2020-11-07 20:00:16.927752
Ladakh,752,5802,79,784,5854,80,6718,6633,2020-11-07 20:00:16.927752
Lakshadweep,0,0,0,0,0,0,0,0,2020-11-07 20:00:16.927752
Madhya Pradesh,7766,164067,2992,7676,164923,3004,175603,174825,2020-11-07 20:00:16.927752
Maharashtra,107358,1551282,44804,103007,1562342,44965,1710314,1703444,2020-11-07 20:00:16.927752
Manipur,3786,15750,189,3608,16092,191,19891,19725,2020-11-07 20:00:16.927752
Meghalaya,989,8813,91,984,8904,91,9979,9893,2020-11-07 20:00:16.927752
Mizoram,515,2473,2,545,2485,2,3032,2990,2020-11-07 20:00:16.927752
Nagaland,1058,8161,45,1000,8282,45,9327,9264,2020-11-07 20:00:16.927752
Odisha,12363,283533,1378,12201,285174,1393,298768,297274,2020-11-07 20:00:16.927752
Puducherry,1830,33123,597,1640,33437,598,35675,35550,2020-11-07 20:00:16.927752
Punjab,4621,126932,4281,4882,127304,4295,136481,135834,2020-11-07 20:00:16.927752
Rajasthan,16301,187544,1955,16277,189354,1966,207597,205800,2020-11-07 20:00:16.927752
Sikkim,240,3778,75,283,3786,75,4144,4093,2020-11-07 20:00:16.927752
Tamil Nadu,19061,706444,11272,19002,708846,11299,739147,736777,2020-11-07 20:00:16.927752
Telengana,19272,226646,1366,19936,227583,1372,248891,247284,2020-11-07 20:00:16.927752
Tripura,1327,29666,354,1286,29792,356,31434,31347,2020-11-07 20:00:16.927752
Uttarakhand,3680,59338,1047,3736,59746,1056,64538,64065,2020-11-07 20:00:16.927752
Uttar Pradesh,23150,461073,7131,23132,463240,7155,493527,491354,2020-11-07 20:00:16.927752
West Bengal,35953,350449,7122,35557,354732,7177,397466,393524,2020-11-07 20:00:16.927752
Andaman and Nicobar Islands,166,4194,60,175,4206,60,4441,4420,2020-11-08 20:58:45.250682
Andhra Pradesh,21825,809770,6768,21434,812517,6779,840730,838363,2020-11-08 20:58:45.250682
Arunachal Pradesh,1603,13679,43,1559,13785,45,15389,15325,2020-11-08 20:58:45.250682
Assam,7067,200384,938,6758,200939,940,208637,208389,2020-11-08 20:58:45.250682
Bihar,6518,212452,1129,6287,213513,1136,220936,220099,2020-11-08 20:58:45.250682
Chandigarh,772,13925,230,815,13978,232,15025,14927,2020-11-08 20:58:45.250682
Chhattisgarh,23066,172513,2412,23256,173872,2434,199562,197991,2020-11-08 20:58:45.250682
Dadra and Nagar Haveli and Daman and Diu,37,3233,2,32,3239,2,3273,3272,2020-11-08 20:58:45.250682
Delhi,39722,377276,6833,40258,383614,6912,430784,423831,2020-11-08 20:58:45.250682
Goa,2058,42056,633,2036,42239,641,44916,44747,2020-11-08 20:58:45.250682
Gujarat,12014,162709,3748,12124,163640,3753,179517,178471,2020-11-08 20:58:45.250682
Haryana,15357,161176,1880,15713,162814,1897,180424,178413,2020-11-08 20:58:45.250682
Himachal Pradesh,3845,20033,361,4198,20243,371,24812,24239,2020-11-08 20:58:45.250682
Jammu and Kashmir,5745,90537,1523,5584,91225,1528,98337,97805,2020-11-08 20:58:45.250682
Jharkhand,4639,98365,895,4566,98776,897,104239,103899,2020-11-08 20:58:45.250682
Karnataka,33338,797204,11347,33339,799439,11369,844147,841889,2020-11-08 20:58:45.250682
Kerala,83324,388504,1640,83377,395624,1668,480669,473468,2020-11-08 20:58:45.250682
Ladakh,784,5854,80,816,5894,80,6790,6718,2020-11-08 20:58:45.250682
Lakshadweep,0,0,0,0,0,0,0,0,2020-11-08 20:58:45.250682
Madhya Pradesh,7676,164923,3004,7736,165715,3017,176468,175603,2020-11-08 20:58:45.250682
Maharashtra,103007,1562342,44965,100068,1569090,45115,1714273,1710314,2020-11-08 20:58:45.250682
Manipur,3608,16092,191,3223,16714,194,20131,19891,2020-11-08 20:58:45.250682
Meghalaya,984,8904,91,995,8959,93,10047,9979,2020-11-08 20:58:45.250682
Mizoram,545,2485,2,562,2526,2,3090,3032,2020-11-08 20:58:45.250682
Nagaland,1000,8282,45,1074,8336,45,9455,9327,2020-11-08 20:58:45.250682
Odisha,12201,285174,1393,11873,286857,1410,300140,298768,2020-11-08 20:58:45.250682
Puducherry,1640,33437,598,1212,33932,600,35744,35675,2020-11-08 20:58:45.250682
Punjab,4882,127304,4295,4827,127821,4310,136958,136481,2020-11-08 20:58:45.250682
Rajasthan,16277,189354,1966,16327,191132,1979,209438,207597,2020-11-08 20:58:45.250682
Sikkim,283,3786,75,314,3805,76,4195,4144,2020-11-08 20:58:45.250682
Tamil Nadu,19002,708846,11299,18966,711198,11324,741488,739147,2020-11-08 20:58:45.250682
Telengana,19936,227583,1372,19890,229064,1377,250331,248891,2020-11-08 20:58:45.250682
Tripura,1286,29792,356,1302,29858,357,31517,31434,2020-11-08 20:58:45.250682
Uttarakhand,3736,59746,1056,3890,60083,1063,65036,64538,2020-11-08 20:58:45.250682
Uttar Pradesh,23132,463240,7155,22991,465250,7180,495421,493527,2020-11-08 20:58:45.250682
West Bengal,35557,354732,7177,35088,359071,7235,401394,397466,2020-11-08 20:58:45.250682
Andaman and Nicobar Islands,175,4206,60,169,4221,60,4450,4441,2020-11-09 20:01:14.220041
Andhra Pradesh,21434,812517,6779,21403,814773,6791,842967,840730,2020-11-09 20:01:14.220041
Arunachal Pradesh,1559,13785,45,1509,13881,46,15436,15389,2020-11-09 20:01:14.220041
Assam,6758,200939,940,6512,201334,943,208789,208637,2020-11-09 20:01:14.220041
Bihar,6287,213513,1136,6273,214207,1144,221624,220936,2020-11-09 20:01:14.220041
Chandigarh,815,13978,232,876,14024,234,15134,15025,2020-11-09 20:01:14.220041
Chhattisgarh,23256,173872,2434,22361,176129,2447,200937,199562,2020-11-09 20:01:14.220041
Dadra and Nagar Haveli and Daman and Diu,32,3239,2,26,3246,2,3274,3273,2020-11-09 20:01:14.220041
Delhi,40258,383614,6912,41857,389683,6989,438529,430784,2020-11-09 20:01:14.220041
Goa,2036,42239,641,1976,42446,643,45065,44916,2020-11-09 20:01:14.220041
Gujarat,12124,163640,3753,12318,164459,3760,180537,179517,2020-11-09 20:01:14.220041
Haryana,15713,162814,1897,16448,164444,1912,182804,180424,2020-11-09 20:01:14.220041
Himachal Pradesh,4198,20243,371,4716,20393,377,25486,24812,2020-11-09 20:01:14.220041
Jammu and Kashmir,5584,91225,1528,5678,91681,1533,98892,98337,2020-11-09 20:01:14.220041
Jharkhand,4566,98776,897,4471,99074,897,104442,104239,2020-11-09 20:01:14.220041
Karnataka,33339,799439,11369,33697,801799,11391,846887,844147,2020-11-09 20:01:14.220041
Kerala,83377,395624,1668,81940,402477,1692,486109,480669,2020-11-09 20:01:14.220041
Ladakh,816,5894,80,765,5960,84,6809,6790,2020-11-09 20:01:14.220041
Lakshadweep,0,0,0,0,0,0,0,0,2020-11-09 20:01:14.220041
Madhya Pradesh,7736,165715,3017,7928,166403,3028,177359,176468,2020-11-09 20:01:14.220041
Maharashtra,100068,1569090,45115,97296,1577322,45240,1719858,1714273,2020-11-09 20:01:14.220041
Manipur,3223,16714,194,3107,17072,197,20376,20131,2020-11-09 20:01:14.220041
Meghalaya,995,8959,93,1034,9075,93,10202,10047,2020-11-09 20:01:14.220041
Mizoram,562,2526,2,476,2618,2,3096,3090,2020-11-09 20:01:14.220041
Nagaland,1074,8336,45,988,8440,46,9474,9455,2020-11-09 20:01:14.220041
Odisha,11873,286857,1410,11981,288168,1425,301574,300140,2020-11-09 20:01:14.220041
Puducherry,1212,33932,600,1170,34067,601,35838,35744,2020-11-09 20:01:14.220041
Punjab,4827,127821,4310,4910,128217,4318,137445,136958,2020-11-09 20:01:14.220041
Rajasthan,16327,191132,1979,16376,192945,1989,211310,209438,2020-11-09 20:01:14.220041
Sikkim,314,3805,76,273,3894,78,4245,4195,2020-11-09 20:01:14.220041
Tamil Nadu,18966,711198,11324,18894,713584,11344,743822,741488,2020-11-09 20:01:14.220041
Telengana,19890,229064,1377,19239,230568,1381,251188,250331,2020-11-09 20:01:14.220041
Tripura,1302,29858,357,1219,29965,359,31543,31517,2020-11-09 20:01:14.220041
Uttarakhand,3890,60083,1063,3972,60242,1065,65279,65036,2020-11-09 20:01:14.220041
Uttar Pradesh,22991,465250,7180,23249,467108,7206,497563,495421,2020-11-09 20:01:14.220041
West Bengal,35088,359071,7235,34566,363454,7294,405314,401394,2020-11-09 20:01:14.220041
Andaman and Nicobar Islands,169,4221,60,164,4239,60,4463,4450,2020-11-10 20:00:15.170943
Andhra Pradesh,21403,814773,6791,21235,816322,6802,844359,842967,2020-11-10 20:00:15.170943
Arunachal Pradesh,1509,13881,46,1472,13966,46,15484,15436,2020-11-10 20:00:15.170943
Assam,6512,201334,943,6328,201842,947,209117,208789,2020-11-10 20:00:15.170943
Bihar,6273,214207,1144,6503,215263,1151,222917,221624,2020-11-10 20:00:15.170943
Chandigarh,876,14024,234,902,14110,237,15249,15134,2020-11-10 20:00:15.170943
Chhattisgarh,22361,176129,2447,21221,178838,2464,202523,200937,2020-11-10 20:00:15.170943
Dadra and Nagar Haveli and Daman and Diu,26,3246,2,23,3249,2,3274,3274,2020-11-10 20:00:15.170943
Delhi,41857,389683,6989,39795,396697,7060,443552,438529,2020-11-10 20:00:15.170943
Goa,1976,42446,643,1884,42678,647,45209,45065,2020-11-10 20:00:15.170943
Gujarat,12318,164459,3760,12291,165452,3765,181508,180537,2020-11-10 20:00:15.170943
Haryana,16448,164444,1912,16717,166595,1919,185231,182804,2020-11-10 20:00:15.170943
Himachal Pradesh,4716,20393,377,5192,20621,384,26197,25486,2020-11-10 20:00:15.170943
Jammu and Kashmir,5678,91681,1533,5565,92245,1542,99352,98892,2020-11-10 20:00:15.170943
Jharkhand,4471,99074,897,4251,99532,905,104688,104442,2020-11-10 20:00:15.170943
Karnataka,33697,801799,11391,32955,804485,11410,848850,846887,2020-11-10 20:00:15.170943
Kerala,81940,402477,1692,79528,408460,1714,489702,486109,2020-11-10 20:00:15.170943
Ladakh,765,5960,84,846,6003,85,6934,6809,2020-11-10 20:00:15.170943
Lakshadweep,0,0,0,0,0,0,0,0,2020-11-10 20:00:15.170943
Madhya Pradesh,7928,166403,3028,8050,167084,3034,178168,177359,2020-11-10 20:00:15.170943
Maharashtra***,97296,1577322,45240,96437,1581373,45325,1723135,1719858,2020-11-10 20:00:15.170943
Manipur,3107,17072,197,3101,17259,198,20558,20376,2020-11-10 20:00:15.170943
Meghalaya,1034,9075,93,1024,9112,94,10230,10202,2020-11-10 20:00:15.170943
Mizoram,476,2618,2,498,2656,2,3156,3096,2020-11-10 20:00:15.170943
Nagaland,988,8440,46,944,8513,46,9503,9474,2020-11-10 20:00:15.170943
Odisha,11981,288168,1425,11663,289689,1441,302793,301574,2020-11-10 20:00:15.170943
Puducherry,1170,34067,601,1086,34212,602,35900,35838,2020-11-10 20:00:15.170943
Punjab,4910,128217,4318,4934,128727,4338,137999,137445,2020-11-10 20:00:15.170943
Rajasthan,16376,192945,1989,16542,194629,1998,213169,211310,2020-11-10 20:00:15.170943
Sikkim,273,3894,78,268,3910,79,4257,4245,2020-11-10 20:00:15.170943
Tamil Nadu,18894,713584,11344,18825,715892,11362,746079,743822,2020-11-10 20:00:15.170943
Telengana,19239,230568,1381,18581,232489,1385,252455,251188,2020-11-10 20:00:15.170943
Tripura,1219,29965,359,1254,30009,359,31622,31543,2020-11-10 20:00:15.170943
Uttarakhand,3972,60242,1065,4149,60453,1075,65677,65279,2020-11-10 20:00:15.170943
Uttar Pradesh,23249,467108,7206,22965,469003,7231,499199,497563,2020-11-10 20:00:15.170943
West Bengal,34566,363454,7294,34021,367850,7350,409221,405314,2020-11-10 20:00:15.170943
Andaman and Nicobar Islands,164,4239,60,162,4255,60,4477,4463,2020-11-11 20:50:47.224151
Andhra Pradesh,21235,816322,6802,20958,818473,6814,846245,844359,2020-11-11 20:50:47.224151
Arunachal Pradesh,1472,13966,46,1484,14051,46,15581,15484,2020-11-11 20:50:47.224151
Assam,6328,201842,947,5965,202471,952,209388,209117,2020-11-11 20:50:47.224151
Bihar,6503,215263,1151,6093,216097,1156,223346,222917,2020-11-11 20:50:47.224151
Chandigarh,902,14110,237,922,14176,241,15339,15249,2020-11-11 20:50:47.224151
Chhattisgarh,21221,178838,2464,20725,180995,2482,204202,202523,2020-11-11 20:50:47.224151
Dadra and Nagar Haveli and Daman and Diu,23,3249,2,20,3253,2,3275,3274,2020-11-11 20:50:47.224151
Delhi,39795,396697,7060,41385,402854,7143,451382,443552,2020-11-11 20:50:47.224151
Goa,1884,42678,647,1861,42877,651,45389,45209,2020-11-11 20:50:47.224151
Gujarat,12291,165452,3765,12456,166331,3770,182557,181508,2020-11-11 20:50:47.224151
Haryana,16717,166595,1919,17421,168421,1935,187777,185231,2020-11-11 20:50:47.224151
Himachal Pradesh,5192,20621,384,5365,21047,396,26808,26197,2020-11-11 20:50:47.224151
Jammu and Kashmir,5565,92245,1542,5415,92880,1549,99844,99352,2020-11-11 20:50:47.224151
Jharkhand,4251,99532,905,4042,99988,910,104940,104688,2020-11-11 20:50:47.224151
Karnataka,32955,804485,11410,31082,808700,11430,851212,848850,2020-11-11 20:50:47.224151
Kerala,79528,408460,1714,78812,415158,1742,495712,489702,2020-11-11 20:50:47.224151
Ladakh,846,6003,85,920,6058,85,7063,6934,2020-11-11 20:50:47.224151
Lakshadweep,0,0,0,0,0,0,0,0,2020-11-11 20:50:47.224151
Madhya Pradesh,8050,167084,3034,8149,167877,3042,179068,178168,2020-11-11 20:50:47.224151
Maharashtra,96437,1581373,45325,93400,1588091,45435,1726926,1723135,2020-11-11 20:50:47.224151
Manipur,3101,17259,198,3043,17534,200,20777,20558,2020-11-11 20:50:47.224151
Meghalaya,1024,9112,94,961,9241,94,10296,10230,2020-11-11 20:50:47.224151
Mizoram,498,2656,2,529,2686,2,3217,3156,2020-11-11 20:50:47.224151
Nagaland,944,8513,46,889,8597,50,9536,9503,2020-11-11 20:50:47.224151
Odisha,11663,289689,1441,11189,291137,1454,303780,302793,2020-11-11 20:50:47.224151
Puducherry,1086,34212,602,1071,34325,604,36000,35900,2020-11-11 20:50:47.224151
Punjab,4934,128727,4338,5038,129089,4358,138485,137999,2020-11-11 20:50:47.224151
Rajasthan,16542,194629,1998,16725,196338,2008,215071,213169,2020-11-11 20:50:47.224151
Sikkim,268,3910,79,305,3923,80,4308,4257,2020-11-11 20:50:47.224151
Tamil Nadu,18825,715892,11362,18709,718129,11387,748225,746079,2020-11-11 20:50:47.224151
Telengana,18581,232489,1385,18027,234234,1390,253651,252455,2020-11-11 20:50:47.224151
Tripura,1254,30009,359,1289,30058,359,31706,31622,2020-11-11 20:50:47.224151
Uttarakhand,4149,60453,1075,3955,60970,1080,66005,65677,2020-11-11 20:50:47.224151
Uttar Pradesh,22965,469003,7231,22846,471204,7261,501311,499199,2020-11-11 20:50:47.224151
West Bengal,34021,367850,7350,33444,372265,7403,413112,409221,2020-11-11 20:50:47.224151
Andaman and Nicobar Islands,162,4255,60,167,4267,60,4494,4477,2020-11-12 20:24:48.271298
Andhra Pradesh,20958,818473,6814,20915,820234,6828,847977,846245,2020-11-12 20:24:48.271298
Arunachal Pradesh,1484,14051,46,1485,14126,46,15657,15581,2020-11-12 20:24:48.271298
Assam,5965,202471,952,5371,203308,954,209633,209388,2020-11-12 20:24:48.271298
Bihar,6093,216097,1156,5815,216940,1162,223917,223346,2020-11-12 20:24:48.271298
Chandigarh,922,14176,241,958,14233,243,15434,15339,2020-11-12 20:24:48.271298
Chhattisgarh,20725,180995,2482,20226,183190,2507,205923,204202,2020-11-12 20:24:48.271298
Dadra and Nagar Haveli and Daman and Diu,20,3253,2,18,3255,2,3275,3275,2020-11-12 20:24:48.271298
Delhi,41385,402854,7143,42629,410118,7228,459975,451382,2020-11-12 20:24:48.271298
Goa,1861,42877,651,1813,43029,656,45498,45389,2020-11-12 20:24:48.271298
Gujarat,12456,166331,3770,12223,167683,3776,183682,182557,2020-11-12 20:24:48.271298
Haryana,17421,168421,1935,18113,170250,1960,190323,187777,2020-11-12 20:24:48.271298
Himachal Pradesh,5365,21047,396,5605,21408,405,27418,26808,2020-11-12 20:24:48.271298
Jammu and Kashmir,5415,92880,1549,5480,93313,1558,100351,99844,2020-11-12 20:24:48.271298
Jharkhand,4042,99988,910,4009,100302,913,105224,104940,2020-11-12 20:24:48.271298
Karnataka,31082,808700,11430,30762,811581,11453,853796,851212,2020-11-12 20:24:48.271298
Kerala,78812,415158,1742,78538,422410,1771,502719,495712,2020-11-12 20:24:48.271298
Ladakh,920,6058,85,930,6118,86,7134,7063,2020-11-12 20:24:48.271298
Lakshadweep,0,0,0,0,0,0,0,0,2020-11-12 20:24:48.271298
Madhya Pradesh,8149,167877,3042,8328,168568,3055,179951,179068,2020-11-12 20:24:48.271298
Maharashtra,93400,1588091,45435,89018,1597255,45560,1731833,1726926,2020-11-12 20:24:48.271298
Manipur,3043,17534,200,3050,17698,202,20950,20777,2020-11-12 20:24:48.271298
Meghalaya,961,9241,94,962,9312,94,10368,10296,2020-11-12 20:24:48.271298
Mizoram,529,2686,2,552,2688,2,3242,3217,2020-11-12 20:24:48.271298
Nagaland,889,8597,50,841,8687,50,9578,9536,2020-11-12 20:24:48.271298
Odisha,11189,291137,1454,11054,292477,1469,305000,303780,2020-11-12 20:24:48.271298
Puducherry,1071,34325,604,1077,34432,605,36114,36000,2020-11-12 20:24:48.271298
Punjab,5038,129089,4358,5246,129549,4389,139184,138485,2020-11-12 20:24:48.271298
Rajasthan,16725,196338,2008,16993,198139,2019,217151,215071,2020-11-12 20:24:48.271298
Sikkim,305,3923,80,291,3971,82,4344,4308,2020-11-12 20:24:48.271298
Tamil Nadu,18709,718129,11387,18655,720339,11415,750409,748225,2020-11-12 20:24:48.271298
Telengana,18027,234234,1390,17323,235950,1393,254666,253651,2020-11-12 20:24:48.271298
Tripura,1289,30058,359,1198,30208,359,31765,31706,2020-11-12 20:24:48.271298
Uttarakhand,3955,60970,1080,4251,61451,1086,66788,66005,2020-11-12 20:24:48.271298
Uttar Pradesh,22846,471204,7261,22562,473316,7281,503159,501311,2020-11-12 20:24:48.271298
West Bengal,33444,372265,7403,32836,376696,7452,416984,413112,2020-11-12 20:24:48.271298
Andaman and Nicobar Islands,164,4282,61,153,4304,61,4518,4507,2020-11-13 12:41:21
Andhra Pradesh,20857,822011,6837,20262,824189,6847,851298,849705,2020-11-13 12:41:21
Arunachal Pradesh,1440,14214,47,1392,14319,47,15758,15701,2020-11-13 12:41:21
Assam,4799,204079,957,4389,204721,958,210068,209835,2020-11-13 12:41:21
Bihar,5763,217594,1167,5637,218313,1174,225124,224524,2020-11-13 12:41:21
Chandigarh,1002,14297,244,1009,14381,246,15636,15543,2020-11-13 12:41:21
Chhattisgarh,20061,185152,2527,19221,187522,2545,209288,207740,2020-11-13 12:41:21
Dadra and Nagar Haveli and Daman and Diu,21,3255,2,20,3259,2,3281,3278,2020-11-13 12:41:21
Delhi,43116,416580,7332,44329,423078,7423,474830,467028,2020-11-13 12:41:21
Goa,1728,43221,656,1715,43388,658,45761,45605,2020-11-13 12:41:21
Gujarat,12321,168858,3785,12389,169936,3791,186116,184964,2020-11-13 12:41:21
Haryana,18867,172265,1979,19413,174380,2006,195799,193111,2020-11-13 12:41:21
Himachal Pradesh,6165,21607,411,6739,21846,423,29008,28183,2020-11-13 12:41:21
Jammu and Kashmir,5578,93824,1566,5645,94375,1574,101594,100968,2020-11-13 12:41:21
Jharkhand,3668,100908,917,3291,101569,921,105781,105493,2020-11-13 12:41:21
Karnataka,29489,814949,11474,28045,818392,11491,857928,855912,2020-11-13 12:41:21
Kerala,77931,428529,1796,77508,434730,1822,514060,508256,2020-11-13 12:41:21
Ladakh,971,6151,89,989,6213,89,7291,7211,2020-11-13 12:41:21
Lakshadweep,0,0,0,0,0,0,0,0,2020-11-13 12:41:21
Madhya Pradesh,8672,169260,3065,8876,170093,3076,182045,180997,2020-11-13 12:41:21
Maharashtra,85583,1605064,45682,85045,1609607,45809,1740461,1736329,2020-11-13 12:41:21
Manipur,3115,17889,207,3068,18144,213,21425,21211,2020-11-13 12:41:21
Meghalaya,1045,9368,98,1028,9455,98,10581,10511,2020-11-13 12:41:21
Mizoram,568,2739,2,573,2792,3,3368,3309,2020-11-13 12:41:21
Nagaland,789,8776,50,727,8859,52,9638,9615,2020-11-13 12:41:21
Odisha,10762,293741,1483,10264,295245,1495,307004,305986,2020-11-13 12:41:21
Puducherry,1071,34501,607,1073,34571,608,36252,36179,2020-11-13 12:41:21
Punjab,5439,130018,4412,5771,130406,4428,140605,139869,2020-11-13 12:41:21
Rajasthan,17352,199943,2032,17657,201770,2044,221471,219327,2020-11-13 12:41:21
Sikkim,264,4019,85,293,4036,86,4415,4368,2020-11-13 12:41:21
Tamil Nadu,18395,722686,11440,17748,725258,11454,754460,752521,2020-11-13 12:41:21
Telengana,17094,237172,1397,16404,238908,1401,256713,255663,2020-11-13 12:41:21
Tripura,1167,30314,360,1143,30414,362,31919,31841,2020-11-13 12:41:21
Uttarakhand,4156,61990,1093,4307,62302,1097,67706,67239,2020-11-13 12:41:21
Uttar Pradesh,22949,475175,7302,23095,477180,7327,507602,505426,2020-11-13 12:41:21
West Bengal,32185,381149,7506,31501,385617,7557,424675,420840,2020-11-13 12:41:21
Andaman and Nicobar Islands,164,4282,61,153,4304,61,4518,4507,2020-11-14 20:35:06.913654
Andhra Pradesh,20857,822011,6837,20262,824189,6847,851298,849705,2020-11-14 20:35:06.913654
Arunachal Pradesh,1440,14214,47,1392,14319,47,15758,15701,2020-11-14 20:35:06.913654
Assam,4799,204079,957,4389,204721,958,210068,209835,2020-11-14 20:35:06.913654
Bihar,5763,217594,1167,5637,218313,1174,225124,224524,2020-11-14 20:35:06.913654
Chandigarh,1002,14297,244,1009,14381,246,15636,15543,2020-11-14 20:35:06.913654
Chhattisgarh,20061,185152,2527,19221,187522,2545,209288,207740,2020-11-14 20:35:06.913654
Dadra and Nagar Haveli and Daman and Diu,21,3255,2,20,3259,2,3281,3278,2020-11-14 20:35:06.913654
Delhi,43116,416580,7332,44329,423078,7423,474830,467028,2020-11-14 20:35:06.913654
Goa,1728,43221,656,1715,43388,658,45761,45605,2020-11-14 20:35:06.913654
Gujarat,12321,168858,3785,12389,169936,3791,186116,184964,2020-11-14 20:35:06.913654
Haryana,18867,172265,1979,19413,174380,2006,195799,193111,2020-11-14 20:35:06.913654
Himachal Pradesh,6165,21607,411,6739,21846,423,29008,28183,2020-11-14 20:35:06.913654
Jammu and Kashmir,5578,93824,1566,5645,94375,1574,101594,100968,2020-11-14 20:35:06.913654
Jharkhand,3668,100908,917,3291,101569,921,105781,105493,2020-11-14 20:35:06.913654
Karnataka,29489,814949,11474,28045,818392,11491,857928,855912,2020-11-14 20:35:06.913654
Kerala,77931,428529,1796,77508,434730,1822,514060,508256,2020-11-14 20:35:06.913654
Ladakh,971,6151,89,989,6213,89,7291,7211,2020-11-14 20:35:06.913654
Lakshadweep,0,0,0,0,0,0,0,0,2020-11-14 20:35:06.913654
Madhya Pradesh,8672,169260,3065,8876,170093,3076,182045,180997,2020-11-14 20:35:06.913654
Maharashtra,85583,1605064,45682,85045,1609607,45809,1740461,1736329,2020-11-14 20:35:06.913654
Manipur,3115,17889,207,3068,18144,213,21425,21211,2020-11-14 20:35:06.913654
Meghalaya,1045,9368,98,1028,9455,98,10581,10511,2020-11-14 20:35:06.913654
Mizoram,568,2739,2,573,2792,3,3368,3309,2020-11-14 20:35:06.913654
Nagaland,789,8776,50,727,8859,52,9638,9615,2020-11-14 20:35:06.913654
Odisha,10762,293741,1483,10264,295245,1495,307004,305986,2020-11-14 20:35:06.913654
Puducherry,1071,34501,607,1073,34571,608,36252,36179,2020-11-14 20:35:06.913654
Punjab,5439,130018,4412,5771,130406,4428,140605,139869,2020-11-14 20:35:06.913654
Rajasthan,17352,199943,2032,17657,201770,2044,221471,219327,2020-11-14 20:35:06.913654
Sikkim,264,4019,85,293,4036,86,4415,4368,2020-11-14 20:35:06.913654
Tamil Nadu,18395,722686,11440,17748,725258,11454,754460,752521,2020-11-14 20:35:06.913654
Telengana,17094,237172,1397,16404,238908,1401,256713,255663,2020-11-14 20:35:06.913654
Tripura,1167,30314,360,1143,30414,362,31919,31841,2020-11-14 20:35:06.913654
Uttarakhand,4156,61990,1093,4307,62302,1097,67706,67239,2020-11-14 20:35:06.913654
Uttar Pradesh,22949,475175,7302,23095,477180,7327,507602,505426,2020-11-14 20:35:06.913654
West Bengal,32185,381149,7506,31501,385617,7557,424675,420840,2020-11-14 20:35:06.913654
Andaman and Nicobar Islands,153,4304,61,151,4315,61,4527,4518,2020-11-15 21:10:23.878539
Andhra Pradesh,20262,824189,6847,19757,826344,6854,852955,851298,2020-11-15 21:10:23.878539
Arunachal Pradesh,1392,14319,47,1323,14421,48,15792,15758,2020-11-15 21:10:23.878539
Assam,4389,204721,958,3964,205250,961,210175,210068,2020-11-15 21:10:23.878539
Bihar,5637,218313,1174,5727,218689,1179,225595,225124,2020-11-15 21:10:23.878539
Chandigarh***,1009,14381,246,1009,14381,246,15636,15636,2020-11-15 21:10:23.878539
Chhattisgarh,19221,187522,2545,19275,188167,2562,210004,209288,2020-11-15 21:10:23.878539
Dadra and Nagar Haveli and Daman and Diu,20,3259,2,20,3263,2,3285,3281,2020-11-15 21:10:23.878539
Delhi,44329,423078,7423,44456,430195,7519,482170,474830,2020-11-15 21:10:23.878539
Goa,1715,43388,658,1653,43533,659,45845,45761,2020-11-15 21:10:23.878539
Gujarat,12389,169936,3791,12512,170931,3797,187240,186116,2020-11-15 21:10:23.878539
Haryana,19413,174380,2006,19538,176368,2011,197917,195799,2020-11-15 21:10:23.878539
Himachal Pradesh,6739,21846,423,6716,22183,431,29330,29008,2020-11-15 21:10:23.878539
Jammu and Kashmir,5645,94375,1574,5728,94851,1580,102159,101594,2020-11-15 21:10:23.878539
Jharkhand,3291,101569,921,3116,101897,922,105935,105781,2020-11-15 21:10:23.878539
Karnataka,28045,818392,11491,27984,820590,11508,860082,857928,2020-11-15 21:10:23.878539
Kerala,77508,434730,1822,77046,441523,1848,520417,514060,2020-11-15 21:10:23.878539
Ladakh,989,6213,89,978,6289,89,7356,7291,2020-11-15 21:10:23.878539
Lakshadweep,0,0,0,0,0,0,0,0,2020-11-15 21:10:23.878539
Madhya Pradesh,8876,170093,3076,9005,170969,3083,183057,182045,2020-11-15 21:10:23.878539
Maharashtra,85045,1609607,45809,86470,1612314,45914,1744698,1740461,2020-11-15 21:10:23.878539
Manipur,3068,18144,213,3084,18334,218,21636,21425,2020-11-15 21:10:23.878539
Meghalaya,1028,9455,98,1014,9518,100,10632,10581,2020-11-15 21:10:23.878539
Mizoram,573,2792,3,569,2820,4,3393,3368,2020-11-15 21:10:23.878539
Nagaland,727,8859,52,807,8891,52,9750,9638,2020-11-15 21:10:23.878539
Odisha,10264,295245,1495,9880,296516,1510,307906,307004,2020-11-15 21:10:23.878539
Puducherry,1073,34571,608,1054,34637,608,36299,36252,2020-11-15 21:10:23.878539
Punjab***,5771,130406,4428,5771,130406,4428,140605,140605,2020-11-15 21:10:23.878539
Rajasthan,17657,201770,2044,18053,203524,2056,223633,221471,2020-11-15 21:10:23.878539
Sikkim,293,4036,86,296,4073,87,4456,4415,2020-11-15 21:10:23.878539
Tamil Nadu,17748,725258,11454,17154,727752,11466,756372,754460,2020-11-15 21:10:23.878539
Telengana,16404,238908,1401,15425,240545,1404,257374,256713,2020-11-15 21:10:23.878539
Tripura,1143,30414,362,1105,30478,362,31945,31919,2020-11-15 21:10:23.878539
Uttarakhand,4307,62302,1097,4417,62483,1102,68002,67706,2020-11-15 21:10:23.878539
Uttar Pradesh,23095,477180,7327,23367,479182,7354,509903,507602,2020-11-15 21:10:23.878539
West Bengal,31501,385617,7557,30792,390096,7610,428498,424675,2020-11-15 21:10:23.878539
Andaman and Nicobar Islands,151,4315,61,145,4330,61,4536,4527,2020-11-16 19:06:38.383276
Andhra Pradesh,19757,826344,6854,18659,828484,6868,854011,852955,2020-11-16 19:06:38.383276
Arunachal Pradesh,1323,14421,48,1264,14500,48,15812,15792,2020-11-16 19:06:38.383276
Assam,3964,205250,961,3666,205639,963,210268,210175,2020-11-16 19:06:38.383276
Bihar,5727,218689,1179,5454,219263,1184,225901,225595,2020-11-16 19:06:38.383276
Chandigarh,1009,14381,246,1088,14468,248,15804,15636,2020-11-16 19:06:38.383276
Chhattisgarh,19275,188167,2562,19087,188869,2578,210534,210004,2020-11-16 19:06:38.383276
Dadra and Nagar Haveli and Daman and Diu,20,3263,2,22,3267,2,3291,3285,2020-11-16 19:06:38.383276
Delhi,44456,430195,7519,39990,437801,7614,485405,482170,2020-11-16 19:06:38.383276
Goa,1653,43533,659,1585,43656,662,45903,45845,2020-11-16 19:06:38.383276
Gujarat,12512,170931,3797,12575,171932,3803,188310,187240,2020-11-16 19:06:38.383276
Haryana,19538,176368,2011,19557,178298,2019,199874,197917,2020-11-16 19:06:38.383276
Himachal Pradesh,6716,22183,431,6879,22392,442,29713,29330,2020-11-16 19:06:38.383276
Jammu and Kashmir,5728,94851,1580,5688,95342,1589,102619,102159,2020-11-16 19:06:38.383276
Jharkhand,3116,101897,922,2952,102188,924,106064,105935,2020-11-16 19:06:38.383276
Karnataka,27984,820590,11508,27165,822953,11529,861647,860082,2020-11-16 19:06:38.383276
Kerala,77046,441523,1848,74922,448207,1869,524998,520417,2020-11-16 19:06:38.383276
Ladakh,978,6289,89,922,6385,89,7396,7356,2020-11-16 19:06:38.383276
Lakshadweep,0,0,0,0,0,0,0,0,2020-11-16 19:06:38.383276
Madhya Pradesh,9005,170969,3083,9146,171691,3090,183927,183057,2020-11-16 19:06:38.383276
Maharashtra,86470,1612314,45914,85889,1615379,45974,1747242,1744698,2020-11-16 19:06:38.383276
Manipur,3084,18334,218,3057,18593,221,21871,21636,2020-11-16 19:06:38.383276
Meghalaya,1014,9518,100,971,9594,100,10665,10632,2020-11-16 19:06:38.383276
Mizoram,569,2820,4,516,2876,4,3396,3393,2020-11-16 19:06:38.383276
Nagaland,807,8891,52,920,8913,52,9885,9750,2020-11-16 19:06:38.383276
Odisha,9880,296516,1510,9270,297862,1527,308659,307906,2020-11-16 19:06:38.383276
Puducherry,1054,34637,608,984,34732,608,36324,36299,2020-11-16 19:06:38.383276
Punjab,5771,130406,4428,5769,131431,4458,141658,140605,2020-11-16 19:06:38.383276
Rajasthan,18053,203524,2056,18337,205414,2066,225817,223633,2020-11-16 19:06:38.383276
Sikkim,296,4073,87,284,4125,89,4498,4456,2020-11-16 19:06:38.383276
Tamil Nadu,17154,727752,11466,16441,730272,11478,758191,756372,2020-11-16 19:06:38.383276
Telengana,15425,240545,1404,14385,242084,1407,257876,257374,2020-11-16 19:06:38.383276
Tripura,1105,30478,362,1043,30555,364,31962,31945,2020-11-16 19:06:38.383276
Uttarakhand,4417,62483,1102,4565,62543,1107,68215,68002,2020-11-16 19:06:38.383276
Uttar Pradesh,23367,479182,7354,22967,480965,7372,511304,509903,2020-11-16 19:06:38.383276
West Bengal,30792,390096,7610,29314,394576,7661,431551,428498,2020-11-16 19:06:38.383276
Andaman and Nicobar Islands,147,4330,61,152,3469,52,3673,4536,2020-11-17 17:39:44
Andhra Pradesh,78836,828484,6868,74518,551821,5410,631749,854011,2020-11-17 17:39:44
Arunachal Pradesh,1964,14500,48,1939,5643,13,7595,15812,2020-11-17 17:39:44
Assam,28780,205639,963,29609,129133,578,159320,210268,2020-11-17 17:39:44
Bihar,13005,219263,1184,12539,156242,870,169651,225901,2020-11-17 17:39:44
Chandigarh,2821,14468,248,2761,7411,126,10298,15804,2020-11-17 17:39:44
Chhattisgarh,37853,188869,2578,37927,49564,690,88181,210534,2020-11-17 17:39:44
Dadra and Nagar Haveli and Daman and Diu,229,3267,2,220,2711,2,2933,3291,2020-11-17 17:39:44
Delhi,32097,437801,7614,30941,213304,5014,249259,485405,2020-11-17 17:39:44
Goa,5781,43656,662,5667,22726,360,28753,45903,2020-11-17 17:39:44
Gujarat,16208,171932,3803,16305,104964,3336,124605,188310,2020-11-17 17:39:44
Haryana,21411,178298,2019,21014,90884,1177,113075,199874,2020-11-17 17:39:44
Himachal Pradesh,4444,22392,442,4458,7853,127,12438,29713,2020-11-17 17:39:44
Jammu and Kashmir,22032,95342,1589,21887,42115,1024,65026,102619,2020-11-17 17:39:44
Jharkhand,13791,102188,924,13504,58543,626,72673,106064,2020-11-17 17:39:44
Karnataka,98062,822953,11529,95354,423377,8145,526876,861647,2020-11-17 17:39:44
Kerala,39484,448207,1869,39354,98724,553,138631,524998,2020-11-17 17:39:44
Ladakh,1013,6385,89,1047,2735,50,3832,7396,2020-11-17 17:39:44
Lakshadweep,0,0,0,0,0,0,0,0,2020-11-17 17:39:44
Madhya Pradesh,22300,171691,3090,22542,83618,2007,108167,183927,2020-11-17 17:39:44
Maharashtra,291630,1615379,45974,275017,916348,33015,1224380,1747242,2020-11-17 17:39:44
Manipur,2070,18593,221,2113,6838,59,9010,21871,2020-11-17 17:39:44
Meghalaya,2111,9594,100,2169,2527,37,4733,10665,2020-11-17 17:39:44
Mizoram,583,2876,4,680,1012,0,1692,3396,2020-11-17 17:39:44
Nagaland,1184,8913,52,1052,4477,15,5544,9885,2020-11-17 17:39:44
Odisha,33504,297862,1527,34033,149379,710,184122,308659,2020-11-17 17:39:44
Puducherry,4908,34732,608,4659,18065,467,23191,36324,2020-11-17 17:39:44
Punjab,22278,131431,4458,21661,75409,2860,99930,141658,2020-11-17 17:39:44
Rajasthan,18184,205414,2066,18245,97284,1352,116881,225817,2020-11-17 17:39:44
Sikkim,469,4125,89,513,1986,29,2528,4498,2020-11-17 17:39:44
Tamil Nadu,46703,730272,11478,46495,491971,8871,547337,758191,2020-11-17 17:39:44
Telengana,29636,242084,1407,29649,144073,1052,174774,257876,2020-11-17 17:39:44
Tripura,6566,30555,364,6700,15883,251,22834,31962,2020-11-17 17:39:44
Uttarakhand,12455,480965,7372,12075,29201,501,41777,511304,2020-11-17 17:39:44
Uttar Pradesh,65954,62543,1107,64164,289594,5135,358893,68215,2020-11-17 17:39:44
West Bengal,24806,394576,7661,24898,198983,4421,228302,431551,2020-11-17 17:39:44
Andaman and Nicobar Islands,150,4346,61,150,4363,61,4574,4557,2020-11-18 21:01:24.202117
Andhra Pradesh,17892,829991,6881,16985,832284,6890,856159,854764,2020-11-18 21:01:24.202117
Arunachal Pradesh,1232,14588,48,1212,14644,48,15904,15868,2020-11-18 21:01:24.202117
Assam,3446,206044,964,3329,206401,966,210696,210454,2020-11-18 21:01:24.202117
Bihar,5221,220007,1189,5156,220668,1194,227018,226417,2020-11-18 21:01:24.202117
Chandigarh,1052,14584,250,1026,14744,252,16022,15886,2020-11-18 21:01:24.202117
Chhattisgarh,18577,190463,2604,18561,192181,2623,213365,211644,2020-11-18 21:01:24.202117
Dadra and Nagar Haveli and Daman and Diu,19,3273,2,21,3274,2,3297,3294,2020-11-18 21:01:24.202117
Delhi,40128,441361,7713,42004,445782,7812,495598,489202,2020-11-18 21:01:24.202117
Goa,1424,43941,663,1383,44132,667,46182,46028,2020-11-18 21:01:24.202117
Gujarat,12456,172972,3808,12458,174088,3815,190361,189236,2020-11-18 21:01:24.202117
Haryana,19342,180647,2038,19153,183261,2063,204477,202027,2020-11-18 21:01:24.202117
Himachal Pradesh,6775,22931,450,6772,23506,462,30740,30156,2020-11-18 21:01:24.202117
Jammu and Kashmir,5588,95824,1597,5585,96392,1604,103581,103009,2020-11-18 21:01:24.202117
Jharkhand,2754,102548,928,2669,102891,931,106491,106230,2020-11-18 21:01:24.202117
Karnataka,26122,825141,11541,25342,827241,11557,864140,862804,2020-11-18 21:01:24.202117
Kerala,71046,454774,1888,70191,461394,1915,533500,527708,2020-11-18 21:01:24.202117
Ladakh,944,6456,93,930,6539,94,7563,7493,2020-11-18 21:01:24.202117
Lakshadweep,0,0,0,0,0,0,0,0,2020-11-18 21:01:24.202117
Madhya Pradesh,8996,172436,3092,9060,173284,3102,185446,184524,2020-11-18 21:01:24.202117
Maharashtra,85363,1618380,46034,82904,1623503,46102,1752509,1749777,2020-11-18 21:01:24.202117
Manipur,2993,18832,224,2918,19065,225,22208,22049,2020-11-18 21:01:24.202117
Meghalaya,933,9672,101,734,9955,102,10791,10706,2020-11-18 21:01:24.202117
Mizoram,524,2915,5,504,2972,5,3481,3444,2020-11-18 21:01:24.202117
Nagaland,1013,8959,53,1138,8997,53,10188,10025,2020-11-18 21:01:24.202117
Odisha,8706,299159,1543,8018,300474,1560,310052,309408,2020-11-18 21:01:24.202117
Puducherry,902,34827,608,843,34958,608,36409,36337,2020-11-18 21:01:24.202117
Punjab,5601,132001,4480,5821,132266,4510,142597,142082,2020-11-18 21:01:24.202117
Rajasthan,18684,207224,2078,19033,209058,2089,230180,227986,2020-11-18 21:01:24.202117
Sikkim,293,4137,91,312,4144,92,4548,4521,2020-11-18 21:01:24.202117
Tamil Nadu,15765,732656,11495,15085,734970,11513,761568,759916,2020-11-18 21:01:24.202117
Telengana,13732,243686,1410,13068,245293,1415,259776,258828,2020-11-18 21:01:24.202117
Tripura,1044,30631,364,998,30750,364,32112,32039,2020-11-18 21:01:24.202117
Uttarakhand,4184,63158,1116,4165,63603,1119,68887,68458,2020-11-18 21:01:24.202117
Uttar Pradesh,22603,482854,7393,22166,484692,7412,514270,512850,2020-11-18 21:01:24.202117
West Bengal,27897,398952,7714,27111,403340,7766,438217,434563,2020-11-18 21:01:24.202117
Andaman and Nicobar Islands,150,4363,61,154,4378,61,4593,4574,2020-11-19 19:35:28.349585
Andhra Pradesh,16985,832284,6890,16516,833980,6899,857395,856159,2020-11-19 19:35:28.349585
Arunachal Pradesh,1212,14644,48,1182,14715,48,15945,15904,2020-11-19 19:35:28.349585
Assam,3329,206401,966,3285,206611,969,210865,210696,2020-11-19 19:35:28.349585
Bihar,5156,220668,1194,5349,221272,1201,227822,227018,2020-11-19 19:35:28.349585
Chandigarh,1026,14744,252,1081,14833,253,16167,16022,2020-11-19 19:35:28.349585
Chhattisgarh,18561,192181,2623,18770,193997,2646,215413,213365,2020-11-19 19:35:28.349585
Dadra and Nagar Haveli and Daman and Diu,21,3274,2,29,3274,2,3305,3297,2020-11-19 19:35:28.349585
Delhi,42004,445782,7812,42458,452683,7943,503084,495598,2020-11-19 19:35:28.349585
Goa,1383,44132,667,1364,44310,670,46344,46182,2020-11-19 19:35:28.349585
Gujarat,12458,174088,3815,12457,175362,3823,191642,190361,2020-11-19 19:35:28.349585
Haryana,19153,183261,2063,19543,185403,2093,207039,204477,2020-11-19 19:35:28.349585
Himachal Pradesh,6772,23506,462,6901,24025,475,31401,30740,2020-11-19 19:35:28.349585
Jammu and Kashmir,5585,96392,1604,5570,96972,1613,104155,103581,2020-11-19 19:35:28.349585
Jharkhand,2669,102891,931,2637,103171,934,106742,106491,2020-11-19 19:35:28.349585
Karnataka,25342,827241,11557,25165,829188,11578,865931,864140,2020-11-19 19:35:28.349585
Kerala,70191,461394,1915,69516,468460,1943,539919,533500,2020-11-19 19:35:28.349585
Ladakh,930,6539,94,924,6605,94,7623,7563,2020-11-19 19:35:28.349585
Lakshadweep,0,0,0,0,0,0,0,0,2020-11-19 19:35:28.349585
Madhya Pradesh,9060,173284,3102,9338,174202,3115,186655,185446,2020-11-19 19:35:28.349585
Maharashtra,82904,1623503,46102,81207,1630111,46202,1757520,1752509,2020-11-19 19:35:28.349585
Manipur,2918,19065,225,2828,19259,231,22318,22208,2020-11-19 19:35:28.349585
Meghalaya,734,9955,102,753,10014,103,10870,10791,2020-11-19 19:35:28.349585
Mizoram,504,2972,5,487,3021,5,3513,3481,2020-11-19 19:35:28.349585
Nagaland,1138,8997,53,1255,9057,54,10366,10188,2020-11-19 19:35:28.349585
Odisha,8018,300474,1560,7568,301777,1575,310920,310052,2020-11-19 19:35:28.349585
Puducherry,843,34958,608,705,35152,608,36465,36409,2020-11-19 19:35:28.349585
Punjab,5821,132266,4510,5937,132917,4541,143395,142597,2020-11-19 19:35:28.349585
Rajasthan,19033,209058,2089,19478,210779,2101,232358,230180,2020-11-19 19:35:28.349585
Sikkim,312,4144,92,300,4182,95,4577,4548,2020-11-19 19:35:28.349585
Tamil Nadu,15085,734970,11513,14470,737281,11531,763282,761568,2020-11-19 19:35:28.349585
Telengana,13068,245293,1415,12682,246733,1419,260834,259776,2020-11-19 19:35:28.349585
Tripura,998,30750,364,997,30856,364,32217,32112,2020-11-19 19:35:28.349585
Uttarakhand,4165,63603,1119,4147,64032,1128,69307,68887,2020-11-19 19:35:28.349585
Uttar Pradesh,22166,484692,7412,21954,487221,7441,516616,514270,2020-11-19 19:35:28.349585
West Bengal,27111,403340,7766,26296,407769,7820,441885,438217,2020-11-19 19:35:28.349585
Andaman and Nicobar Islands,154,4378,61,145,4398,61,4604,4593,2020-11-20 20:33:00.104992
Andhra Pradesh,16516,833980,6899,16000,835801,6910,858711,857395,2020-11-20 20:33:00.104992
Arunachal Pradesh,1182,14715,48,1127,14800,49,15976,15945,2020-11-20 20:33:00.104992
Assam,3285,206611,969,3193,206878,969,211040,210865,2020-11-20 20:33:00.104992
Bihar,5349,221272,1201,5378,221924,1209,228511,227822,2020-11-20 20:33:00.104992
Chandigarh,1081,14833,253,1105,14963,254,16322,16167,2020-11-20 20:33:00.104992
Chhattisgarh,18770,193997,2646,19421,195469,2672,217562,215413,2020-11-20 20:33:00.104992
Dadra and Nagar Haveli and Daman and Diu,29,3274,2,31,3274,2,3307,3305,2020-11-20 20:33:00.104992
Delhi,42458,452683,7943,43221,459368,8041,510630,503084,2020-11-20 20:33:00.104992
Goa,1364,44310,670,1343,44467,670,46480,46344,2020-11-20 20:33:00.104992
Gujarat,12457,175362,3823,12677,176475,3830,192982,191642,2020-11-20 20:33:00.104992
Haryana,19543,185403,2093,19579,187559,2113,209251,207039,2020-11-20 20:33:00.104992
Himachal Pradesh,6901,24025,475,6980,24729,488,32197,31401,2020-11-20 20:33:00.104992
Jammu and Kashmir,5570,96972,1613,5560,97537,1618,104715,104155,2020-11-20 20:33:00.104992
Jharkhand,2637,103171,934,2600,103435,937,106972,106742,2020-11-20 20:33:00.104992
Karnataka,25165,829188,11578,25188,830988,11604,867780,865931,2020-11-20 20:33:00.104992
Kerala,69516,468460,1943,68352,475320,1969,545641,539919,2020-11-20 20:33:00.104992
Ladakh,924,6605,94,1000,6619,95,7714,7623,2020-11-20 20:33:00.104992
Lakshadweep,0,0,0,0,0,0,0,0,2020-11-20 20:33:00.104992
Madhya Pradesh,9338,174202,3115,9800,175089,3129,188018,186655,2020-11-20 20:33:00.104992
Maharashtra,81207,1630111,46202,80728,1635971,46356,1763055,1757520,2020-11-20 20:33:00.104992
Manipur,2828,19259,231,2886,19431,231,22548,22318,2020-11-20 20:33:00.104992
Meghalaya,753,10014,103,801,10074,104,10979,10870,2020-11-20 20:33:00.104992
Mizoram,487,3021,5,511,3025,5,3541,3513,2020-11-20 20:33:00.104992
Nagaland,1255,9057,54,1296,9110,54,10460,10366,2020-11-20 20:33:00.104992
Odisha,7568,301777,1575,7400,302796,1592,311788,310920,2020-11-20 20:33:00.104992
Puducherry,705,35152,608,670,35254,609,36533,36465,2020-11-20 20:33:00.104992
Punjab,5937,132917,4541,6194,133427,4556,144177,143395,2020-11-20 20:33:00.104992
Rajasthan,19478,210779,2101,20168,212623,2116,234907,232358,2020-11-20 20:33:00.104992
Sikkim,300,4182,95,296,4218,95,4609,4577,2020-11-20 20:33:00.104992
Tamil Nadu,14470,737281,11531,13907,739532,11550,764989,763282,2020-11-20 20:33:00.104992
Telengana,12682,246733,1419,12515,247790,1423,261728,260834,2020-11-20 20:33:00.104992
Tripura,997,30856,364,959,30968,365,32292,32217,2020-11-20 20:33:00.104992
Uttarakhand,4147,64032,1128,4133,64427,1133,69693,69307,2020-11-20 20:33:00.104992
Uttar Pradesh,21954,487221,7441,22757,488911,7480,519148,516616,2020-11-20 20:33:00.104992
West Bengal,26296,407769,7820,25873,411759,7873,445505,441885,2020-11-20 20:33:00.104992
Andaman and Nicobar Islands,145,4398,61,148,4408,61,4617,4604,2020-11-21 20:01:10.602931
Andhra Pradesh,16000,835801,6910,15382,837630,6920,859932,858711,2020-11-21 20:01:10.602931
Arunachal Pradesh,1127,14800,49,1082,14870,49,16001,15976,2020-11-21 20:01:10.602931
Assam,3193,206878,969,3204,207029,971,211204,211040,2020-11-21 20:01:10.602931
Bihar,5378,221924,1209,5254,222420,1212,228886,228511,2020-11-21 20:01:10.602931
Chandigarh,1105,14963,254,1121,15096,255,16472,16322,2020-11-21 20:01:10.602931
Chhattisgarh,19421,195469,2672,19817,196896,2691,219404,217562,2020-11-21 20:01:10.602931
Dadra and Nagar Haveli and Daman and Diu,31,3274,2,39,3275,2,3316,3307,2020-11-21 20:01:10.602931
Delhi,43221,459368,8041,40936,468143,8159,517238,510630,2020-11-21 20:01:10.602931
Goa,1343,44467,670,1295,44665,672,46632,46480,2020-11-21 20:01:10.602931
Gujarat,12677,176475,3830,13050,177515,3837,194402,192982,2020-11-21 20:01:10.602931
Haryana,19579,187559,2113,20150,190067,2138,212355,209251,2020-11-21 20:01:10.602931
Himachal Pradesh,6980,24729,488,6830,25455,500,32785,32197,2020-11-21 20:01:10.602931
Jammu and Kashmir,5560,97537,1618,5678,98076,1622,105376,104715,2020-11-21 20:01:10.602931
Jharkhand,2600,103435,937,2594,103624,939,107157,106972,2020-11-21 20:01:10.602931
Karnataka,25188,830988,11604,24771,833169,11621,869561,867780,2020-11-21 20:01:10.602931
Kerala,68352,475320,1969,67954,481718,1997,551669,545641,2020-11-21 20:01:10.602931
Ladakh,1000,6619,95,948,6743,96,7787,7714,2020-11-21 20:01:10.602931
Lakshadweep,0,0,0,0,0,0,0,0,2020-11-21 20:01:10.602931
Madhya Pradesh,9800,175089,3129,10402,176006,3138,189546,188018,2020-11-21 20:01:10.602931
Maharashtra,80728,1635971,46356,79268,1642916,46511,1768695,1763055,2020-11-21 20:01:10.602931
Manipur,2886,19431,231,2896,19620,232,22748,22548,2020-11-21 20:01:10.602931
Meghalaya,801,10074,104,888,10158,106,11152,10979,2020-11-21 20:01:10.602931
Mizoram,511,3025,5,491,3111,5,3607,3541,2020-11-21 20:01:10.602931
Nagaland,1296,9110,54,1344,9208,56,10608,10460,2020-11-21 20:01:10.602931
Odisha,7400,302796,1592,7040,303897,1608,312545,311788,2020-11-21 20:01:10.602931
Puducherry,670,35254,609,621,35355,609,36585,36533,2020-11-21 20:01:10.602931
Punjab,6194,133427,4556,6504,133919,4572,144995,144177,2020-11-21 20:01:10.602931
Rajasthan,20168,212623,2116,20923,214616,2130,237669,234907,2020-11-21 20:01:10.602931
Sikkim,296,4218,95,265,4271,96,4632,4609,2020-11-21 20:01:10.602931
Tamil Nadu,13907,739532,11550,13404,741705,11568,766677,764989,2020-11-21 20:01:10.602931
Telengana,12515,247790,1423,12070,249157,1426,262653,261728,2020-11-21 20:01:10.602931
Tripura,959,30968,365,917,31084,366,32367,32292,2020-11-21 20:01:10.602931
Uttarakhand,4133,64427,1133,3505,65562,1138,70205,69693,2020-11-21 20:01:10.602931
Uttar Pradesh,22757,488911,7480,23357,491131,7500,521988,519148,2020-11-21 20:01:10.602931
West Bengal,25873,411759,7873,25599,415609,7923,449131,445505,2020-11-21 20:01:10.602931
Andaman and Nicobar Islands,148,4408,61,142,4428,61,4631,4617,2020-11-22 20:00:47.391170
Andhra Pradesh,15382,837630,6920,14770,839395,6927,861092,859932,2020-11-22 20:00:47.391170
Arunachal Pradesh,1082,14870,49,1051,14937,49,16037,16001,2020-11-22 20:00:47.391170
Assam,3204,207029,971,3232,207222,973,211427,211204,2020-11-22 20:00:47.391170
Bihar,5254,222420,1212,5082,222879,1216,229177,228886,2020-11-22 20:00:47.391170
Chandigarh,1121,15096,255,1135,15198,258,16591,16472,2020-11-22 20:00:47.391170
Chhattisgarh,19817,196896,2691,20659,198316,2713,221688,219404,2020-11-22 20:00:47.391170
Dadra and Nagar Haveli and Daman and Diu,39,3275,2,39,3276,2,3317,3316,2020-11-22 20:00:47.391170
Delhi,40936,468143,8159,39741,475106,8270,523117,517238,2020-11-22 20:00:47.391170
Goa,1295,44665,672,1261,44812,675,46748,46632,2020-11-22 20:00:47.391170
Gujarat,13050,177515,3837,13285,178786,3846,195917,194402,2020-11-22 20:00:47.391170
Haryana,20150,190067,2138,20325,192533,2163,215021,212355,2020-11-22 20:00:47.391170
Himachal Pradesh,6830,25455,500,7070,26112,518,33700,32785,2020-11-22 20:00:47.391170
Jammu and Kashmir,5678,98076,1622,5720,98640,1624,105984,105376,2020-11-22 20:00:47.391170
Jharkhand,2594,103624,939,2430,103957,945,107332,107157,2020-11-22 20:00:47.391170
Karnataka,24771,833169,11621,24733,834968,11641,871342,869561,2020-11-22 20:00:47.391170
Kerala,67954,481718,1997,66982,488437,2022,557441,551669,2020-11-22 20:00:47.391170
Ladakh,948,6743,96,912,6856,98,7866,7787,2020-11-22 20:00:47.391170
Lakshadweep,0,0,0,0,0,0,0,0,2020-11-22 20:00:47.391170
Madhya Pradesh,10402,176006,3138,11192,176905,3149,191246,189546,2020-11-22 20:00:47.391170
Maharashtra,79268,1642916,46511,80878,1647004,46573,1774455,1768695,2020-11-22 20:00:47.391170
Manipur,2896,19620,232,2972,19813,233,23018,22748,2020-11-22 20:00:47.391170
Meghalaya,888,10158,106,925,10236,108,11269,11152,2020-11-22 20:00:47.391170
Mizoram,491,3111,5,485,3157,5,3647,3607,2020-11-22 20:00:47.391170
Nagaland,1344,9208,56,1375,9242,57,10674,10608,2020-11-22 20:00:47.391170
Odisha,7040,303897,1608,6790,304908,1625,313323,312545,2020-11-22 20:00:47.391170
Puducherry,621,35355,609,602,35437,609,36648,36585,2020-11-22 20:00:47.391170
Punjab,6504,133919,4572,6561,134511,4595,145667,144995,2020-11-22 20:00:47.391170
Rajasthan,20923,214616,2130,21951,216579,2146,240676,237669,2020-11-22 20:00:47.391170
Sikkim,265,4271,96,289,4304,98,4691,4632,2020-11-22 20:00:47.391170
Tamil Nadu,13404,741705,11568,12916,743838,11586,768340,766677,2020-11-22 20:00:47.391170
Telengana,12070,249157,1426,11643,250453,1430,263526,262653,2020-11-22 20:00:47.391170
Tripura,917,31084,366,870,31179,366,32415,32367,2020-11-22 20:00:47.391170
Uttarakhand,3505,65562,1138,4082,65562,1146,70790,70205,2020-11-22 20:00:47.391170
Uttar Pradesh,23357,491131,7500,23471,493228,7524,524223,521988,2020-11-22 20:00:47.391170
West Bengal,25599,415609,7923,25391,419403,7976,452770,449131,2020-11-22 20:00:47.391170
Andaman and Nicobar Islands,142,4428,61,140,4440,61,4641,4631,2020-11-23 20:03:49.985605
Andhra Pradesh,14770,839395,6927,14249,841026,6938,862213,861092,2020-11-23 20:03:49.985605
Arunachal Pradesh,1051,14937,49,1040,14972,49,16061,16037,2020-11-23 20:03:49.985605
Assam,3232,207222,973,3142,207397,974,211513,211427,2020-11-23 20:03:49.985605
Bihar,5082,222879,1216,4839,223484,1221,229544,229177,2020-11-23 20:03:49.985605
Chandigarh,1135,15198,258,1094,15317,260,16671,16591,2020-11-23 20:03:49.985605
Chhattisgarh,20659,198316,2713,21393,199311,2732,223436,221688,2020-11-23 20:03:49.985605
Dadra and Nagar Haveli and Daman and Diu,39,3276,2,39,3280,2,3321,3317,2020-11-23 20:03:49.985605
Delhi,39741,475106,8270,40212,481260,8391,529863,523117,2020-11-23 20:03:49.985605
Goa,1261,44812,675,1170,44979,677,46826,46748,2020-11-23 20:03:49.985605
Gujarat,13285,178786,3846,13600,179953,3859,197412,195917,2020-11-23 20:03:49.985605
Haryana,20325,192533,2163,20344,194768,2188,217300,215021,2020-11-23 20:03:49.985605
Himachal Pradesh,7070,26112,518,7034,26756,537,34327,33700,2020-11-23 20:03:49.985605
Jammu and Kashmir,5720,98640,1624,5700,99219,1629,106548,105984,2020-11-23 20:03:49.985605
Jharkhand,2430,103957,945,2289,104229,951,107469,107332,2020-11-23 20:03:49.985605
Karnataka,24733,834968,11641,24887,836505,11654,873046,871342,2020-11-23 20:03:49.985605
Kerala,66982,488437,2022,65982,494664,2049,562695,557441,2020-11-23 20:03:49.985605
Ladakh,912,6856,98,928,6911,100,7939,7866,2020-11-23 20:03:49.985605
Lakshadweep,0,0,0,0,0,0,0,0,2020-11-23 20:03:49.985605
Madhya Pradesh,11192,176905,3149,11765,178117,3162,193044,191246,2020-11-23 20:03:49.985605
Maharashtra,80878,1647004,46573,82521,1651064,46623,1780208,1774455,2020-11-23 20:03:49.985605
Manipur,2972,19813,233,3146,20018,236,23400,23018,2020-11-23 20:03:49.985605
Meghalaya,925,10236,108,894,10335,110,11339,11269,2020-11-23 20:03:49.985605
Mizoram,485,3157,5,463,3192,5,3660,3647,2020-11-23 20:03:49.985605
Nagaland,1375,9242,57,1410,9308,59,10777,10674,2020-11-23 20:03:49.985605
Odisha,6790,304908,1625,6508,305813,1640,313961,313323,2020-11-23 20:03:49.985605
Puducherry,602,35437,609,559,35525,609,36693,36648,2020-11-23 20:03:49.985605
Punjab,6561,134511,4595,6724,135008,4614,146346,145667,2020-11-23 20:03:49.985605
Rajasthan,21951,216579,2146,23190,218583,2163,243936,240676,2020-11-23 20:03:49.985605
Sikkim,289,4304,98,278,4345,99,4722,4691,2020-11-23 20:03:49.985605
Tamil Nadu,12916,743838,11586,12542,745848,11605,769995,768340,2020-11-23 20:03:49.985605
Telengana,11643,250453,1430,11227,251468,1433,264128,263526,2020-11-23 20:03:49.985605
Tripura,870,31179,366,796,31269,369,32434,32415,2020-11-23 20:03:49.985605
Uttarakhand,4082,65562,1146,4368,65733,1155,71256,70790,2020-11-23 20:03:49.985605
Uttar Pradesh,23471,493228,7524,23806,495415,7559,526780,524223,2020-11-23 20:03:49.985605
West Bengal,25391,419403,7976,25207,423129,8025,456361,452770,2020-11-23 20:03:49.985605
Andaman and Nicobar Islands,140,4440,61,142,4453,61,4656,4641,2020-11-24 20:00:22.098944
Andhra Pradesh,14249,841026,6938,13394,842416,6948,862758,862213,2020-11-24 20:00:22.098944
Arunachal Pradesh,1040,14972,49,1007,15036,49,16092,16061,2020-11-24 20:00:22.098944
Assam,3142,207397,974,3179,207528,975,211682,211513,2020-11-24 20:00:22.098944
Bihar,4839,223484,1221,4794,224073,1227,230094,229544,2020-11-24 20:00:22.098944
Chandigarh,1094,15317,260,1117,15389,263,16769,16671,2020-11-24 20:00:22.098944
Chhattisgarh,21393,199311,2732,21926,200825,2746,225497,223436,2020-11-24 20:00:22.098944
Dadra and Nagar Haveli and Daman and Diu,39,3280,2,40,3283,2,3325,3321,2020-11-24 20:00:22.098944
Delhi,40212,481260,8391,37329,488476,8512,534317,529863,2020-11-24 20:00:22.098944
Goa,1170,44979,677,1141,45083,677,46901,46826,2020-11-24 20:00:22.098944
Gujarat,13600,179953,3859,13836,181187,3876,198899,197412,2020-11-24 20:00:22.098944
Haryana,20344,194768,2188,20412,197335,2216,219963,217300,2020-11-24 20:00:22.098944
Himachal Pradesh,7034,26756,537,6680,27541,560,34781,34327,2020-11-24 20:00:22.098944
Jammu and Kashmir,5700,99219,1629,5431,99827,1641,106899,106548,2020-11-24 20:00:22.098944
Jharkhand,2289,104229,951,2202,104533,953,107688,107469,2020-11-24 20:00:22.098944
Karnataka,24887,836505,11654,24727,838150,11678,874555,873046,2020-11-24 20:00:22.098944
Kerala,65982,494664,2049,64292,500089,2071,566452,562695,2020-11-24 20:00:22.098944
Ladakh,928,6911,100,859,6985,101,7945,7939,2020-11-24 20:00:22.098944
Lakshadweep,0,0,0,0,0,0,0,0,2020-11-24 20:00:22.098944
Madhya Pradesh,11765,178117,3162,12336,179237,3172,194745,193044,2020-11-24 20:00:22.098944
Maharashtra,82521,1651064,46623,82915,1654793,46653,1784361,1780208,2020-11-24 20:00:22.098944
Manipur,3146,20018,236,3038,20374,238,23650,23400,2020-11-24 20:00:22.098944
Meghalaya,894,10335,110,895,10392,110,11397,11339,2020-11-24 20:00:22.098944
Mizoram,463,3192,5,502,3203,5,3710,3660,2020-11-24 20:00:22.098944
Nagaland,1410,9308,59,1444,9347,61,10852,10777,2020-11-24 20:00:22.098944
Odisha,6508,305813,1640,6246,306726,1657,314629,313961,2020-11-24 20:00:22.098944
Puducherry,559,35525,609,527,35582,609,36718,36693,2020-11-24 20:00:22.098944
Punjab,6724,135008,4614,6687,135739,4631,147057,146346,2020-11-24 20:00:22.098944
Rajasthan,23190,218583,2163,24116,220871,2181,247168,243936,2020-11-24 20:00:22.098944
Sikkim,278,4345,99,230,4406,100,4736,4722,2020-11-24 20:00:22.098944
Tamil Nadu,12542,745848,11605,12245,747752,11622,771619,769995,2020-11-24 20:00:22.098944
Telengana,11227,251468,1433,11047,252565,1437,265049,264128,2020-11-24 20:00:22.098944
Tripura,796,31269,369,827,31296,370,32493,32434,2020-11-24 20:00:22.098944
Uttarakhand,4368,65733,1155,4298,66172,1162,71632,71256,2020-11-24 20:00:22.098944
Uttar Pradesh,23806,495415,7559,23776,497475,7582,528833,526780,2020-11-24 20:00:22.098944
West Bengal,25207,423129,8025,25030,426816,8072,459918,456361,2020-11-24 20:00:22.098944
Andaman and Nicobar Islands,142,4453,61,142,4464,61,4667,4656,2020-11-25 20:08:44.954419
Andhra Pradesh,13394,842416,6948,13024,843863,6956,863843,862758,2020-11-25 20:08:44.954419
Arunachal Pradesh,1007,15036,49,1004,15091,49,16144,16092,2020-11-25 20:08:44.954419
Assam,3179,207528,975,3214,207649,976,211839,211682,2020-11-25 20:08:44.954419
Bihar,4794,224073,1227,4897,224715,1233,230845,230094,2020-11-25 20:08:44.954419
Chandigarh,1117,15389,263,1128,15455,265,16848,16769,2020-11-25 20:08:44.954419
Chhattisgarh,21926,200825,2746,22815,201744,2767,227326,225497,2020-11-25 20:08:44.954419
Dadra and Nagar Haveli and Daman and Diu,40,3283,2,37,3286,2,3325,3325,2020-11-25 20:08:44.954419
Delhi,37329,488476,8512,38501,493419,8621,540541,534317,2020-11-25 20:08:44.954419
Goa,1141,45083,677,1221,45168,679,47068,46901,2020-11-25 20:08:44.954419
Gujarat,13836,181187,3876,14044,182473,3892,200409,198899,2020-11-25 20:08:44.954419
Haryana,20412,197335,2216,20765,199278,2249,222292,219963,2020-11-25 20:08:44.954419
Himachal Pradesh,6680,27541,560,7150,28007,572,35729,34781,2020-11-25 20:08:44.954419
Jammu and Kashmir,5431,99827,1641,5357,100322,1651,107330,106899,2020-11-25 20:08:44.954419
Jharkhand,2202,104533,953,2242,104724,955,107921,107688,2020-11-25 20:08:44.954419
Karnataka,24727,838150,11678,24631,840099,11695,876425,874555,2020-11-25 20:08:44.954419
Kerala,64292,500089,2071,64539,505238,2095,571872,566452,2020-11-25 20:08:44.954419
Ladakh,859,6985,101,854,7069,105,8028,7945,2020-11-25 20:08:44.954419
Lakshadweep,0,0,0,0,0,0,0,0,2020-11-25 20:08:44.954419
Madhya Pradesh,12336,179237,3172,12979,180349,3183,196511,194745,2020-11-25 20:08:44.954419
Maharashtra,82915,1654793,46653,84238,1658879,46683,1789800,1784361,2020-11-25 20:08:44.954419
Manipur,3038,20374,238,3175,20525,240,23940,23650,2020-11-25 20:08:44.954419
Meghalaya,895,10392,110,893,10451,110,11454,11397,2020-11-25 20:08:44.954419
Mizoram,502,3203,5,442,3298,5,3745,3710,2020-11-25 20:08:44.954419
Nagaland,1444,9347,61,1473,9397,61,10931,10852,2020-11-25 20:08:44.954419
Odisha,6246,306726,1657,6226,307374,1671,315271,314629,2020-11-25 20:08:44.954419
Puducherry,527,35582,609,489,35671,609,36769,36718,2020-11-25 20:08:44.954419
Punjab,6687,135739,4631,6834,136178,4653,147665,147057,2020-11-25 20:08:44.954419
Rajasthan,24116,220871,2181,25197,223085,2200,250482,247168,2020-11-25 20:08:44.954419
Sikkim,230,4406,100,238,4437,102,4777,4736,2020-11-25 20:08:44.954419
Tamil Nadu,12245,747752,11622,11875,749662,11639,773176,771619,2020-11-25 20:08:44.954419
Telengana,11047,252565,1437,10886,253715,1441,266042,265049,2020-11-25 20:08:44.954419
Tripura,827,31296,370,790,31368,370,32528,32493,2020-11-25 20:08:44.954419
Uttarakhand,4298,66172,1162,4638,66349,1173,72160,71632,2020-11-25 20:08:44.954419
Uttar Pradesh,23776,497475,7582,23928,499507,7615,531050,528833,2020-11-25 20:08:44.954419
West Bengal,25030,426816,8072,24880,430462,8121,463463,459918,2020-11-25 20:08:44.954419
Andaman and Nicobar Islands,142,4464,61,137,4479,61,4677,4667,2020-11-26 13:20:33.745058
Andhra Pradesh,13024,843863,6956,12673,845039,6962,864674,863843,2020-11-26 13:20:33.745058
Arunachal Pradesh,1004,15091,49,968,15157,49,16174,16144,2020-11-26 13:20:33.745058
Assam,3214,207649,976,3277,207766,978,212021,211839,2020-11-26 13:20:33.745058
Bihar,4897,224715,1233,5225,225077,1237,231539,230845,2020-11-26 13:20:33.745058
Chandigarh,1128,15455,265,1127,15532,266,16925,16848,2020-11-26 13:20:33.745058
Chhattisgarh,22815,201744,2767,24676,201744,2783,229203,227326,2020-11-26 13:20:33.745058
Dadra and Nagar Haveli and Daman and Diu,37,3286,2,35,3290,2,3327,3325,2020-11-26 13:20:33.745058
Delhi,38501,493419,8621,38287,498780,8720,545787,540541,2020-11-26 13:20:33.745058
Goa,1221,45168,679,1281,45229,683,47193,47068,2020-11-26 13:20:33.745058
Gujarat,14044,182473,3892,14287,183756,3906,201949,200409,2020-11-26 13:20:33.745058
Haryana,20765,199278,2249,20948,201250,2291,224489,222292,2020-11-26 13:20:33.745058
Himachal Pradesh,7150,28007,572,7875,28106,585,36566,35729,2020-11-26 13:20:33.745058
Jammu and Kashmir,5357,100322,1651,5264,100892,1663,107819,107330,2020-11-26 13:20:33.745058
Jharkhand,2242,104724,955,2160,105040,958,108158,107921,2020-11-26 13:20:33.745058
Karnataka,24631,840099,11695,24909,841432,11714,878055,876425,2020-11-26 13:20:33.745058
Kerala,64539,505238,2095,65234,511008,2121,578363,571872,2020-11-26 13:20:33.745058
Ladakh,854,7069,105,886,7125,108,8119,8028,2020-11-26 13:20:33.745058
Lakshadweep,0,0,0,0,0,0,0,0,2020-11-26 13:20:33.745058
Madhya Pradesh,12979,180349,3183,13742,181345,3197,198284,196511,2020-11-26 13:20:33.745058
Maharashtra,84238,1658879,46683,85488,1663723,46748,1795959,1789800,2020-11-26 13:20:33.745058
Manipur,3175,20525,240,3248,20640,245,24133,23940,2020-11-26 13:20:33.745058
Meghalaya,893,10451,110,915,10488,110,11513,11454,2020-11-26 13:20:33.745058
Mizoram,442,3298,5,441,3319,5,3765,3745,2020-11-26 13:20:33.745058
Nagaland,1473,9397,61,1467,9463,61,10991,10931,2020-11-26 13:20:33.745058
Odisha,6226,307374,1671,6212,308102,1687,316001,315271,2020-11-26 13:20:33.745058
Puducherry,489,35671,609,540,35671,609,36820,36769,2020-11-26 13:20:33.745058
Punjab,6834,136178,4653,7129,136622,4684,148435,147665,2020-11-26 13:20:33.745058
Rajasthan,25197,223085,2200,26320,225229,2218,253767,250482,2020-11-26 13:20:33.745058
Sikkim,238,4437,102,236,4481,102,4819,4777,2020-11-26 13:20:33.745058
Tamil Nadu,11875,749662,11639,11520,751535,11655,774710,773176,2020-11-26 13:20:33.745058
Telengana,10886,253715,1441,10784,254676,1444,266904,266042,2020-11-26 13:20:33.745058
Tripura,790,31368,370,767,31441,370,32578,32528,2020-11-26 13:20:33.745058
Uttarakhand,4638,66349,1173,4658,66799,1185,72642,72160,2020-11-26 13:20:33.745058
Uttar Pradesh,23928,499507,7615,24876,500835,7644,533355,531050,2020-11-26 13:20:33.745058
West Bengal,24880,430462,8121,24752,434067,8172,466991,463463,2020-11-26 13:20:33.745058
Andaman and Nicobar Islands,147,4479,61,152,3469,52,3673,4677,2020-11-27 17:39:44
Andhra Pradesh,78836,845039,6962,74518,551821,5410,631749,864674,2020-11-27 17:39:44
Arunachal Pradesh,1964,15157,49,1939,5643,13,7595,16174,2020-11-27 17:39:44
Assam,28780,207766,978,29609,129133,578,159320,212021,2020-11-27 17:39:44
Bihar,13005,225077,1237,12539,156242,870,169651,231539,2020-11-27 17:39:44
Chandigarh,2821,15532,266,2761,7411,126,10298,16925,2020-11-27 17:39:44
Chhattisgarh,37853,201744,2783,37927,49564,690,88181,229203,2020-11-27 17:39:44
Dadra and Nagar Haveli and Daman and Diu,229,3290,2,220,2711,2,2933,3327,2020-11-27 17:39:44
Delhi,32097,498780,8720,30941,213304,5014,249259,545787,2020-11-27 17:39:44
Goa,5781,45229,683,5667,22726,360,28753,47193,2020-11-27 17:39:44
Gujarat,16208,183756,3906,16305,104964,3336,124605,201949,2020-11-27 17:39:44
Haryana,21411,201250,2291,21014,90884,1177,113075,224489,2020-11-27 17:39:44
Himachal Pradesh,4444,28106,585,4458,7853,127,12438,36566,2020-11-27 17:39:44
Jammu and Kashmir,22032,100892,1663,21887,42115,1024,65026,107819,2020-11-27 17:39:44
Jharkhand,13791,105040,958,13504,58543,626,72673,108158,2020-11-27 17:39:44
Karnataka,98062,841432,11714,95354,423377,8145,526876,878055,2020-11-27 17:39:44
Kerala,39484,511008,2121,39354,98724,553,138631,578363,2020-11-27 17:39:44
Ladakh,1013,7125,108,1047,2735,50,3832,8119,2020-11-27 17:39:44
Lakshadweep,0,0,0,0,0,0,0,0,2020-11-27 17:39:44
Madhya Pradesh,22300,181345,3197,22542,83618,2007,108167,198284,2020-11-27 17:39:44
Maharashtra,291630,1663723,46748,275017,916348,33015,1224380,1795959,2020-11-27 17:39:44
Manipur,2070,20640,245,2113,6838,59,9010,24133,2020-11-27 17:39:44
Meghalaya,2111,10488,110,2169,2527,37,4733,11513,2020-11-27 17:39:44
Mizoram,583,3319,5,680,1012,0,1692,3765,2020-11-27 17:39:44
Nagaland,1184,9463,61,1052,4477,15,5544,10991,2020-11-27 17:39:44
Odisha,33504,308102,1687,34033,149379,710,184122,316001,2020-11-27 17:39:44
Puducherry,4908,35671,609,4659,18065,467,23191,36820,2020-11-27 17:39:44
Punjab,22278,136622,4684,21661,75409,2860,99930,148435,2020-11-27 17:39:44
Rajasthan,18184,225229,2218,18245,97284,1352,116881,253767,2020-11-27 17:39:44
Sikkim,469,4481,102,513,1986,29,2528,4819,2020-11-27 17:39:44
Tamil Nadu,46703,751535,11655,46495,491971,8871,547337,774710,2020-11-27 17:39:44
Telengana,29636,254676,1444,29649,144073,1052,174774,266904,2020-11-27 17:39:44
Tripura,6566,31441,370,6700,15883,251,22834,32578,2020-11-27 17:39:44
Uttarakhand,12455,500835,7644,12075,29201,501,41777,533355,2020-11-27 17:39:44
Uttar Pradesh,65954,66799,1185,64164,289594,5135,358893,72642,2020-11-27 17:39:44
West Bengal,24806,434067,8172,24898,198983,4421,228302,466991,2020-11-27 17:39:44
Andaman and Nicobar Islands,130,4491,61,120,4508,61,4689,4682,2020-11-28 22:59:13.845765
Andhra Pradesh,12615,846120,6970,12137,847325,6976,866438,865705,2020-11-28 22:59:13.845765
Arunachal Pradesh,926,15229,49,911,15270,50,16231,16204,2020-11-28 22:59:13.845765
Assam,3285,207908,978,3272,208068,980,212320,212171,2020-11-28 22:59:13.845765
Bihar,5390,225602,1243,5401,226267,1248,232916,232235,2020-11-28 22:59:13.845765
Chandigarh,1169,15612,270,1190,15697,270,17157,17051,2020-11-28 22:59:13.845765
Chhattisgarh,23957,204198,2801,21839,208183,2813,232835,230956,2020-11-28 22:59:13.845765
Dadra and Nagar Haveli and Daman and Diu,33,3293,2,27,3301,2,3330,3328,2020-11-28 22:59:13.845765
Delhi,38734,503717,8811,38181,509654,8909,556744,551262,2020-11-28 22:59:13.845765
Goa,1316,45340,685,1313,45492,686,47491,47341,2020-11-28 22:59:13.845765
Gujarat,14529,185058,3922,14732,186446,3938,205116,203509,2020-11-28 22:59:13.845765
Haryana,20778,203517,2316,20400,206001,2345,228746,226611,2020-11-28 22:59:13.845765
Himachal Pradesh,7878,29020,599,8205,29510,612,38327,37497,2020-11-28 22:59:13.845765
Jammu and Kashmir,5275,101363,1668,5236,101959,1676,108871,108306,2020-11-28 22:59:13.845765
Jharkhand,2169,105258,961,2162,105453,962,108577,108388,2020-11-28 22:59:13.845765
Karnataka,25335,842499,11726,25398,843950,11738,881086,879560,2020-11-28 22:59:13.845765
Kerala,64615,516978,2148,64014,521522,2171,587707,583741,2020-11-28 22:59:13.845765
Ladakh,961,7154,113,904,7254,114,8272,8228,2020-11-28 22:59:13.845765
Lakshadweep,0,0,0,0,0,0,0,0,2020-11-28 22:59:13.845765
Madhya Pradesh,14199,182544,3209,14677,183696,3224,201597,199952,2020-11-28 22:59:13.845765
Maharashtra,87014,1668538,46813,89025,1672627,46898,1808550,1802365,2020-11-28 22:59:13.845765
Manipur,3245,20798,249,3252,21006,256,24514,24292,2020-11-28 22:59:13.845765
Meghalaya,947,10524,110,917,10606,110,11633,11581,2020-11-28 22:59:13.845765
Mizoram,431,3352,5,434,3367,5,3806,3788,2020-11-28 22:59:13.845765
Nagaland,1402,9595,63,1222,9805,64,11091,11060,2020-11-28 22:59:13.845765
Odisha,6102,308839,1704,5774,309747,1718,317239,316645,2020-11-28 22:59:13.845765
Puducherry,544,35687,609,514,35733,609,36856,36840,2020-11-28 22:59:13.845765
Punjab,7479,137089,4710,7719,137630,4737,150086,149278,2020-11-28 22:59:13.845765
Rajasthan,27302,227408,2237,28183,229602,2255,260040,256947,2020-11-28 22:59:13.845765
Sikkim,268,4501,102,264,4541,103,4908,4871,2020-11-28 22:59:13.845765
Tamil Nadu,11173,753332,11669,11109,754826,11681,777616,776174,2020-11-28 22:59:13.845765
Telengana,10839,255378,1448,10637,256330,1451,268418,267665,2020-11-28 22:59:13.845765
Tripura,741,31499,370,703,31568,370,32641,32610,2020-11-28 22:59:13.845765
Uttarakhand,4682,67119,1196,4812,67514,1201,73527,72997,2020-11-28 22:59:13.845765
Uttar Pradesh,25422,502353,7674,25639,504411,7697,537747,535449,2020-11-28 22:59:13.845765
West Bengal,24670,437604,8224,24617,441100,8270,473987,470498,2020-11-28 22:59:13.845765
Andaman and Nicobar Islands,147,4508,61,152,3469,52,3673,4689,2020-11-29 17:39:44
Andhra Pradesh,78836,847325,6976,74518,551821,5410,631749,866438,2020-11-29 17:39:44
Arunachal Pradesh,1964,15270,50,1939,5643,13,7595,16231,2020-11-29 17:39:44
Assam,28780,208068,980,29609,129133,578,159320,212320,2020-11-29 17:39:44
Bihar,13005,226267,1248,12539,156242,870,169651,232916,2020-11-29 17:39:44
Chandigarh,2821,15697,270,2761,7411,126,10298,17157,2020-11-29 17:39:44
Chhattisgarh,37853,208183,2813,37927,49564,690,88181,232835,2020-11-29 17:39:44
Dadra and Nagar Haveli and Daman and Diu,229,3301,2,220,2711,2,2933,3330,2020-11-29 17:39:44
Delhi,32097,509654,8909,30941,213304,5014,249259,556744,2020-11-29 17:39:44
Goa,5781,45492,686,5667,22726,360,28753,47491,2020-11-29 17:39:44
Gujarat,16208,186446,3938,16305,104964,3336,124605,205116,2020-11-29 17:39:44
Haryana,21411,206001,2345,21014,90884,1177,113075,228746,2020-11-29 17:39:44
Himachal Pradesh,4444,29510,612,4458,7853,127,12438,38327,2020-11-29 17:39:44
Jammu and Kashmir,22032,101959,1676,21887,42115,1024,65026,108871,2020-11-29 17:39:44
Jharkhand,13791,105453,962,13504,58543,626,72673,108577,2020-11-29 17:39:44
Karnataka,98062,843950,11738,95354,423377,8145,526876,881086,2020-11-29 17:39:44
Kerala,39484,521522,2171,39354,98724,553,138631,587707,2020-11-29 17:39:44
Ladakh,1013,7254,114,1047,2735,50,3832,8272,2020-11-29 17:39:44
Lakshadweep,0,0,0,0,0,0,0,0,2020-11-29 17:39:44
Madhya Pradesh,22300,183696,3224,22542,83618,2007,108167,201597,2020-11-29 17:39:44
Maharashtra,291630,1672627,46898,275017,916348,33015,1224380,1808550,2020-11-29 17:39:44
Manipur,2070,21006,256,2113,6838,59,9010,24514,2020-11-29 17:39:44
Meghalaya,2111,10606,110,2169,2527,37,4733,11633,2020-11-29 17:39:44
Mizoram,583,3367,5,680,1012,0,1692,3806,2020-11-29 17:39:44
Nagaland,1184,9805,64,1052,4477,15,5544,11091,2020-11-29 17:39:44
Odisha,33504,309747,1718,34033,149379,710,184122,317239,2020-11-29 17:39:44
Puducherry,4908,35733,609,4659,18065,467,23191,36856,2020-11-29 17:39:44
Punjab,22278,137630,4737,21661,75409,2860,99930,150086,2020-11-29 17:39:44
Rajasthan,18184,229602,2255,18245,97284,1352,116881,260040,2020-11-29 17:39:44
Sikkim,469,4541,103,513,1986,29,2528,4908,2020-11-29 17:39:44
Tamil Nadu,46703,754826,11681,46495,491971,8871,547337,777616,2020-11-29 17:39:44
Telengana,29636,256330,1451,29649,144073,1052,174774,268418,2020-11-29 17:39:44
Tripura,6566,31568,370,6700,15883,251,22834,32641,2020-11-29 17:39:44
Uttarakhand,12455,504411,7697,12075,29201,501,41777,537747,2020-11-29 17:39:44
Uttar Pradesh,65954,67514,1201,64164,289594,5135,358893,73527,2020-11-29 17:39:44
West Bengal,24806,441100,8270,24898,198983,4421,228302,473987,2020-11-29 17:39:44
Andaman and Nicobar Islands,119,4518,61,106,4537,61,4704,4698,2020-11-30 20:43:55.186313
Andhra Pradesh,11571,848511,6981,8397,852298,6988,867683,867063,2020-11-30 20:43:55.186313
Arunachal Pradesh,888,15323,51,851,15364,54,16269,16262,2020-11-30 20:43:55.186313
Assam,3313,208190,980,3350,208286,981,212617,212483,2020-11-30 20:43:55.186313
Bihar,5380,226939,1253,5404,227456,1259,234119,233572,2020-11-30 20:43:55.186313
Chandigarh,1115,15857,274,1140,15926,276,17342,17246,2020-11-30 20:43:55.186313
Chhattisgarh,20978,210917,2830,20641,212517,2840,235998,234725,2020-11-30 20:43:55.186313
Dadra and Nagar Haveli and Daman and Diu,23,3305,2,22,3308,2,3332,3330,2020-11-30 20:43:55.186313
Delhi,36578,516166,8998,35091,522491,9066,566648,561742,2020-11-30 20:43:55.186313
Goa,1348,45655,686,1327,45790,687,47804,47689,2020-11-30 20:43:55.186313
Gujarat,14792,187969,3953,14889,189420,3969,208278,206714,2020-11-30 20:43:55.186313
Haryana,19916,208422,2375,18905,211216,2401,232522,230713,2020-11-30 20:43:55.186313
Himachal Pradesh,8574,29780,623,8644,30724,635,40003,38977,2020-11-30 20:43:55.186313
Jammu and Kashmir,5112,102591,1680,5087,103082,1685,109854,109383,2020-11-30 20:43:55.186313
Jharkhand,2154,105669,963,2138,105883,963,108984,108786,2020-11-30 20:43:55.186313
Karnataka,24776,846082,11750,24522,847612,11765,883899,882608,2020-11-30 20:43:55.186313
Kerala,64964,526797,2196,64719,532658,2223,599600,593957,2020-11-30 20:43:55.186313
Ladakh,885,7327,116,878,7409,116,8403,8328,2020-11-30 20:43:55.186313
Lakshadweep,0,0,0,0,0,0,0,0,2020-11-30 20:43:55.186313
Madhya Pradesh,14981,185013,3237,14974,186521,3250,204745,203231,2020-11-30 20:43:55.186313
Maharashtra,90965,1676564,46986,92062,1680926,47071,1820059,1814515,2020-11-30 20:43:55.186313
Manipur,3283,21203,263,3236,21401,273,24910,24749,2020-11-30 20:43:55.186313
Meghalaya,858,10735,111,768,10861,111,11740,11704,2020-11-30 20:43:55.186313
Mizoram,392,3425,5,381,3440,5,3826,3822,2020-11-30 20:43:55.186313
Nagaland,1221,9830,64,1090,10005,64,11159,11115,2020-11-30 20:43:55.186313
Odisha,5510,310549,1730,5317,311256,1734,318307,317789,2020-11-30 20:43:55.186313
Puducherry,519,35774,609,480,35846,609,36935,36902,2020-11-30 20:43:55.186313
Punjab,7834,138206,4765,7888,138870,4780,151538,150805,2020-11-30 20:43:55.186313
Rajasthan,28751,231780,2274,28758,234336,2292,265386,262805,2020-11-30 20:43:55.186313
Sikkim,288,4572,107,268,4609,108,4985,4967,2020-11-30 20:43:55.186313
Tamil Nadu,11073,756279,11694,11052,757750,11703,780505,779046,2020-11-30 20:43:55.186313
Telengana,10490,257278,1455,10022,258336,1458,269816,269223,2020-11-30 20:43:55.186313
Tripura,649,31655,370,595,31730,370,32695,32674,2020-11-30 20:43:55.186313
Uttarakhand,4876,67861,1214,4970,68148,1222,74340,73951,2020-11-30 20:43:55.186313
Uttar Pradesh,25243,506938,7718,24575,509556,7742,541873,539899,2020-11-30 20:43:55.186313
West Bengal,24537,444587,8322,24405,448032,8376,480813,477446,2020-11-30 20:43:55.186313
Andaman and Nicobar Islands,106,4537,61,99,4550,61,4710,4704,2020-12-01 20:23:02.917547
Andhra Pradesh,8397,852298,6988,7840,853232,6992,868064,867683,2020-12-01 20:23:02.917547
Arunachal Pradesh,851,15364,54,817,15411,54,16282,16269,2020-12-01 20:23:02.917547
Assam,3350,208286,981,3399,208396,981,212776,212617,2020-12-01 20:23:02.917547
Bihar,5404,227456,1259,5359,227987,1264,234610,234119,2020-12-01 20:23:02.917547
Chandigarh,1140,15926,276,1062,16070,277,17409,17342,2020-12-01 20:23:02.917547
Chhattisgarh,20641,212517,2840,19635,214826,2861,237322,235998,2020-12-01 20:23:02.917547
Dadra and Nagar Haveli and Daman and Diu,22,3308,2,16,3314,2,3332,3332,2020-12-01 20:23:02.917547
Delhi,35091,522491,9066,32885,528315,9174,570374,566648,2020-12-01 20:23:02.917547
Goa,1327,45790,687,1335,45940,688,47963,47804,2020-12-01 20:23:02.917547
Gujarat,14889,189420,3969,14970,190821,3989,209780,208278,2020-12-01 20:23:02.917547
Haryana,18905,211216,2401,18362,213336,2428,234126,232522,2020-12-01 20:23:02.917547
Himachal Pradesh,8644,30724,635,8289,31584,645,40518,40003,2020-12-01 20:23:02.917547
Jammu and Kashmir,5087,103082,1685,4965,103565,1694,110224,109854,2020-12-01 20:23:02.917547
Jharkhand,2138,105883,963,2016,106171,964,109151,108984,2020-12-01 20:23:02.917547
Karnataka,24522,847612,11765,23298,849821,11778,884897,883899,2020-12-01 20:23:02.917547
Kerala,64719,532658,2223,62025,538713,2244,602982,599600,2020-12-01 20:23:02.917547
Ladakh,878,7409,116,809,7489,117,8415,8403,2020-12-01 20:23:02.917547
Lakshadweep,0,0,0,0,0,0,0,0,2020-12-01 20:23:02.917547
Madhya Pradesh,14974,186521,3250,14771,188097,3260,206128,204745,2020-12-01 20:23:02.917547
Maharashtra,92062,1680926,47071,91623,1685122,47151,1823896,1820059,2020-12-01 20:23:02.917547
Manipur,3236,21401,273,3198,21566,281,25045,24910,2020-12-01 20:23:02.917547
Meghalaya,768,10861,111,763,10936,111,11810,11740,2020-12-01 20:23:02.917547
Mizoram,381,3440,5,343,3499,5,3847,3826,2020-12-01 20:23:02.917547
Nagaland,1090,10005,64,928,10194,64,11186,11159,2020-12-01 20:23:02.917547
Odisha,5317,311256,1734,4921,312065,1739,318725,318307,2020-12-01 20:23:02.917547
Puducherry,480,35846,609,460,35898,610,36968,36935,2020-12-01 20:23:02.917547
Punjab,7888,138870,4780,7842,139442,4807,152091,151538,2020-12-01 20:23:02.917547
Rajasthan,28758,234336,2292,28653,237098,2312,268063,265386,2020-12-01 20:23:02.917547
Sikkim,268,4609,108,248,4632,109,4989,4985,2020-12-01 20:23:02.917547
Tamil Nadu,11052,757750,11703,10997,759206,11712,781915,780505,2020-12-01 20:23:02.917547
Telengana,10022,258336,1458,9627,259230,1461,270318,269816,2020-12-01 20:23:02.917547
Tripura,595,31730,370,592,31764,370,32726,32695,2020-12-01 20:23:02.917547
Uttarakhand,4970,68148,1222,5059,68505,1231,74795,74340,2020-12-01 20:23:02.917547
Uttar Pradesh,24575,509556,7742,24099,512028,7761,543888,541873,2020-12-01 20:23:02.917547
West Bengal,24405,448032,8376,24298,450762,8424,483484,480813,2020-12-01 20:23:02.917547
Andaman and Nicobar Islands,147,4550,61,152,3469,52,3673,4710,2020-12-02 17:39:44
Andhra Pradesh,78836,853232,6992,74518,551821,5410,631749,868064,2020-12-02 17:39:44
Arunachal Pradesh,1964,15411,54,1939,5643,13,7595,16282,2020-12-02 17:39:44
Assam,28780,208396,981,29609,129133,578,159320,212776,2020-12-02 17:39:44
Bihar,13005,227987,1264,12539,156242,870,169651,234610,2020-12-02 17:39:44
Chandigarh,2821,16070,277,2761,7411,126,10298,17409,2020-12-02 17:39:44
Chhattisgarh,37853,214826,2861,37927,49564,690,88181,237322,2020-12-02 17:39:44
Dadra and Nagar Haveli and Daman and Diu,229,3314,2,220,2711,2,2933,3332,2020-12-02 17:39:44
Delhi,32097,528315,9174,30941,213304,5014,249259,570374,2020-12-02 17:39:44
Goa,5781,45940,688,5667,22726,360,28753,47963,2020-12-02 17:39:44
Gujarat,16208,190821,3989,16305,104964,3336,124605,209780,2020-12-02 17:39:44
Haryana,21411,213336,2428,21014,90884,1177,113075,234126,2020-12-02 17:39:44
Himachal Pradesh,4444,31584,645,4458,7853,127,12438,40518,2020-12-02 17:39:44
Jammu and Kashmir,22032,103565,1694,21887,42115,1024,65026,110224,2020-12-02 17:39:44
Jharkhand,13791,106171,964,13504,58543,626,72673,109151,2020-12-02 17:39:44
Karnataka,98062,849821,11778,95354,423377,8145,526876,884897,2020-12-02 17:39:44
Kerala,39484,538713,2244,39354,98724,553,138631,602982,2020-12-02 17:39:44
Ladakh,1013,7489,117,1047,2735,50,3832,8415,2020-12-02 17:39:44
Lakshadweep,0,0,0,0,0,0,0,0,2020-12-02 17:39:44
Madhya Pradesh,22300,188097,3260,22542,83618,2007,108167,206128,2020-12-02 17:39:44
Maharashtra,291630,1685122,47151,275017,916348,33015,1224380,1823896,2020-12-02 17:39:44
Manipur,2070,21566,281,2113,6838,59,9010,25045,2020-12-02 17:39:44
Meghalaya,2111,10936,111,2169,2527,37,4733,11810,2020-12-02 17:39:44
Mizoram,583,3499,5,680,1012,0,1692,3847,2020-12-02 17:39:44
Nagaland,1184,10194,64,1052,4477,15,5544,11186,2020-12-02 17:39:44
Odisha,33504,312065,1739,34033,149379,710,184122,318725,2020-12-02 17:39:44
Puducherry,4908,35898,610,4659,18065,467,23191,36968,2020-12-02 17:39:44
Punjab,22278,139442,4807,21661,75409,2860,99930,152091,2020-12-02 17:39:44
Rajasthan,18184,237098,2312,18245,97284,1352,116881,268063,2020-12-02 17:39:44
Sikkim,469,4632,109,513,1986,29,2528,4989,2020-12-02 17:39:44
Tamil Nadu,46703,759206,11712,46495,491971,8871,547337,781915,2020-12-02 17:39:44
Telengana,29636,259230,1461,29649,144073,1052,174774,270318,2020-12-02 17:39:44
Tripura,6566,31764,370,6700,15883,251,22834,32726,2020-12-02 17:39:44
Uttarakhand,12455,512028,7761,12075,29201,501,41777,543888,2020-12-02 17:39:44
Uttar Pradesh,65954,68505,1231,64164,289594,5135,358893,74795,2020-12-02 17:39:44
West Bengal,24806,450762,8424,24898,198983,4421,228302,483484,2020-12-02 17:39:44
Andaman and Nicobar Islands,91,4566,61,79,4583,61,4723,4718,2020-12-03 20:00:16.199081
Andhra Pradesh,7427,854326,6996,6924,855485,7003,869412,868749,2020-12-03 20:00:16.199081
Arunachal Pradesh,786,15456,54,778,15488,54,16320,16296,2020-12-03 20:00:16.199081
Assam,3486,208531,981,3519,208669,983,213171,212998,2020-12-03 20:00:16.199081
Bihar,5568,228316,1268,5768,228797,1274,235839,235152,2020-12-03 20:00:16.199081
Chandigarh,1086,16173,278,1082,16279,281,17642,17537,2020-12-03 20:00:16.199081
Chhattisgarh,19333,216990,2892,19749,218195,2919,240863,239215,2020-12-03 20:00:16.199081
Dadra and Nagar Haveli and Daman and Diu,15,3317,2,16,3322,2,3340,3334,2020-12-03 20:00:16.199081
Delhi,31769,533351,9260,30302,538680,9342,578324,574380,2020-12-03 20:00:16.199081
Goa,1366,46068,690,1416,46132,693,48241,48124,2020-12-03 20:00:16.199081
Gujarat,14885,192368,4004,14813,193938,4018,212769,211257,2020-12-03 20:00:16.199081
Haryana,17744,215797,2456,16673,218443,2488,237604,235997,2020-12-03 20:00:16.199081
Himachal Pradesh,8218,32343,666,7813,33370,677,41860,41227,2020-12-03 20:00:16.199081
Jammu and Kashmir,4908,104068,1702,4951,104471,1708,111130,110678,2020-12-03 20:00:16.199081
Jharkhand,1965,106398,969,1907,106660,971,109538,109332,2020-12-03 20:00:16.199081
Karnataka,23728,850707,11792,24169,851690,11808,887667,886227,2020-12-03 20:00:16.199081
Kerala,61223,544864,2270,61587,550788,2298,614673,608357,2020-12-03 20:00:16.199081
Ladakh,793,7565,119,862,7642,119,8623,8477,2020-12-03 20:00:16.199081
Lakshadweep,0,0,0,0,0,0,0,0,2020-12-03 20:00:16.199081
Madhya Pradesh,14435,189780,3270,14019,191618,3287,208924,207485,2020-12-03 20:00:16.199081
Maharashtra,90168,1691412,47246,89611,1695208,47357,1832176,1828826,2020-12-03 20:00:16.199081
Manipur,3236,21718,289,3162,21937,291,25390,25243,2020-12-03 20:00:16.199081
Meghalaya,669,11094,112,686,11154,114,11954,11875,2020-12-03 20:00:16.199081
Mizoram,291,3572,6,291,3584,6,3881,3869,2020-12-03 20:00:16.199081
Nagaland,843,10302,64,723,10467,64,11254,11209,2020-12-03 20:00:16.199081
Odisha,4625,312734,1744,4439,313394,1750,319583,319103,2020-12-03 20:00:16.199081
Puducherry,439,35970,611,432,36035,612,37079,37020,2020-12-03 20:00:16.199081
Punjab,7634,140254,4821,7694,140772,4842,153308,152709,2020-12-03 20:00:16.199081
Rajasthan,27974,240105,2331,26710,243340,2350,272400,270410,2020-12-03 20:00:16.199081
Sikkim,284,4637,110,300,4661,111,5072,5031,2020-12-03 20:00:16.199081
Tamil Nadu,10980,760617,11722,10999,762015,11733,784747,783319,2020-12-03 20:00:16.199081
Telengana,9266,260155,1462,8999,261028,1465,271492,270883,2020-12-03 20:00:16.199081
Tripura,571,31821,372,552,31879,372,32803,32764,2020-12-03 20:00:16.199081
Uttarakhand,4947,69083,1238,4955,69578,1251,75784,75268,2020-12-03 20:00:16.199081
Uttar Pradesh,23670,514087,7788,22797,516694,7817,547308,545545,2020-12-03 20:00:16.199081
West Bengal,24221,454102,8476,24166,457377,8527,490070,486799,2020-12-03 20:00:16.199081
Andaman and Nicobar Islands,79,4583,61,71,4597,61,4729,4723,2020-12-04 20:24:48.555613
Andhra Pradesh,6924,855485,7003,6742,856320,7014,870076,869412,2020-12-04 20:24:48.555613
Arunachal Pradesh,778,15488,54,769,15525,54,16348,16320,2020-12-04 20:24:48.555613
Assam,3519,208669,983,3505,208846,985,213336,213171,2020-12-04 20:24:48.555613
Bihar,5768,228797,1274,5890,229249,1281,236420,235839,2020-12-04 20:24:48.555613
Chandigarh,1082,16279,281,981,16452,284,17717,17642,2020-12-04 20:24:48.555613
Chhattisgarh,19749,218195,2919,19300,220177,2941,242418,240863,2020-12-04 20:24:48.555613
Dadra and Nagar Haveli and Daman and Diu,16,3322,2,14,3324,2,3340,3340,2020-12-04 20:24:48.555613
Delhi,30302,538680,9342,29120,543514,9424,582058,578324,2020-12-04 20:24:48.555613
Goa,1416,46132,693,1418,46251,696,48365,48241,2020-12-04 20:24:48.555613
Gujarat,14813,193938,4018,14913,195365,4031,214309,212769,2020-12-04 20:24:48.555613
Haryana,16673,218443,2488,15516,221203,2520,239239,237604,2020-12-04 20:24:48.555613
Himachal Pradesh,7813,33370,677,8088,33914,695,42697,41860,2020-12-04 20:24:48.555613
Jammu and Kashmir,4951,104471,1708,5104,104890,1718,111712,111130,2020-12-04 20:24:48.555613
Jharkhand,1907,106660,971,1926,106868,977,109771,109538,2020-12-04 20:24:48.555613
Karnataka,24169,851690,11808,24708,852584,11821,889113,887667,2020-12-04 20:24:48.555613
Kerala,61587,550788,2298,61342,556378,2329,620049,614673,2020-12-04 20:24:48.555613
Ladakh,862,7642,119,859,7713,119,8691,8623,2020-12-04 20:24:48.555613
Lakshadweep,0,0,0,0,0,0,0,0,2020-12-04 20:24:48.555613
Madhya Pradesh,14019,191618,3287,13887,193187,3300,210374,208924,2020-12-04 20:24:48.555613
Maharashtra,89611,1695208,47357,86612,1703274,47472,1837358,1832176,2020-12-04 20:24:48.555613
Manipur,3162,21937,291,3070,22172,294,25536,25390,2020-12-04 20:24:48.555613
Meghalaya,686,11154,114,648,11241,116,12005,11954,2020-12-04 20:24:48.555613
Mizoram,291,3584,6,235,3647,6,3888,3881,2020-12-04 20:24:48.555613
Nagaland,723,10467,64,699,10520,64,11283,11254,2020-12-04 20:24:48.555613
Odisha,4439,313394,1750,4239,314023,1755,320017,319583,2020-12-04 20:24:48.555613
Puducherry,432,36035,612,444,36062,613,37119,37079,2020-12-04 20:24:48.555613
Punjab,7694,140772,4842,7724,141478,4862,154064,153308,2020-12-04 20:24:48.555613
Rajasthan,26710,243340,2350,25544,246572,2370,274486,272400,2020-12-04 20:24:48.555613
Sikkim,300,4661,111,320,4669,111,5100,5072,2020-12-04 20:24:48.555613
Tamil Nadu,10999,762015,11733,10988,763428,11747,786163,784747,2020-12-04 20:24:48.555613
Telengana,8999,261028,1465,8826,261830,1467,272123,271492,2020-12-04 20:24:48.555613
Tripura,552,31879,372,517,31947,372,32836,32803,2020-12-04 20:24:48.555613
Uttarakhand,4955,69578,1251,4967,70045,1263,76275,75784,2020-12-04 20:24:48.555613
Uttar Pradesh,22797,516694,7817,22990,518390,7848,549228,547308,2020-12-04 20:24:48.555613
West Bengal,24166,457377,8527,24106,460634,8576,493316,490070,2020-12-04 20:24:48.555613
Andaman and Nicobar Islands,71,4597,61,70,4611,61,4742,4729,2020-12-05 20:00:14.967513
Andhra Pradesh,6742,856320,7014,6422,857233,7020,870675,870076,2020-12-05 20:00:14.967513
Arunachal Pradesh,769,15525,54,751,15561,55,16367,16348,2020-12-05 20:00:14.967513
Assam,3505,208846,985,3551,208967,987,213505,213336,2020-12-05 20:00:14.967513
Bihar,5890,229249,1281,5836,229883,1287,237006,236420,2020-12-05 20:00:14.967513
Chandigarh,981,16452,284,928,16613,287,17828,17717,2020-12-05 20:00:14.967513
Chhattisgarh,19300,220177,2941,19351,221690,2956,243997,242418,2020-12-05 20:00:14.967513
Dadra and Nagar Haveli and Daman and Diu,14,3324,2,12,3326,2,3340,3340,2020-12-05 20:00:14.967513
Delhi,29120,543514,9424,28252,548376,9497,586125,582058,2020-12-05 20:00:14.967513
Goa,1418,46251,696,1388,46375,696,48459,48365,2020-12-05 20:00:14.967513
Gujarat,14913,195365,4031,14778,196992,4049,215819,214309,2020-12-05 20:00:14.967513
Haryana,15516,221203,2520,14329,223973,2539,240841,239239,2020-12-05 20:00:14.967513
Himachal Pradesh,8088,33914,695,8300,34492,708,43500,42697,2020-12-05 20:00:14.967513
Jammu and Kashmir,5104,104890,1718,4989,105537,1730,112256,111712,2020-12-05 20:00:14.967513
Jharkhand,1926,106868,977,1938,107074,978,109990,109771,2020-12-05 20:00:14.967513
Karnataka,24708,852584,11821,25065,853461,11834,890360,889113,2020-12-05 20:00:14.967513
Kerala,61342,556378,2329,61535,561874,2358,625767,620049,2020-12-05 20:00:14.967513
Ladakh,859,7713,119,860,7752,120,8732,8691,2020-12-05 20:00:14.967513
Lakshadweep,0,0,0,0,0,0,0,0,2020-12-05 20:00:14.967513
Madhya Pradesh,13887,193187,3300,13641,194743,3314,211698,210374,2020-12-05 20:00:14.967513
Maharashtra,86612,1703274,47472,84938,1710050,47599,1842587,1837358,2020-12-05 20:00:14.967513
Manipur,3070,22172,294,2951,22445,295,25691,25536,2020-12-05 20:00:14.967513
Meghalaya,648,11241,116,630,11319,118,12067,12005,2020-12-05 20:00:14.967513
Mizoram,235,3647,6,217,3690,6,3913,3888,2020-12-05 20:00:14.967513
Nagaland,699,10520,64,481,10759,65,11305,11283,2020-12-05 20:00:14.967513
Odisha,4239,314023,1755,3969,314665,1760,320394,320017,2020-12-05 20:00:14.967513
Puducherry,444,36062,613,427,36124,614,37165,37119,2020-12-05 20:00:14.967513
Punjab,7724,141478,4862,7785,142121,4882,154788,154064,2020-12-05 20:00:14.967513
Rajasthan,25544,246572,2370,24318,249713,2389,276420,274486,2020-12-05 20:00:14.967513
Sikkim,320,4669,111,358,4677,112,5147,5100,2020-12-05 20:00:14.967513
Tamil Nadu,10988,763428,11747,10938,764854,11762,787554,786163,2020-12-05 20:00:14.967513
Telengana,8826,261830,1467,8498,262751,1470,272719,272123,2020-12-05 20:00:14.967513
Tripura,517,31947,372,479,32009,372,32860,32836,2020-12-05 20:00:14.967513
Uttarakhand,4967,70045,1263,4994,70626,1273,76893,76275,2020-12-05 20:00:14.967513
Uttar Pradesh,22990,518390,7848,22665,520637,7877,551179,549228,2020-12-05 20:00:14.967513
West Bengal,24106,460634,8576,24045,463849,8628,496522,493316,2020-12-05 20:00:14.967513
Andaman and Nicobar Islands,70,4611,61,70,4616,61,4747,4742,2020-12-06 20:00:15.198544
Andhra Pradesh,6422,857233,7020,6166,858115,7024,871305,870675,2020-12-06 20:00:15.198544
Arunachal Pradesh,751,15561,55,748,15581,55,16384,16367,2020-12-06 20:00:15.198544
Assam,3551,208967,987,3543,209130,989,213662,213505,2020-12-06 20:00:15.198544
Bihar,5836,229883,1287,5630,230630,1292,237552,237006,2020-12-06 20:00:15.198544
Chandigarh,928,16613,287,883,16754,289,17926,17828,2020-12-06 20:00:15.198544
Chhattisgarh,19351,221690,2956,19533,223070,2977,245580,243997,2020-12-06 20:00:15.198544
Dadra and Nagar Haveli and Daman and Diu,12,3326,2,13,3326,2,3341,3340,2020-12-06 20:00:15.198544
Delhi,28252,548376,9497,26678,553292,9574,589544,586125,2020-12-06 20:00:15.198544
Goa,1388,46375,696,1384,46493,697,48574,48459,2020-12-06 20:00:15.198544
Gujarat,14778,196992,4049,14742,198527,4064,217333,215819,2020-12-06 20:00:15.198544
Haryana,14329,223973,2539,13310,226524,2564,242398,240841,2020-12-06 20:00:15.198544
Himachal Pradesh,8300,34492,708,8247,35437,721,44405,43500,2020-12-06 20:00:15.198544
Jammu and Kashmir,4989,105537,1730,5009,106006,1742,112757,112256,2020-12-06 20:00:15.198544
Jharkhand,1938,107074,978,1845,107362,979,110186,109990,2020-12-06 20:00:15.198544
Karnataka,25065,853461,11834,24978,854861,11846,891685,890360,2020-12-06 20:00:15.198544
Kerala,61535,561874,2358,61531,567694,2390,631615,625767,2020-12-06 20:00:15.198544
Ladakh,860,7752,120,884,7836,120,8840,8732,2020-12-06 20:00:15.198544
Lakshadweep,0,0,0,0,0,0,0,0,2020-12-06 20:00:15.198544
Madhya Pradesh,13641,194743,3314,13532,196192,3326,213050,211698,2020-12-06 20:00:15.198544
Maharashtra,84938,1710050,47599,83931,1715884,47694,1847509,1842587,2020-12-06 20:00:15.198544
Manipur,2951,22445,295,2903,22655,299,25857,25691,2020-12-06 20:00:15.198544
Meghalaya,630,11319,118,654,11392,118,12164,12067,2020-12-06 20:00:15.198544
Mizoram,217,3690,6,220,3708,6,3934,3913,2020-12-06 20:00:15.198544
Nagaland,481,10759,65,514,10761,65,11340,11305,2020-12-06 20:00:15.198544
Odisha,3969,314665,1760,3768,315270,1765,320803,320394,2020-12-06 20:00:15.198544
Puducherry,427,36124,614,419,36176,614,37209,37165,2020-12-06 20:00:15.198544
Punjab,7785,142121,4882,7727,142791,4906,155424,154788,2020-12-06 20:00:15.198544
Rajasthan,24318,249713,2389,23176,252911,2409,278496,276420,2020-12-06 20:00:15.198544
Sikkim,358,4677,112,367,4686,115,5168,5147,2020-12-06 20:00:15.198544
Tamil Nadu,10938,764854,11762,10882,766261,11777,788920,787554,2020-12-06 20:00:15.198544
Telengana,8498,262751,1470,8125,263744,1472,273341,272719,2020-12-06 20:00:15.198544
Tripura,479,32009,372,451,32068,372,32891,32860,2020-12-06 20:00:15.198544
Uttarakhand,4994,70626,1273,5176,71116,1281,77573,76893,2020-12-06 20:00:15.198544
Uttar Pradesh,22665,520637,7877,22245,522867,7900,553012,551179,2020-12-06 20:00:15.198544
West Bengal,24045,463849,8628,23964,467056,8677,499697,496522,2020-12-06 20:00:15.198544
Andaman and Nicobar Islands,70,4616,61,73,4624,61,4758,4747,2020-12-07 20:00:14.579697
Andhra Pradesh,6166,858115,7024,5910,859029,7033,871972,871305,2020-12-07 20:00:14.579697
Arunachal Pradesh,748,15581,55,735,15605,55,16395,16384,2020-12-07 20:00:14.579697
Assam,3543,209130,989,3552,209214,993,213759,213662,2020-12-07 20:00:14.579697
Bihar,5630,230630,1292,5563,231248,1295,238106,237552,2020-12-07 20:00:14.579697
Chandigarh,883,16754,289,922,16814,291,18027,17926,2020-12-07 20:00:14.579697
Chhattisgarh,19533,223070,2977,20048,223772,2989,246809,245580,2020-12-07 20:00:14.579697
Dadra and Nagar Haveli and Daman and Diu,13,3326,2,14,3326,2,3342,3341,2020-12-07 20:00:14.579697
Delhi,26678,553292,9574,24693,557914,9643,592250,589544,2020-12-07 20:00:14.579697
Goa,1384,46493,697,1364,46624,698,48686,48574,2020-12-07 20:00:14.579697
Gujarat,14742,198527,4064,14695,200012,4081,218788,217333,2020-12-07 20:00:14.579697
Haryana,13310,226524,2564,12897,228411,2588,243896,242398,2020-12-07 20:00:14.579697
Himachal Pradesh,8247,35437,721,8269,35957,732,44958,44405,2020-12-07 20:00:14.579697
Jammu and Kashmir,5009,106006,1742,5170,106372,1746,113288,112757,2020-12-07 20:00:14.579697
Jharkhand,1845,107362,979,1796,107496,986,110278,110186,2020-12-07 20:00:14.579697
Karnataka,24978,854861,11846,25400,855750,11856,893006,891685,2020-12-07 20:00:14.579697
Kerala,61531,567694,2390,61063,572911,2418,636392,631615,2020-12-07 20:00:14.579697
Ladakh,884,7836,120,856,7917,120,8893,8840,2020-12-07 20:00:14.579697
Lakshadweep,0,0,0,0,0,0,0,0,2020-12-07 20:00:14.579697
Madhya Pradesh,13532,196192,3326,13391,197777,3337,214505,213050,2020-12-07 20:00:14.579697
Maharashtra,83931,1715884,47694,81162,1723370,47734,1852266,1847509,2020-12-07 20:00:14.579697
Manipur,2903,22655,299,2919,22848,306,26073,25857,2020-12-07 20:00:14.579697
Meghalaya,654,11392,118,664,11453,120,12237,12164,2020-12-07 20:00:14.579697
Mizoram,220,3708,6,202,3728,6,3936,3934,2020-12-07 20:00:14.579697
Nagaland,514,10761,65,547,10766,66,11379,11340,2020-12-07 20:00:14.579697
Odisha,3768,315270,1765,3585,315840,1771,321196,320803,2020-12-07 20:00:14.579697
Puducherry,419,36176,614,372,36238,614,37224,37209,2020-12-07 20:00:14.579697
Punjab,7727,142791,4906,7896,143414,4916,156226,155424,2020-12-07 20:00:14.579697
Rajasthan,23176,252911,2409,22427,255729,2429,280585,278496,2020-12-07 20:00:14.579697
Sikkim,367,4686,115,387,4695,115,5197,5168,2020-12-07 20:00:14.579697
Tamil Nadu,10882,766261,11777,10688,767759,11793,790240,788920,2020-12-07 20:00:14.579697
Telengana,8125,263744,1472,7778,264606,1474,273858,273341,2020-12-07 20:00:14.579697
Tripura,451,32068,372,414,32110,373,32897,32891,2020-12-07 20:00:14.579697
Uttarakhand,5176,71116,1281,5223,71489,1285,77997,77573,2020-12-07 20:00:14.579697
Uttar Pradesh,22245,522867,7900,22160,524860,7924,554944,553012,2020-12-07 20:00:14.579697
West Bengal,23964,467056,8677,23894,470223,8723,502840,499697,2020-12-07 20:00:14.579697
Andaman and Nicobar Islands,73,4624,61,81,4631,61,4773,4758,2020-12-08 20:00:13.192001
Andhra Pradesh,5910,859029,7033,5626,859624,7038,872288,871972,2020-12-08 20:00:13.192001
Arunachal Pradesh,735,15605,55,707,15653,55,16415,16395,2020-12-08 20:00:13.192001
Assam,3552,209214,993,3585,209345,995,213925,213759,2020-12-08 20:00:13.192001
Bihar,5563,231248,1295,5467,231884,1297,238648,238106,2020-12-08 20:00:13.192001
Chandigarh,922,16814,291,921,16899,293,18113,18027,2020-12-08 20:00:13.192001
Chhattisgarh,20048,223772,2989,19589,225633,3010,248232,246809,2020-12-08 20:00:13.192001
Dadra and Nagar Haveli and Daman and Diu,14,3326,2,16,3328,2,3346,3342,2020-12-08 20:00:13.192001
Delhi,24693,557914,9643,22486,561732,9706,593924,592250,2020-12-08 20:00:13.192001
Goa,1364,46624,698,1297,46778,701,48776,48686,2020-12-08 20:00:13.192001
Gujarat,14695,200012,4081,14493,201580,4095,220168,218788,2020-12-08 20:00:13.192001
Haryana,12897,228411,2588,12126,230551,2611,245288,243896,2020-12-08 20:00:13.192001
Himachal Pradesh,8269,35957,732,7895,37063,739,45697,44958,2020-12-08 20:00:13.192001
Jammu and Kashmir,5170,106372,1746,5055,106758,1755,113568,113288,2020-12-08 20:00:13.192001
Jharkhand,1796,107496,986,1759,107710,988,110457,110278,2020-12-08 20:00:13.192001
Karnataka,25400,855750,11856,24786,857351,11867,894004,893006,2020-12-08 20:00:13.192001
Kerala,61063,572911,2418,59607,577616,2441,639664,636392,2020-12-08 20:00:13.192001
Ladakh,856,7917,120,761,8014,121,8896,8893,2020-12-08 20:00:13.192001
Lakshadweep,0,0,0,0,0,0,0,0,2020-12-08 20:00:13.192001
Madhya Pradesh,13391,197777,3337,13443,199167,3347,215957,214505,2020-12-08 20:00:13.192001
Maharashtra,81162,1723370,47734,76852,1730715,47774,1855341,1852266,2020-12-08 20:00:13.192001
Manipur,2919,22848,306,2919,22997,309,26225,26073,2020-12-08 20:00:13.192001
Meghalaya,664,11453,120,621,11573,120,12314,12237,2020-12-08 20:00:13.192001
Mizoram,202,3728,6,205,3757,6,3968,3936,2020-12-08 20:00:13.192001
Nagaland,547,10766,66,579,10773,66,11418,11379,2020-12-08 20:00:13.192001
Odisha,3585,315840,1771,3339,316447,1778,321564,321196,2020-12-08 20:00:13.192001
Puducherry,372,36238,614,392,36263,615,37270,37224,2020-12-08 20:00:13.192001
Punjab,7896,143414,4916,7604,144301,4934,156839,156226,2020-12-08 20:00:13.192001
Rajasthan,22427,255729,2429,21671,258393,2448,282512,280585,2020-12-08 20:00:13.192001
Sikkim,387,4695,115,371,4715,117,5203,5197,2020-12-08 20:00:13.192001
Tamil Nadu,10688,767759,11793,10695,769048,11809,791552,790240,2020-12-08 20:00:13.192001
Telengana,7778,264606,1474,7696,265367,1477,274540,273858,2020-12-08 20:00:13.192001
Tripura,414,32110,373,427,32125,373,32925,32897,2020-12-08 20:00:13.192001
Uttarakhand,5223,71489,1285,5234,71980,1295,78509,77997,2020-12-08 20:00:13.192001
Uttar Pradesh,22160,524860,7924,21732,526721,7944,556397,554944,2020-12-08 20:00:13.192001
West Bengal,23894,470223,8723,23829,472454,8771,505054,502840,2020-12-08 20:00:13.192001
Andaman and Nicobar Islands,81,4631,61,70,4647,61,4778,4773,2020-12-09 20:00:14.332060
Andhra Pradesh,5626,859624,7038,5429,860368,7042,872839,872288,2020-12-09 20:00:14.332060
Arunachal Pradesh,707,15653,55,692,15690,55,16437,16415,2020-12-09 20:00:14.332060
Assam,3585,209345,995,3575,209447,997,214019,213925,2020-12-09 20:00:14.332060
Bihar,5467,231884,1297,5459,232563,1300,239322,238648,2020-12-09 20:00:14.332060
Chandigarh,921,16899,293,962,16981,296,18239,18113,2020-12-09 20:00:14.332060
Chhattisgarh,19589,225633,3010,19516,227158,3025,249699,248232,2020-12-09 20:00:14.332060
Dadra and Nagar Haveli and Daman and Diu,16,3328,2,19,3330,2,3351,3346,2020-12-09 20:00:14.332060
Delhi,22486,561732,9706,22310,565039,9763,597112,593924,2020-12-09 20:00:14.332060
Goa,1297,46778,701,1310,46924,701,48935,48776,2020-12-09 20:00:14.332060
Gujarat,14493,201580,4095,14272,203111,4110,221493,220168,2020-12-09 20:00:14.332060
Haryana,12126,230551,2611,11947,232108,2624,246679,245288,2020-12-09 20:00:14.332060
Himachal Pradesh,7895,37063,739,7577,37871,753,46201,45697,2020-12-09 20:00:14.332060
Jammu and Kashmir,5055,106758,1755,4995,107282,1761,114038,113568,2020-12-09 20:00:14.332060
Jharkhand,1759,107710,988,1753,107898,988,110639,110457,2020-12-09 20:00:14.332060
Karnataka,24786,857351,11867,25034,858370,11880,895284,894004,2020-12-09 20:00:14.332060
Kerala,59607,577616,2441,59873,582351,2472,644696,639664,2020-12-09 20:00:14.332060
Ladakh,761,8014,121,791,8056,122,8969,8896,2020-12-09 20:00:14.332060
Lakshadweep,0,0,0,0,0,0,0,0,2020-12-09 20:00:14.332060
Madhya Pradesh,13443,199167,3347,13280,200664,3358,217302,215957,2020-12-09 20:00:14.332060
Maharashtra,76852,1730715,47774,74460,1737080,47827,1859367,1855341,2020-12-09 20:00:14.332060
Manipur,2919,22997,309,2919,23166,311,26396,26225,2020-12-09 20:00:14.332060
Meghalaya,621,11573,120,602,11686,122,12410,12314,2020-12-09 20:00:14.332060
Mizoram,205,3757,6,199,3772,6,3977,3968,2020-12-09 20:00:14.332060
Nagaland,579,10773,66,631,10781,67,11479,11418,2020-12-09 20:00:14.332060
Odisha,3339,316447,1778,3159,316970,1784,321913,321564,2020-12-09 20:00:14.332060
Puducherry,392,36263,615,388,36308,615,37311,37270,2020-12-09 20:00:14.332060
Punjab,7604,144301,4934,7274,145093,4964,157331,156839,2020-12-09 20:00:14.332060
Rajasthan,21671,258393,2448,20875,260773,2468,284116,282512,2020-12-09 20:00:14.332060
Sikkim,371,4715,117,363,4735,117,5215,5203,2020-12-09 20:00:14.332060
Tamil Nadu,10695,769048,11809,10588,770378,11822,792788,791552,2020-12-09 20:00:14.332060
Telengana,7696,265367,1477,7661,266120,1480,275261,274540,2020-12-09 20:00:14.332060
Tripura,427,32125,373,403,32169,373,32945,32925,2020-12-09 20:00:14.332060
Uttarakhand,5234,71980,1295,5399,72435,1307,79141,78509,2020-12-09 20:00:14.332060
Uttar Pradesh,21732,526721,7944,21374,528832,7967,558173,556397,2020-12-09 20:00:14.332060
West Bengal,23829,472454,8771,23750,475425,8820,507995,505054,2020-12-09 20:00:14.332060
Andaman and Nicobar Islands,70,4647,61,75,4647,61,4783,4778,2020-12-10 20:47:18.120159
Andhra Pradesh,5429,860368,7042,5259,861153,7045,873457,872839,2020-12-10 20:47:18.120159
Arunachal Pradesh,692,15690,55,709,15697,55,16461,16437,2020-12-10 20:47:18.120159
Assam,3575,209447,997,3542,209625,998,214165,214019,2020-12-10 20:47:18.120159
Bihar,5459,232563,1300,5354,233298,1303,239955,239322,2020-12-10 20:47:18.120159
Chandigarh,962,16981,296,897,17128,297,18322,18239,2020-12-10 20:47:18.120159
Chhattisgarh,19516,227158,3025,19778,228304,3038,251120,249699,2020-12-10 20:47:18.120159
Dadra and Nagar Haveli and Daman and Diu,19,3330,2,21,3331,2,3354,3351,2020-12-10 20:47:18.120159
Delhi,22310,565039,9763,20546,569216,9813,599575,597112,2020-12-10 20:47:18.120159
Goa,1310,46924,701,1277,47056,703,49036,48935,2020-12-10 20:47:18.120159
Gujarat,14272,203111,4110,14027,204661,4123,222811,221493,2020-12-10 20:47:18.120159
Haryana,11947,232108,2624,11733,233696,2650,248079,246679,2020-12-10 20:47:18.120159
Himachal Pradesh,7577,37871,753,7475,38690,765,46930,46201,2020-12-10 20:47:18.120159
Jammu and Kashmir,4995,107282,1761,5016,107624,1767,114407,114038,2020-12-10 20:47:18.120159
Jharkhand,1753,107898,988,1739,108100,991,110830,110639,2020-12-10 20:47:18.120159
Karnataka,25034,858370,11880,23075,861588,11900,896563,895284,2020-12-10 20:47:18.120159
Kerala,59873,582351,2472,60066,586998,2507,649571,644696,2020-12-10 20:47:18.120159
Ladakh,791,8056,122,819,8104,122,9045,8969,2020-12-10 20:47:18.120159
Lakshadweep,0,0,0,0,0,0,0,0,2020-12-10 20:47:18.120159
Madhya Pradesh,13280,200664,3358,13221,201987,3366,218574,217302,2020-12-10 20:47:18.120159
Maharashtra,74460,1737080,47827,74315,1742131,47902,1864348,1859367,2020-12-10 20:47:18.120159
Manipur,2919,23166,311,2915,23301,318,26534,26396,2020-12-10 20:47:18.120159
Meghalaya,602,11686,122,534,11855,122,12511,12410,2020-12-10 20:47:18.120159
Mizoram,199,3772,6,204,3784,6,3994,3977,2020-12-10 20:47:18.120159
Nagaland,631,10781,67,592,10849,67,11508,11479,2020-12-10 20:47:18.120159
Odisha,3159,316970,1784,3098,317412,1789,322299,321913,2020-12-10 20:47:18.120159
Puducherry,388,36308,615,370,36354,615,37339,37311,2020-12-10 20:47:18.120159
Punjab,7274,145093,4964,7325,145623,4980,157928,157331,2020-12-10 20:47:18.120159
Rajasthan,20875,260773,2468,19792,263350,2485,285627,284116,2020-12-10 20:47:18.120159
Sikkim,363,4735,117,368,4754,117,5239,5215,2020-12-10 20:47:18.120159
Tamil Nadu,10588,770378,11822,10491,771693,11836,794020,792788,2020-12-10 20:47:18.120159
Telengana,7661,266120,1480,7497,266925,1482,275904,275261,2020-12-10 20:47:18.120159
Tripura,403,32169,373,399,32204,373,32976,32945,2020-12-10 20:47:18.120159
Uttarakhand,5399,72435,1307,5456,72880,1320,79656,79141,2020-12-10 20:47:18.120159
Uttar Pradesh,21374,528832,7967,20658,530854,7987,559499,558173,2020-12-10 20:47:18.120159
West Bengal,23750,475425,8820,23650,478434,8867,510951,507995,2020-12-10 20:47:18.120159
Andaman and Nicobar Islands,75,4647,61,78,4652,61,4791,4783,2020-12-11 20:47:00.107138
Andhra Pradesh,5259,861153,7045,5237,861711,7047,873995,873457,2020-12-11 20:47:00.107138
Arunachal Pradesh,709,15697,55,685,15739,55,16479,16461,2020-12-11 20:47:00.107138
Assam,3542,209625,998,3516,209790,999,214305,214165,2020-12-11 20:47:00.107138
Bihar,5354,233298,1303,5499,233766,1307,240572,239955,2020-12-11 20:47:00.107138
Chandigarh,897,17128,297,881,17231,298,18410,18322,2020-12-11 20:47:00.107138
Chhattisgarh,19778,228304,3038,19346,230238,3054,252638,251120,2020-12-11 20:47:00.107138
Dadra and Nagar Haveli and Daman and Diu,21,3331,2,20,3332,2,3354,3354,2020-12-11 20:47:00.107138
Delhi,20546,569216,9813,18753,572523,9874,601150,599575,2020-12-11 20:47:00.107138
Goa,1277,47056,703,1213,47215,703,49131,49036,2020-12-11 20:47:00.107138
Gujarat,14027,204661,4123,13820,206126,4135,224081,222811,2020-12-11 20:47:00.107138
Haryana,11733,233696,2650,11456,235197,2676,249329,248079,2020-12-11 20:47:00.107138
Himachal Pradesh,7475,38690,765,7865,39065,773,47703,46930,2020-12-11 20:47:00.107138
Jammu and Kashmir,5016,107624,1767,4848,108150,1775,114773,114407,2020-12-11 20:47:00.107138
Jharkhand,1739,108100,991,1690,108320,993,111003,110830,2020-12-11 20:47:00.107138
Karnataka,23075,861588,11900,19225,866664,11912,897801,896563,2020-12-11 20:47:00.107138
Kerala,60066,586998,2507,59663,591845,2533,654041,649571,2020-12-11 20:47:00.107138
Ladakh,819,8104,122,774,8175,122,9071,9045,2020-12-11 20:47:00.107138
Lakshadweep,0,0,0,0,0,0,0,0,2020-12-11 20:47:00.107138
Madhya Pradesh,13221,201987,3366,13226,203294,3373,219893,218574,2020-12-11 20:47:00.107138
Maharashtra,74315,1742131,47902,73001,1747199,47972,1868172,1864348,2020-12-11 20:47:00.107138
Manipur,2915,23301,318,2970,23397,318,26685,26534,2020-12-11 20:47:00.107138
Meghalaya,534,11855,122,580,11883,123,12586,12511,2020-12-11 20:47:00.107138
Mizoram,204,3784,6,202,3800,6,4008,3994,2020-12-11 20:47:00.107138
Nagaland,592,10849,67,666,10868,68,11602,11508,2020-12-11 20:47:00.107138
Odisha,3098,317412,1789,2978,317870,1794,322642,322299,2020-12-11 20:47:00.107138
Puducherry,370,36354,615,374,36372,617,37363,37339,2020-12-11 20:47:00.107138
Punjab,7325,145623,4980,7423,146126,5007,158556,157928,2020-12-11 20:47:00.107138
Rajasthan,19792,263350,2485,19030,265689,2500,287219,285627,2020-12-11 20:47:00.107138
Sikkim,368,4754,117,367,4779,118,5264,5239,2020-12-11 20:47:00.107138
Tamil Nadu,10491,771693,11836,10392,772995,11853,795240,794020,2020-12-11 20:47:00.107138
Telengana,7497,266925,1482,7604,267427,1485,276516,275904,2020-12-11 20:47:00.107138
Tripura,399,32204,373,373,32250,374,32997,32976,2020-12-11 20:47:00.107138
Uttarakhand,5456,72880,1320,5742,73412,1332,80486,79656,2020-12-11 20:47:00.107138
Uttar Pradesh,20658,530854,7987,20801,532349,8011,561161,559499,2020-12-11 20:47:00.107138
West Bengal,23650,478434,8867,23451,481385,8916,513752,510951,2020-12-11 20:47:00.107138
Andaman and Nicobar Islands,78,4652,61,78,4659,61,4798,4791,2020-12-12 20:00:15.305722
Andhra Pradesh,5237,861711,7047,5236,862230,7049,874515,873995,2020-12-12 20:00:15.305722
Arunachal Pradesh,685,15739,55,279,16163,55,16497,16479,2020-12-12 20:00:15.305722
Assam,3516,209790,999,3493,209939,1000,214432,214305,2020-12-12 20:00:15.305722
Bihar,5499,233766,1307,5527,234383,1312,241222,240572,2020-12-12 20:00:15.305722
Chandigarh,881,17231,298,838,17365,299,18502,18410,2020-12-12 20:00:15.305722
Chhattisgarh,19346,230238,3054,18346,232715,3068,254129,252638,2020-12-12 20:00:15.305722
Dadra and Nagar Haveli and Daman and Diu,20,3332,2,18,3335,2,3355,3354,2020-12-12 20:00:15.305722
Delhi,18753,572523,9874,18676,574925,9934,603535,601150,2020-12-12 20:00:15.305722
Goa,1213,47215,703,1187,47345,703,49235,49131,2020-12-12 20:00:15.305722
Gujarat,13820,206126,4135,13627,207529,4148,225304,224081,2020-12-12 20:00:15.305722
Haryana,11456,235197,2676,10686,237009,2699,250394,249329,2020-12-12 20:00:15.305722
Himachal Pradesh,7865,39065,773,7725,39836,793,48354,47703,2020-12-12 20:00:15.305722
Jammu and Kashmir,4848,108150,1775,4849,108572,1786,115207,114773,2020-12-12 20:00:15.305722
Jharkhand,1690,108320,993,1694,108488,995,111177,111003,2020-12-12 20:00:15.305722
Karnataka,19225,866664,11912,18612,868471,11928,899011,897801,2020-12-12 20:00:15.305722
Kerala,59663,591845,2533,59528,596593,2562,658683,654041,2020-12-12 20:00:15.305722
Ladakh,774,8175,122,797,8192,123,9112,9071,2020-12-12 20:00:15.305722
Lakshadweep,0,0,0,0,0,0,0,0,2020-12-12 20:00:15.305722
Madhya Pradesh,13226,203294,3373,13092,204641,3382,221115,219893,2020-12-12 20:00:15.305722
Maharashtra,73001,1747199,47972,74408,1749973,48059,1872440,1868172,2020-12-12 20:00:15.305722
Manipur,2970,23397,318,2998,23541,320,26859,26685,2020-12-12 20:00:15.305722
Meghalaya,580,11883,123,594,11927,124,12645,12586,2020-12-12 20:00:15.305722
Mizoram,202,3800,6,197,3820,7,4024,4008,2020-12-12 20:00:15.305722
Nagaland,666,10868,68,632,10934,68,11634,11602,2020-12-12 20:00:15.305722
Odisha,2978,317870,1794,2953,318278,1798,323029,322642,2020-12-12 20:00:15.305722
Puducherry,374,36372,617,367,36420,619,37406,37363,2020-12-12 20:00:15.305722
Punjab,7423,146126,5007,7286,146777,5036,159099,158556,2020-12-12 20:00:15.305722
Rajasthan,19030,265689,2500,17721,268457,2514,288692,287219,2020-12-12 20:00:15.305722
Sikkim,367,4779,118,363,4810,118,5291,5264,2020-12-12 20:00:15.305722
Tamil Nadu,10392,772995,11853,10299,774306,11870,796475,795240,2020-12-12 20:00:15.305722
Telengana,7604,267427,1485,7670,267992,1489,277151,276516,2020-12-12 20:00:15.305722
Tripura,373,32250,374,355,32285,375,33015,32997,2020-12-12 20:00:15.305722
Uttarakhand,5742,73412,1332,5934,73936,1341,81211,80486,2020-12-12 20:00:15.305722
Uttar Pradesh,20801,532349,8011,20473,534224,8025,562722,561161,2020-12-12 20:00:15.305722
West Bengal,23451,481385,8916,23281,484258,8966,516505,513752,2020-12-12 20:00:15.305722
Andaman and Nicobar Islands,78,4659,61,79,4665,61,4805,4798,2020-12-13 20:24:35.607709
Andhra Pradesh,5236,862230,7049,5078,862895,7052,875025,874515,2020-12-13 20:24:35.607709
Arunachal Pradesh,279,16163,55,269,16185,55,16509,16497,2020-12-13 20:24:35.607709
Assam,3493,209939,1000,3527,210057,1000,214584,214432,2020-12-13 20:24:35.607709
Bihar,5527,234383,1312,5501,234958,1317,241776,241222,2020-12-13 20:24:35.607709
Chandigarh,838,17365,299,815,17457,300,18572,18502,2020-12-13 20:24:35.607709
Chhattisgarh,18346,232715,3068,18640,234037,3084,255761,254129,2020-12-13 20:24:35.607709
Dadra and Nagar Haveli and Daman and Diu,18,3335,2,17,3337,2,3356,3355,2020-12-13 20:24:35.607709
Delhi,18676,574925,9934,17373,578116,9981,605470,603535,2020-12-13 20:24:35.607709
Goa,1187,47345,703,1111,47489,705,49305,49235,2020-12-13 20:24:35.607709
Gujarat,13627,207529,4148,13481,208867,4160,226508,225304,2020-12-13 20:24:35.607709
Haryana,10686,237009,2699,10318,238374,2710,251402,250394,2020-12-13 20:24:35.607709
Himachal Pradesh,7725,39836,793,7575,40573,803,48951,48354,2020-12-13 20:24:35.607709
Jammu and Kashmir,4849,108572,1786,4831,109002,1793,115626,115207,2020-12-13 20:24:35.607709
Jharkhand,1694,108488,995,1610,108761,995,111366,111177,2020-12-13 20:24:35.607709
Karnataka,18612,868471,11928,18273,870002,11939,900214,899011,2020-12-13 20:24:35.607709
Kerala,59528,596593,2562,60177,601861,2594,664632,658683,2020-12-13 20:24:35.607709
Ladakh,797,8192,123,763,8252,123,9138,9112,2020-12-13 20:24:35.607709
Lakshadweep,0,0,0,0,0,0,0,0,2020-12-13 20:24:35.607709
Madhya Pradesh,13092,204641,3382,12947,206059,3391,222397,221115,2020-12-13 20:24:35.607709
Maharashtra,74408,1749973,48059,74638,1753922,48139,1876699,1872440,2020-12-13 20:24:35.607709
Manipur,2998,23541,320,3057,23657,322,27036,26859,2020-12-13 20:24:35.607709
Meghalaya,594,11927,124,641,11977,125,12743,12645,2020-12-13 20:24:35.607709
Mizoram,197,3820,7,192,3836,7,4035,4024,2020-12-13 20:24:35.607709
Nagaland,632,10934,68,610,10998,68,11676,11634,2020-12-13 20:24:35.607709
Odisha,2953,318278,1798,2879,318683,1802,323364,323029,2020-12-13 20:24:35.607709
Puducherry,367,36420,619,346,36479,619,37444,37406,2020-12-13 20:24:35.607709
Punjab,7286,146777,5036,7091,147431,5057,159579,159099,2020-12-13 20:24:35.607709
Rajasthan,17721,268457,2514,16821,270650,2528,289999,288692,2020-12-13 20:24:35.607709
Sikkim,363,4810,118,364,4834,118,5316,5291,2020-12-13 20:24:35.607709
Tamil Nadu,10299,774306,11870,10208,775602,11883,797693,796475,2020-12-13 20:24:35.607709
Telengana,7670,267992,1489,7630,268601,1493,277724,277151,2020-12-13 20:24:35.607709
Tripura,355,32285,375,352,32310,376,33038,33015,2020-12-13 20:24:35.607709
Uttarakhand,5934,73936,1341,6207,74381,1351,81939,81211,2020-12-13 20:24:35.607709
Uttar Pradesh,20473,534224,8025,20091,535985,8056,564132,562722,2020-12-13 20:24:35.607709
West Bengal,23281,484258,8966,23034,487171,9010,519215,516505,2020-12-13 20:24:35.607709
Andaman and Nicobar Islands,79,4665,61,84,4673,61,4818,4805,2020-12-14 20:07:09.602611
Andhra Pradesh,5078,862895,7052,4966,863508,7057,875531,875025,2020-12-14 20:07:09.602611
Arunachal Pradesh,269,16185,55,252,16206,55,16513,16509,2020-12-14 20:07:09.602611
Assam,3527,210057,1000,3481,210174,1002,214657,214584,2020-12-14 20:07:09.602611
Bihar,5501,234958,1317,5375,235528,1321,242224,241776,2020-12-14 20:07:09.602611
Chandigarh,815,17457,300,766,17571,301,18638,18572,2020-12-14 20:07:09.602611
Chhattisgarh,18640,234037,3084,19070,234853,3097,257020,255761,2020-12-14 20:07:09.602611
Dadra and Nagar Haveli and Daman and Diu,17,3337,2,17,3337,2,3356,3356,2020-12-14 20:07:09.602611
Delhi,17373,578116,9981,16785,580655,10014,607454,605470,2020-12-14 20:07:09.602611
Goa,1111,47489,705,1066,47590,706,49362,49305,2020-12-14 20:07:09.602611
Gujarat,13481,208867,4160,13298,210214,4171,227683,226508,2020-12-14 20:07:09.602611
Haryana,10318,238374,2710,9875,239800,2717,252392,251402,2020-12-14 20:07:09.602611
Himachal Pradesh,7575,40573,803,7251,41313,811,49375,48951,2020-12-14 20:07:09.602611
Jammu and Kashmir,4831,109002,1793,4702,109507,1799,116008,115626,2020-12-14 20:07:09.602611
Jharkhand,1610,108761,995,1571,108940,999,111510,111366,2020-12-14 20:07:09.602611
Karnataka,18273,870002,11939,17428,872038,11944,901410,900214,2020-12-14 20:07:09.602611
Kerala,60177,601861,2594,59588,607119,2623,669330,664632,2020-12-14 20:07:09.602611
Ladakh,763,8252,123,649,8383,123,9155,9138,2020-12-14 20:07:09.602611
Lakshadweep,0,0,0,0,0,0,0,0,2020-12-14 20:07:09.602611
Madhya Pradesh,12947,206059,3391,12837,207337,3404,223578,222397,2020-12-14 20:07:09.602611
Maharashtra,74638,1753922,48139,75202,1757005,48209,1880416,1876699,2020-12-14 20:07:09.602611
Manipur,3057,23657,322,3074,23759,322,27155,27036,2020-12-14 20:07:09.602611
Meghalaya,641,11977,125,730,12008,128,12866,12743,2020-12-14 20:07:09.602611
Mizoram,192,3836,7,186,3847,7,4040,4035,2020-12-14 20:07:09.602611
Nagaland,610,10998,68,634,11007,68,11709,11676,2020-12-14 20:07:09.602611
Odisha,2879,318683,1802,2881,319069,1807,323757,323364,2020-12-14 20:07:09.602611
Puducherry,346,36479,619,337,36536,619,37492,37444,2020-12-14 20:07:09.602611
Punjab,7091,147431,5057,7076,148047,5077,160200,159579,2020-12-14 20:07:09.602611
Rajasthan,16821,270650,2528,16629,272118,2542,291289,289999,2020-12-14 20:07:09.602611
Sikkim,364,4834,118,356,4864,118,5338,5316,2020-12-14 20:07:09.602611
Tamil Nadu,10208,775602,11883,10115,776878,11895,798888,797693,2020-12-14 20:07:09.602611
Telengana,7630,268601,1493,7380,269232,1496,278108,277724,2020-12-14 20:07:09.602611
Tripura,352,32310,376,330,32342,376,33048,33038,2020-12-14 20:07:09.602611
Uttarakhand,6207,74381,1351,6293,74781,1355,82429,81939,2020-12-14 20:07:09.602611
Uttar Pradesh,20091,535985,8056,19729,537755,8072,565556,564132,2020-12-14 20:07:09.602611
West Bengal,23034,487171,9010,22573,490165,9057,521795,519215,2020-12-14 20:07:09.602611
Andaman and Nicobar Islands,84,4673,61,92,4681,61,4834,4818,2020-12-15 20:01:30.761307
Andhra Pradesh,4966,863508,7057,4728,864049,7059,875836,875531,2020-12-15 20:01:30.761307
Arunachal Pradesh,252,16206,55,238,16243,55,16536,16513,2020-12-15 20:01:30.761307
Assam,3481,210174,1002,3501,210299,1003,214803,214657,2020-12-15 20:01:30.761307
Bihar,5375,235528,1321,5088,236247,1325,242660,242224,2020-12-15 20:01:30.761307
Chandigarh,766,17571,301,714,17698,302,18714,18638,2020-12-15 20:01:30.761307
Chhattisgarh,19070,234853,3097,18931,236588,3116,258635,257020,2020-12-15 20:01:30.761307
Dadra and Nagar Haveli and Daman and Diu,17,3337,2,19,3338,2,3359,3356,2020-12-15 20:01:30.761307
Delhi,16785,580655,10014,15247,583509,10074,608830,607454,2020-12-15 20:01:30.761307
Goa,1066,47590,706,1030,47737,707,49474,49362,2020-12-15 20:01:30.761307
Gujarat,13298,210214,4171,13018,211603,4182,228803,227683,2020-12-15 20:01:30.761307
Haryana,9875,239800,2717,9108,241544,2733,253385,252392,2020-12-15 20:01:30.761307
Himachal Pradesh,7251,41313,811,6948,41990,823,49761,49375,2020-12-15 20:01:30.761307
Jammu and Kashmir,4702,109507,1799,4558,109894,1802,116254,116008,2020-12-15 20:01:30.761307
Jharkhand,1571,108940,999,1581,109141,1000,111722,111510,2020-12-15 20:01:30.761307
Karnataka,17428,872038,11944,16084,874202,11954,902240,901410,2020-12-15 20:01:30.761307
Kerala,59588,607119,2623,57790,611600,2647,672037,669330,2020-12-15 20:01:30.761307
Ladakh,649,8383,123,614,8429,123,9166,9155,2020-12-15 20:01:30.761307
Lakshadweep,0,0,0,0,0,0,0,0,2020-12-15 20:01:30.761307
Madhya Pradesh,12837,207337,3404,12803,208421,3412,224636,223578,2020-12-15 20:01:30.761307
Maharashtra,75202,1757005,48209,73481,1761615,48269,1883365,1880416,2020-12-15 20:01:30.761307
Manipur,3074,23759,322,2146,24739,324,27209,27155,2020-12-15 20:01:30.761307
Meghalaya,730,12008,128,753,12058,130,12941,12866,2020-12-15 20:01:30.761307
Mizoram,186,3847,7,173,3869,7,4049,4040,2020-12-15 20:01:30.761307
Nagaland,634,11007,68,593,11066,69,11728,11709,2020-12-15 20:01:30.761307
Odisha,2881,319069,1807,2820,319458,1811,324089,323757,2020-12-15 20:01:30.761307
Puducherry,337,36536,619,307,36586,620,37513,37492,2020-12-15 20:01:30.761307
Punjab,7076,148047,5077,6881,148680,5098,160659,160200,2020-12-15 20:01:30.761307
Rajasthan,16629,272118,2542,16200,273784,2555,292539,291289,2020-12-15 20:01:30.761307
Sikkim,356,4864,118,303,4919,118,5340,5338,2020-12-15 20:01:30.761307
Tamil Nadu,10115,776878,11895,10039,778081,11909,800029,798888,2020-12-15 20:01:30.761307
Telengana,7380,269232,1496,7272,269828,1499,278599,278108,2020-12-15 20:01:30.761307
Tripura,330,32342,376,314,32367,376,33057,33048,2020-12-15 20:01:30.761307
Uttarakhand,6293,74781,1355,6144,75501,1361,83006,82429,2020-12-15 20:01:30.761307
Uttar Pradesh,19729,537755,8072,18918,539727,8083,566728,565556,2020-12-15 20:01:30.761307
West Bengal,22573,490165,9057,21384,493145,9100,523629,521795,2020-12-15 20:01:30.761307
Andaman and Nicobar Islands,92,4681,61,93,4688,61,4842,4834,2020-12-16 20:16:25.861729
Andhra Pradesh,4728,864049,7059,4660,864612,7064,876336,875836,2020-12-16 20:16:25.861729
Arunachal Pradesh,238,16243,55,234,16264,55,16553,16536,2020-12-16 20:16:25.861729
Assam,3501,210299,1003,3540,210401,1004,214945,214803,2020-12-16 20:16:25.861729
Bihar,5088,236247,1325,5170,236782,1329,243281,242660,2020-12-16 20:16:25.861729
Chandigarh,714,17698,302,635,17837,304,18776,18714,2020-12-16 20:16:25.861729
Chhattisgarh,18931,236588,3116,17637,239468,3135,260240,258635,2020-12-16 20:16:25.861729
Dadra and Nagar Haveli and Daman and Diu,19,3338,2,19,3338,2,3359,3359,2020-12-16 20:16:25.861729
Delhi,15247,583509,10074,14480,585852,10115,610447,608830,2020-12-16 20:16:25.861729
Goa,1030,47737,707,995,47861,710,49566,49474,2020-12-16 20:16:25.861729
Gujarat,13018,211603,4182,12881,212839,4193,229913,228803,2020-12-16 20:16:25.861729
Haryana,9108,241544,2733,8232,243224,2751,254207,253385,2020-12-16 20:16:25.861729
Himachal Pradesh,6948,41990,823,6792,42568,836,50196,49761,2020-12-16 20:16:25.861729
Jammu and Kashmir,4558,109894,1802,4434,110354,1812,116600,116254,2020-12-16 20:16:25.861729
Jharkhand,1581,109141,1000,1578,109352,1001,111931,111722,2020-12-16 20:16:25.861729
Karnataka,16084,874202,11954,15664,875796,11965,903425,902240,2020-12-16 20:16:25.861729
Kerala,57790,611600,2647,57909,616666,2680,677255,672037,2020-12-16 20:16:25.861729
Ladakh,614,8429,123,625,8469,123,9217,9166,2020-12-16 20:16:25.861729
Lakshadweep,0,0,0,0,0,0,0,0,2020-12-16 20:16:25.861729
Madhya Pradesh,12803,208421,3412,12516,209768,3425,225709,224636,2020-12-16 20:16:25.861729
Maharashtra,73481,1761615,48269,72458,1766010,48339,1886807,1883365,2020-12-16 20:16:25.861729
Manipur,2146,24739,324,2085,24880,327,27292,27209,2020-12-16 20:16:25.861729
Meghalaya,753,12058,130,690,12186,131,13007,12941,2020-12-16 20:16:25.861729
Mizoram,173,3869,7,179,3894,7,4080,4049,2020-12-16 20:16:25.861729
Nagaland,593,11066,69,595,11097,69,11761,11728,2020-12-16 20:16:25.861729
Odisha,2820,319458,1811,2724,319850,1815,324389,324089,2020-12-16 20:16:25.861729
Puducherry,307,36586,620,297,36633,620,37550,37513,2020-12-16 20:16:25.861729
Punjab,6881,148680,5098,6502,149434,5117,161053,160659,2020-12-16 20:16:25.861729
Rajasthan,16200,273784,2555,15510,275506,2568,293584,292539,2020-12-16 20:16:25.861729
Sikkim,303,4919,118,294,4952,119,5365,5340,2020-12-16 20:16:25.861729
Tamil Nadu,10039,778081,11909,9951,779291,11919,801161,800029,2020-12-16 20:16:25.861729
Telengana,7272,269828,1499,7183,270450,1502,279135,278599,2020-12-16 20:16:25.861729
Tripura,314,32367,376,306,32397,378,33081,33057,2020-12-16 20:16:25.861729
Uttarakhand,6144,75501,1361,6089,76041,1372,83502,83006,2020-12-16 20:16:25.861729
Uttar Pradesh,18918,539727,8083,18382,541579,8103,568064,566728,2020-12-16 20:16:25.861729
West Bengal,21384,493145,9100,20663,496110,9145,525918,523629,2020-12-16 20:16:25.861729
Andaman and Nicobar Islands,93,4688,61,91,4698,61,4850,4842,2020-12-17 20:07:27.839977
Andhra Pradesh,4660,864612,7064,4420,865327,7067,876814,876336,2020-12-17 20:07:27.839977
Arunachal Pradesh,234,16264,55,241,16278,55,16574,16553,2020-12-17 20:07:27.839977
Assam,3540,210401,1004,3544,210491,1007,215042,214945,2020-12-17 20:07:27.839977
Bihar,5170,236782,1329,5231,237267,1332,243830,243281,2020-12-17 20:07:27.839977
Chandigarh,635,17837,304,627,17912,304,18843,18776,2020-12-17 20:07:27.839977
Chhattisgarh,17637,239468,3135,17468,241288,3145,261901,260240,2020-12-17 20:07:27.839977
Dadra and Nagar Haveli and Daman and Diu,19,3338,2,16,3342,2,3360,3359,2020-12-17 20:07:27.839977
Delhi,14480,585852,10115,13261,588586,10147,611994,610447,2020-12-17 20:07:27.839977
Goa,995,47861,710,979,47965,713,49657,49566,2020-12-17 20:07:27.839977
Gujarat,12881,212839,4193,12647,214223,4203,231073,229913,2020-12-17 20:07:27.839977
Haryana,8232,243224,2751,7573,244676,2765,255014,254207,2020-12-17 20:07:27.839977
Himachal Pradesh,6792,42568,836,6218,43614,848,50680,50196,2020-12-17 20:07:27.839977
Jammu and Kashmir,4434,110354,1812,4346,110769,1817,116932,116600,2020-12-17 20:07:27.839977
Jharkhand,1578,109352,1001,1585,109532,1004,112121,111931,2020-12-17 20:07:27.839977
Karnataka,15664,875796,11965,15495,877199,11971,904665,903425,2020-12-17 20:07:27.839977
Kerala,57909,616666,2680,58339,622394,2707,683440,677255,2020-12-17 20:07:27.839977
Ladakh,625,8469,123,536,8579,123,9238,9217,2020-12-17 20:07:27.839977
Lakshadweep,0,0,0,0,0,0,0,0,2020-12-17 20:07:27.839977
Madhya Pradesh,12516,209768,3425,12330,211025,3433,226788,225709,2020-12-17 20:07:27.839977
Maharashtra***,72458,1766010,48339,68476,1769897,48434,1886807,1886807,2020-12-17 20:07:27.839977
Manipur,2085,24880,327,1937,25107,329,27373,27292,2020-12-17 20:07:27.839977
Meghalaya,690,12186,131,687,12252,133,13072,13007,2020-12-17 20:07:27.839977
Mizoram,179,3894,7,171,3907,7,4085,4080,2020-12-17 20:07:27.839977
Nagaland,595,11097,69,597,11120,70,11787,11761,2020-12-17 20:07:27.839977
Odisha,2724,319850,1815,2768,320208,1820,324796,324389,2020-12-17 20:07:27.839977
Puducherry,297,36633,620,299,36661,622,37582,37550,2020-12-17 20:07:27.839977
Punjab,6502,149434,5117,6241,150007,5135,161383,161053,2020-12-17 20:07:27.839977
Rajasthan,15510,275506,2568,14510,277743,2578,294831,293584,2020-12-17 20:07:27.839977
Sikkim,294,4952,119,306,4971,121,5398,5365,2020-12-17 20:07:27.839977
Tamil Nadu,9951,779291,11919,9880,780531,11931,802342,801161,2020-12-17 20:07:27.839977
Telengana,7183,270450,1502,7172,270967,1505,279644,279135,2020-12-17 20:07:27.839977
Tripura,306,32397,378,291,32429,378,33098,33081,2020-12-17 20:07:27.839977
Uttarakhand,6089,76041,1372,6140,76554,1375,84069,83502,2020-12-17 20:07:27.839977
Uttar Pradesh,18382,541579,8103,17801,543344,8118,569263,568064,2020-12-17 20:07:27.839977
West Bengal,20663,496110,9145,20143,498877,9191,528211,525918,2020-12-17 20:07:27.839977
Andaman and Nicobar Islands,147,4698,61,152,3469,52,3673,4850,2020-12-18 17:39:44
Andhra Pradesh,78836,865327,7067,74518,551821,5410,631749,876814,2020-12-18 17:39:44
Arunachal Pradesh,1964,16278,55,1939,5643,13,7595,16574,2020-12-18 17:39:44
Assam,28780,210491,1007,29609,129133,578,159320,215042,2020-12-18 17:39:44
Bihar,13005,237267,1332,12539,156242,870,169651,243830,2020-12-18 17:39:44
Chandigarh,2821,17912,304,2761,7411,126,10298,18843,2020-12-18 17:39:44
Chhattisgarh,37853,241288,3145,37927,49564,690,88181,261901,2020-12-18 17:39:44
Dadra and Nagar Haveli and Daman and Diu,229,3342,2,220,2711,2,2933,3360,2020-12-18 17:39:44
Delhi,32097,588586,10147,30941,213304,5014,249259,611994,2020-12-18 17:39:44
Goa,5781,47965,713,5667,22726,360,28753,49657,2020-12-18 17:39:44
Gujarat,16208,214223,4203,16305,104964,3336,124605,231073,2020-12-18 17:39:44
Haryana,21411,244676,2765,21014,90884,1177,113075,255014,2020-12-18 17:39:44
Himachal Pradesh,4444,43614,848,4458,7853,127,12438,50680,2020-12-18 17:39:44
Jammu and Kashmir,22032,110769,1817,21887,42115,1024,65026,116932,2020-12-18 17:39:44
Jharkhand,13791,109532,1004,13504,58543,626,72673,112121,2020-12-18 17:39:44
Karnataka,98062,877199,11971,95354,423377,8145,526876,904665,2020-12-18 17:39:44
Kerala,39484,622394,2707,39354,98724,553,138631,683440,2020-12-18 17:39:44
Ladakh,1013,8579,123,1047,2735,50,3832,9238,2020-12-18 17:39:44
Lakshadweep,0,0,0,0,0,0,0,0,2020-12-18 17:39:44
Madhya Pradesh,22300,211025,3433,22542,83618,2007,108167,226788,2020-12-18 17:39:44
Maharashtra,291630,1769897,48434,275017,916348,33015,1224380,1886807,2020-12-18 17:39:44
Manipur,2070,25107,329,2113,6838,59,9010,27373,2020-12-18 17:39:44
Meghalaya,2111,12252,133,2169,2527,37,4733,13072,2020-12-18 17:39:44
Mizoram,583,3907,7,680,1012,0,1692,4085,2020-12-18 17:39:44
Nagaland,1184,11120,70,1052,4477,15,5544,11787,2020-12-18 17:39:44
Odisha,33504,320208,1820,34033,149379,710,184122,324796,2020-12-18 17:39:44
Puducherry,4908,36661,622,4659,18065,467,23191,37582,2020-12-18 17:39:44
Punjab,22278,150007,5135,21661,75409,2860,99930,161383,2020-12-18 17:39:44
Rajasthan,18184,277743,2578,18245,97284,1352,116881,294831,2020-12-18 17:39:44
Sikkim,469,4971,121,513,1986,29,2528,5398,2020-12-18 17:39:44
Tamil Nadu,46703,780531,11931,46495,491971,8871,547337,802342,2020-12-18 17:39:44
Telengana,29636,270967,1505,29649,144073,1052,174774,279644,2020-12-18 17:39:44
Tripura,6566,32429,378,6700,15883,251,22834,33098,2020-12-18 17:39:44
Uttarakhand,12455,543344,8118,12075,29201,501,41777,569263,2020-12-18 17:39:44
Uttar Pradesh,65954,76554,1375,64164,289594,5135,358893,84069,2020-12-18 17:39:44
West Bengal,24806,498877,9191,24898,198983,4421,228302,528211,2020-12-18 17:39:44
Andaman and Nicobar Islands,147,4707,61,152,3469,52,3673,4860,2020-12-19 17:39:44
Andhra Pradesh,78836,865825,7069,74518,551821,5410,631749,877348,2020-12-19 17:39:44
Arunachal Pradesh,1964,16290,55,1939,5643,13,7595,16603,2020-12-19 17:39:44
Assam,28780,210615,1010,29609,129133,578,159320,215148,2020-12-19 17:39:44
Bihar,13005,237770,1337,12539,156242,870,169651,244386,2020-12-19 17:39:44
Chandigarh,2821,18017,304,2761,7411,126,10298,18905,2020-12-19 17:39:44
Chhattisgarh,37853,242922,3156,37927,49564,690,88181,263485,2020-12-19 17:39:44
Dadra and Nagar Haveli and Daman and Diu,229,3344,2,220,2711,2,2933,3361,2020-12-19 17:39:44
Delhi,32097,590977,10182,30941,213304,5014,249259,613357,2020-12-19 17:39:44
Goa,5781,48054,716,5667,22726,360,28753,49745,2020-12-19 17:39:44
Gujarat,16208,215528,4211,16305,104964,3336,124605,232188,2020-12-19 17:39:44
Haryana,21411,245933,2782,21014,90884,1177,113075,255728,2020-12-19 17:39:44
Himachal Pradesh,4444,44146,858,4458,7853,127,12438,51143,2020-12-19 17:39:44
Jammu and Kashmir,22032,111164,1826,21887,42115,1024,65026,117317,2020-12-19 17:39:44
Jharkhand,13791,109696,1007,13504,58543,626,72673,112332,2020-12-19 17:39:44
Karnataka,98062,878696,11981,95354,423377,8145,526876,905901,2020-12-19 17:39:44
Kerala,39484,627364,2734,39354,98724,553,138631,688409,2020-12-19 17:39:44
Ladakh,1013,8623,123,1047,2735,50,3832,9243,2020-12-19 17:39:44
Lakshadweep,0,0,0,0,0,0,0,0,2020-12-19 17:39:44
Madhya Pradesh,22300,212351,3442,22542,83618,2007,108167,227949,2020-12-19 17:39:44
Maharashtra,291630,1774255,48499,275017,916348,33015,1224380,1886807,2020-12-19 17:39:44
Manipur,2070,25250,332,2113,6838,59,9010,27454,2020-12-19 17:39:44
Meghalaya,2111,12322,133,2169,2527,37,4733,13141,2020-12-19 17:39:44
Mizoram,583,3923,7,680,1012,0,1692,4094,2020-12-19 17:39:44
Nagaland,1184,11200,73,1052,4477,15,5544,11820,2020-12-19 17:39:44
Odisha,33504,320584,1825,34033,149379,710,184122,325147,2020-12-19 17:39:44
Puducherry,4908,36693,622,4659,18065,467,23191,37622,2020-12-19 17:39:44
Punjab,22278,150636,5150,21661,75409,2860,99930,161831,2020-12-19 17:39:44
Rajasthan,18184,279717,2589,18245,97284,1352,116881,295953,2020-12-19 17:39:44
Sikkim,469,4990,122,513,1986,29,2528,5406,2020-12-19 17:39:44
Tamil Nadu,46703,781745,11942,46495,491971,8871,547337,803516,2020-12-19 17:39:44
Telengana,29636,271649,1506,29649,144073,1052,174774,280195,2020-12-19 17:39:44
Tripura,6566,32471,378,6700,15883,251,22834,33119,2020-12-19 17:39:44
Uttarakhand,12455,544503,8136,12075,29201,501,41777,570789,2020-12-19 17:39:44
Uttar Pradesh,65954,77243,1384,64164,289594,5135,358893,84689,2020-12-19 17:39:44
West Bengal,24806,501624,9235,24898,198983,4421,228302,530456,2020-12-19 17:39:44
Andaman and Nicobar Islands,96,4712,61,95,4719,61,4875,4869,2020-12-20 20:22:36.493708
Andhra Pradesh,4377,866359,7070,4355,866856,7074,878285,877806,2020-12-20 20:22:36.493708
Arunachal Pradesh,234,16322,55,241,16333,55,16629,16611,2020-12-20 20:22:36.493708
Assam,3539,210700,1011,3526,210808,1012,215346,215250,2020-12-20 20:22:36.493708
Bihar,5370,238316,1341,5205,239109,1347,245661,245027,2020-12-20 20:22:36.493708
Chandigarh,535,18139,305,494,18244,306,19044,18979,2020-12-20 20:22:36.493708
Chhattisgarh,17488,244247,3163,17040,246054,3172,266266,264898,2020-12-20 20:22:36.493708
Dadra and Nagar Haveli and Daman and Diu,10,3350,2,9,3352,2,3363,3362,2020-12-20 20:22:36.493708
Delhi,11419,593137,10219,10358,595305,10251,615914,614775,2020-12-20 20:22:36.493708
Goa,961,48170,718,978,48280,718,49976,49849,2020-12-20 20:22:36.493708
Gujarat,12360,216683,4220,12127,217935,4227,234289,233263,2020-12-20 20:22:36.493708
Haryana,6577,247097,2803,6079,248172,2816,257067,256477,2020-12-20 20:22:36.493708
Himachal Pradesh,5974,44784,867,5966,45174,870,52010,51625,2020-12-20 20:22:36.493708
Jammu and Kashmir,4244,111628,1833,4076,112093,1837,118006,117705,2020-12-20 20:22:36.493708
Jharkhand,1707,109891,1008,1718,110125,1010,112853,112606,2020-12-20 20:22:36.493708
Karnataka,15399,879735,11989,14389,881882,12004,908275,907123,2020-12-20 20:22:36.493708
Kerala,59043,632065,2757,60558,636814,2786,700158,693865,2020-12-20 20:22:36.493708
Ladakh,473,8655,124,423,8723,124,9270,9252,2020-12-20 20:22:36.493708
Lakshadweep,0,0,0,0,0,0,0,0,2020-12-20 20:22:36.493708
Madhya Pradesh,11876,213801,3453,11446,215211,3468,230125,229130,2020-12-20 20:22:36.493708
Maharashtra,61471,1778722,48574,62218,1781841,48648,1892707,1888767,2020-12-20 20:22:36.493708
Manipur,1835,25371,334,1750,25512,336,27598,27540,2020-12-20 20:22:36.493708
Meghalaya,586,12470,133,557,12531,133,13221,13189,2020-12-20 20:22:36.493708
Mizoram,160,3943,7,158,3957,7,4122,4110,2020-12-20 20:22:36.493708
Nagaland,554,11205,73,538,11230,73,11841,11832,2020-12-20 20:22:36.493708
Odisha,2729,320947,1829,2720,321309,1832,325861,325505,2020-12-20 20:22:36.493708
Puducherry,316,36731,623,339,36752,624,37715,37670,2020-12-20 20:22:36.493708
Punjab,5981,151119,5170,5837,151679,5189,162705,162270,2020-12-20 20:22:36.493708
Rajasthan,13058,281372,2599,12779,282631,2608,298018,297029,2020-12-20 20:22:36.493708
Sikkim,304,5012,123,401,5037,123,5561,5439,2020-12-20 20:22:36.493708
Tamil Nadu,9781,782915,11954,9692,784117,11968,805777,804650,2020-12-20 20:22:36.493708
Telengana,6942,272370,1510,6888,273013,1513,281414,280822,2020-12-20 20:22:36.493708
Tripura,265,32501,378,257,32532,378,33167,33144,2020-12-20 20:22:36.493708
Uttarakhand,6067,77803,1399,6074,78371,1408,85853,85269,2020-12-20 20:22:36.493708
Uttar Pradesh,17955,546087,8154,17593,547631,8177,573401,572196,2020-12-20 20:22:36.493708
West Bengal,19065,504353,9277,18460,507070,9320,534850,532695,2020-12-20 20:22:36.493708
Andaman and Nicobar Islands,147,4719,61,152,3469,52,3673,4875,2020-12-21 17:39:44
Andhra Pradesh,78836,866856,7074,74518,551821,5410,631749,878285,2020-12-21 17:39:44
Arunachal Pradesh,1964,16333,55,1939,5643,13,7595,16629,2020-12-21 17:39:44
Assam,28780,210808,1012,29609,129133,578,159320,215346,2020-12-21 17:39:44
Bihar,13005,239109,1347,12539,156242,870,169651,245661,2020-12-21 17:39:44
Chandigarh,2821,18244,306,2761,7411,126,10298,19044,2020-12-21 17:39:44
Chhattisgarh,37853,246054,3172,37927,49564,690,88181,266266,2020-12-21 17:39:44
Dadra and Nagar Haveli and Daman and Diu,229,3352,2,220,2711,2,2933,3363,2020-12-21 17:39:44
Delhi,32097,595305,10251,30941,213304,5014,249259,615914,2020-12-21 17:39:44
Goa,5781,48280,718,5667,22726,360,28753,49976,2020-12-21 17:39:44
Gujarat,16208,217935,4227,16305,104964,3336,124605,234289,2020-12-21 17:39:44
Haryana,21411,248172,2816,21014,90884,1177,113075,257067,2020-12-21 17:39:44
Himachal Pradesh,4444,45174,870,4458,7853,127,12438,52010,2020-12-21 17:39:44
Jammu and Kashmir,22032,112093,1837,21887,42115,1024,65026,118006,2020-12-21 17:39:44
Jharkhand,13791,110125,1010,13504,58543,626,72673,112853,2020-12-21 17:39:44
Karnataka,98062,881882,12004,95354,423377,8145,526876,908275,2020-12-21 17:39:44
Kerala,39484,636814,2786,39354,98724,553,138631,700158,2020-12-21 17:39:44
Ladakh,1013,8723,124,1047,2735,50,3832,9270,2020-12-21 17:39:44
Lakshadweep,0,0,0,0,0,0,0,0,2020-12-21 17:39:44
Madhya Pradesh,22300,215211,3468,22542,83618,2007,108167,230125,2020-12-21 17:39:44
Maharashtra,291630,1781841,48648,275017,916348,33015,1224380,1892707,2020-12-21 17:39:44
Manipur,2070,25512,336,2113,6838,59,9010,27598,2020-12-21 17:39:44
Meghalaya,2111,12531,133,2169,2527,37,4733,13221,2020-12-21 17:39:44
Mizoram,583,3957,7,680,1012,0,1692,4122,2020-12-21 17:39:44
Nagaland,1184,11230,73,1052,4477,15,5544,11841,2020-12-21 17:39:44
Odisha,33504,321309,1832,34033,149379,710,184122,325861,2020-12-21 17:39:44
Puducherry,4908,36752,624,4659,18065,467,23191,37715,2020-12-21 17:39:44
Punjab,22278,151679,5189,21661,75409,2860,99930,162705,2020-12-21 17:39:44
Rajasthan,18184,282631,2608,18245,97284,1352,116881,298018,2020-12-21 17:39:44
Sikkim,469,5037,123,513,1986,29,2528,5561,2020-12-21 17:39:44
Tamil Nadu,46703,784117,11968,46495,491971,8871,547337,805777,2020-12-21 17:39:44
Telengana,29636,273013,1513,29649,144073,1052,174774,281414,2020-12-21 17:39:44
Tripura,6566,32532,378,6700,15883,251,22834,33167,2020-12-21 17:39:44
Uttarakhand,12455,547631,8177,12075,29201,501,41777,573401,2020-12-21 17:39:44
Uttar Pradesh,65954,78371,1408,64164,289594,5135,358893,85853,2020-12-21 17:39:44
West Bengal,24806,507070,9320,24898,198983,4421,228302,534850,2020-12-21 17:39:44
Andaman and Nicobar Islands,147,4732,61,152,3469,52,3673,4881,2020-12-22 17:39:44
Andhra Pradesh,78836,867445,7076,74518,551821,5410,631749,878723,2020-12-22 17:39:44
Arunachal Pradesh,1964,16350,55,1939,5643,13,7595,16630,2020-12-22 17:39:44
Assam,28780,210872,1017,29609,129133,578,159320,215409,2020-12-22 17:39:44
Bihar,13005,239693,1352,12539,156242,870,169651,246185,2020-12-22 17:39:44
Chandigarh,2821,18328,308,2761,7411,126,10298,19073,2020-12-22 17:39:44
Chhattisgarh,37853,247480,3181,37927,49564,690,88181,267219,2020-12-22 17:39:44
Dadra and Nagar Haveli and Daman and Diu,229,3352,2,220,2711,2,2933,3363,2020-12-22 17:39:44
Delhi,32097,596580,10277,30941,213304,5014,249259,617005,2020-12-22 17:39:44
Goa,5781,48371,721,5667,22726,360,28753,50064,2020-12-22 17:39:44
Gujarat,16208,219125,4234,16305,104964,3336,124605,235299,2020-12-22 17:39:44
Haryana,21411,248935,2821,21014,90884,1177,113075,257644,2020-12-22 17:39:44
Himachal Pradesh,4444,46257,876,4458,7853,127,12438,52329,2020-12-22 17:39:44
Jammu and Kashmir,22032,112568,1841,21887,42115,1024,65026,118263,2020-12-22 17:39:44
Jharkhand,13791,110307,1010,13504,58543,626,72673,113025,2020-12-22 17:39:44
Karnataka,98062,882944,12009,95354,423377,8145,526876,909469,2020-12-22 17:39:44
Kerala,39484,641285,2816,39354,98724,553,138631,705869,2020-12-22 17:39:44
Ladakh,1013,8801,124,1047,2735,50,3832,9279,2020-12-22 17:39:44
Lakshadweep,0,0,0,0,0,0,0,0,2020-12-22 17:39:44
Madhya Pradesh,22300,216485,3481,22542,83618,2007,108167,231284,2020-12-22 17:39:44
Maharashtra,291630,1783905,48746,275017,916348,33015,1224380,1896518,2020-12-22 17:39:44
Manipur,2070,25646,337,2113,6838,59,9010,27646,2020-12-22 17:39:44
Meghalaya,2111,12620,134,2169,2527,37,4733,13253,2020-12-22 17:39:44
Mizoram,583,3963,7,680,1012,0,1692,4124,2020-12-22 17:39:44
Nagaland,1184,11273,73,1052,4477,15,5544,11842,2020-12-22 17:39:44
Odisha,33504,321647,1836,34033,149379,710,184122,326233,2020-12-22 17:39:44
Puducherry,4908,36777,626,4659,18065,467,23191,37748,2020-12-22 17:39:44
Punjab,22278,152223,5201,21661,75409,2860,99930,163042,2020-12-22 17:39:44
Rajasthan,18184,283957,2617,18245,97284,1352,116881,298996,2020-12-22 17:39:44
Sikkim,469,5075,124,513,1986,29,2528,5573,2020-12-22 17:39:44
Tamil Nadu,46703,785315,11983,46495,491971,8871,547337,806891,2020-12-22 17:39:44
Telengana,29636,273625,1515,29649,144073,1052,174774,281730,2020-12-22 17:39:44
Tripura,6566,32561,380,6700,15883,251,22834,33175,2020-12-22 17:39:44
Uttarakhand,12455,549190,8196,12075,29201,501,41777,574631,2020-12-22 17:39:44
Uttar Pradesh,65954,78727,1413,64164,289594,5135,358893,86317,2020-12-22 17:39:44
West Bengal,24806,509697,9360,24898,198983,4421,228302,536828,2020-12-22 17:39:44
Andaman and Nicobar Islands,86,4740,62,82,4749,62,4893,4888,2020-12-23 11:14:25.051554
Andhra Pradesh,3992,867867,7078,3978,868279,7082,879339,878937,2020-12-23 11:14:25.051554
Arunachal Pradesh,227,16369,56,222,16379,56,16657,16652,2020-12-23 11:14:25.051554
Assam,3525,210965,1020,3483,211078,1024,215585,215510,2020-12-23 11:14:25.051554
Bihar,4991,240219,1358,5030,240716,1362,247108,246568,2020-12-23 11:14:25.051554
Chandigarh,389,18429,310,364,18508,312,19184,19128,2020-12-23 11:14:25.051554
Chhattisgarh,16060,249218,3199,15879,250766,3212,269857,268477,2020-12-23 11:14:25.051554
Dadra and Nagar Haveli and Daman and Diu,7,3354,2,5,3357,2,3364,3363,2020-12-23 11:14:25.051554
Delhi,9255,598249,10304,8735,599683,10329,618747,617808,2020-12-23 11:14:25.051554
Goa,941,48479,723,947,48567,725,50239,50143,2020-12-23 11:14:25.051554
Gujarat,11625,220393,4241,11397,221602,4248,237247,236259,2020-12-23 11:14:25.051554
Haryana,5525,249840,2832,5387,250502,2842,258731,258197,2020-12-23 11:14:25.051554
Himachal Pradesh,4886,46852,885,4791,47275,889,52955,52623,2020-12-23 11:14:25.051554
Jammu and Kashmir,3625,113026,1844,3646,113307,1850,118803,118495,2020-12-23 11:14:25.051554
Jharkhand,1675,110512,1011,1635,110758,1014,113407,113198,2020-12-23 11:14:25.051554
Karnataka,14020,884205,12016,14012,885341,12029,911382,910241,2020-12-23 11:14:25.051554
Kerala,60670,645779,2843,61635,650836,2870,715341,709292,2020-12-23 11:14:25.051554
Ladakh,309,8852,125,270,8901,125,9296,9286,2020-12-23 11:14:25.051554
Lakshadweep,0,0,0,0,0,0,0,0,2020-12-23 11:14:25.051554
Madhya Pradesh,11054,217775,3490,10994,218828,3502,233324,232319,2020-12-23 11:14:25.051554
Maharashtra,60593,1789958,48801,59502,1794080,48876,1902458,1899352,2020-12-23 11:14:25.051554
Manipur,1568,25779,337,1458,25928,337,27723,27684,2020-12-23 11:14:25.051554
Meghalaya,432,12692,134,430,12735,134,13299,13258,2020-12-23 11:14:25.051554
Mizoram,153,3973,7,145,3989,7,4141,4133,2020-12-23 11:14:25.051554
Nagaland,462,11323,73,417,11373,76,11866,11858,2020-12-23 11:14:25.051554
Odisha,2801,321956,1839,2728,322344,1843,326915,326596,2020-12-23 11:14:25.051554
Puducherry,332,36803,627,360,36822,629,37811,37762,2020-12-23 11:14:25.051554
Punjab,5408,152758,5212,5053,153382,5230,163665,163378,2020-12-23 11:14:25.051554
Rajasthan,11961,285322,2626,11601,286481,2634,300716,299909,2020-12-23 11:14:25.051554
Sikkim,360,5092,124,378,5108,124,5610,5576,2020-12-23 11:14:25.051554
Tamil Nadu,9495,786472,11995,9391,787611,12012,809014,807962,2020-12-23 11:14:25.051554
Telengana,6569,274260,1518,6627,274833,1522,282982,282347,2020-12-23 11:14:25.051554
Tripura,213,32595,380,207,32613,383,33203,33188,2020-12-23 11:14:25.051554
Uttarakhand,5584,79755,1426,5512,80425,1439,87376,86765,2020-12-23 11:14:25.051554
Uttar Pradesh,16822,550587,8212,16691,551917,8224,576832,575621,2020-12-23 11:14:25.051554
West Bengal,16903,512039,9401,16248,514309,9439,539996,538343,2020-12-23 11:14:25.051554
Andaman and Nicobar Islands,82,4749,62,73,4761,62,4896,4893,2020-12-24 20:00:14.737698
Andhra Pradesh,3978,868279,7082,3864,868769,7085,879718,879339,2020-12-24 20:00:14.737698
Arunachal Pradesh,222,16379,56,212,16401,56,16669,16657,2020-12-24 20:00:14.737698
Assam,3483,211078,1024,3470,211181,1029,215680,215585,2020-12-24 20:00:14.737698
Bihar,5030,240716,1362,5408,241031,1368,247807,247108,2020-12-24 20:00:14.737698
Chandigarh,364,18508,312,369,18584,313,19266,19184,2020-12-24 20:00:14.737698
Chhattisgarh,15879,250766,3212,15635,252332,3227,271194,269857,2020-12-24 20:00:14.737698
Dadra and Nagar Haveli and Daman and Diu,5,3357,2,6,3357,2,3365,3364,2020-12-24 20:00:14.737698
Delhi,8735,599683,10329,8003,601268,10347,619618,618747,2020-12-24 20:00:14.737698
Goa,947,48567,725,1000,48637,727,50364,50239,2020-12-24 20:00:14.737698
Gujarat,11397,221602,4248,11040,222911,4254,238205,237247,2020-12-24 20:00:14.737698
Haryana,5387,250502,2842,5230,251149,2847,259226,258731,2020-12-24 20:00:14.737698
Himachal Pradesh,4791,47275,889,4629,47869,894,53392,52955,2020-12-24 20:00:14.737698
Jammu and Kashmir,3646,113307,1850,3555,113645,1853,119053,118803,2020-12-24 20:00:14.737698
Jharkhand,1635,110758,1014,1633,110962,1014,113609,113407,2020-12-24 20:00:14.737698
Karnataka,14012,885341,12029,13755,886547,12038,912340,911382,2020-12-24 20:00:14.737698
Kerala,61635,650836,2870,62974,655644,2892,721510,715341,2020-12-24 20:00:14.737698
Ladakh,270,8901,125,237,8947,125,9309,9296,2020-12-24 20:00:14.737698
Lakshadweep,0,0,0,0,0,0,0,0,2020-12-24 20:00:14.737698
Madhya Pradesh,10994,218828,3502,10766,220051,3514,234331,233324,2020-12-24 20:00:14.737698
Maharashtra,59502,1794080,48876,55702,1801700,48969,1906371,1902458,2020-12-24 20:00:14.737698
Manipur,1458,25928,337,1459,26030,338,27827,27723,2020-12-24 20:00:14.737698
Meghalaya,430,12735,134,299,12894,135,13328,13299,2020-12-24 20:00:14.737698
Mizoram,145,3989,7,140,4008,8,4156,4141,2020-12-24 20:00:14.737698
Nagaland,417,11373,76,377,11423,77,11877,11866,2020-12-24 20:00:14.737698
Odisha,2728,322344,1843,2785,322648,1846,327279,326915,2020-12-24 20:00:14.737698
Puducherry,360,36822,629,350,36866,629,37845,37811,2020-12-24 20:00:14.737698
Punjab,5053,153382,5230,4938,153964,5243,164145,163665,2020-12-24 20:00:14.737698
Rajasthan,11601,286481,2634,11648,287418,2642,301708,300716,2020-12-24 20:00:14.737698
Sikkim,378,5108,124,397,5110,125,5632,5610,2020-12-24 20:00:14.737698
Tamil Nadu,9391,787611,12012,9314,788742,12024,810080,809014,2020-12-24 20:00:14.737698
Telengana,6627,274833,1522,6815,275217,1524,283556,282982,2020-12-24 20:00:14.737698
Tripura,207,32613,383,192,32640,384,33216,33203,2020-12-24 20:00:14.737698
Uttarakhand,5512,80425,1439,5507,80986,1447,87940,87376,2020-12-24 20:00:14.737698
Uttar Pradesh,16691,551917,8224,16378,553019,8245,577642,576832,2020-12-24 20:00:14.737698
West Bengal,16248,514309,9439,15689,516462,9473,541624,539996,2020-12-24 20:00:14.737698
Andaman and Nicobar Islands,147,4761,62,152,3469,52,3673,4896,2020-12-25 17:39:44
Andhra Pradesh,78836,868769,7085,74518,551821,5410,631749,879718,2020-12-25 17:39:44
Arunachal Pradesh,1964,16401,56,1939,5643,13,7595,16669,2020-12-25 17:39:44
Assam,28780,211181,1029,29609,129133,578,159320,215680,2020-12-25 17:39:44
Bihar,13005,241031,1368,12539,156242,870,169651,247807,2020-12-25 17:39:44
Chandigarh,2821,18584,313,2761,7411,126,10298,19266,2020-12-25 17:39:44
Chhattisgarh,37853,252332,3227,37927,49564,690,88181,271194,2020-12-25 17:39:44
Dadra and Nagar Haveli and Daman and Diu,229,3357,2,220,2711,2,2933,3365,2020-12-25 17:39:44
Delhi,32097,601268,10347,30941,213304,5014,249259,619618,2020-12-25 17:39:44
Goa,5781,48637,727,5667,22726,360,28753,50364,2020-12-25 17:39:44
Gujarat,16208,222911,4254,16305,104964,3336,124605,238205,2020-12-25 17:39:44
Haryana,21411,251149,2847,21014,90884,1177,113075,259226,2020-12-25 17:39:44
Himachal Pradesh,4444,47869,894,4458,7853,127,12438,53392,2020-12-25 17:39:44
Jammu and Kashmir,22032,113645,1853,21887,42115,1024,65026,119053,2020-12-25 17:39:44
Jharkhand,13791,110962,1014,13504,58543,626,72673,113609,2020-12-25 17:39:44
Karnataka,98062,886547,12038,95354,423377,8145,526876,912340,2020-12-25 17:39:44
Kerala,39484,655644,2892,39354,98724,553,138631,721510,2020-12-25 17:39:44
Ladakh,1013,8947,125,1047,2735,50,3832,9309,2020-12-25 17:39:44
Lakshadweep,0,0,0,0,0,0,0,0,2020-12-25 17:39:44
Madhya Pradesh,22300,220051,3514,22542,83618,2007,108167,234331,2020-12-25 17:39:44
Maharashtra,291630,1801700,48969,275017,916348,33015,1224380,1906371,2020-12-25 17:39:44
Manipur,2070,26030,338,2113,6838,59,9010,27827,2020-12-25 17:39:44
Meghalaya,2111,12894,135,2169,2527,37,4733,13328,2020-12-25 17:39:44
Mizoram,583,4008,8,680,1012,0,1692,4156,2020-12-25 17:39:44
Nagaland,1184,11423,77,1052,4477,15,5544,11877,2020-12-25 17:39:44
Odisha,33504,322648,1846,34033,149379,710,184122,327279,2020-12-25 17:39:44
Puducherry,4908,36866,629,4659,18065,467,23191,37845,2020-12-25 17:39:44
Punjab,22278,153964,5243,21661,75409,2860,99930,164145,2020-12-25 17:39:44
Rajasthan,18184,287418,2642,18245,97284,1352,116881,301708,2020-12-25 17:39:44
Sikkim,469,5110,125,513,1986,29,2528,5632,2020-12-25 17:39:44
Tamil Nadu,46703,788742,12024,46495,491971,8871,547337,810080,2020-12-25 17:39:44
Telengana,29636,275217,1524,29649,144073,1052,174774,283556,2020-12-25 17:39:44
Tripura,6566,32640,384,6700,15883,251,22834,33216,2020-12-25 17:39:44
Uttarakhand,12455,553019,8245,12075,29201,501,41777,577642,2020-12-25 17:39:44
Uttar Pradesh,65954,80986,1447,64164,289594,5135,358893,87940,2020-12-25 17:39:44
West Bengal,24806,516462,9473,24898,198983,4421,228302,541624,2020-12-25 17:39:44
Andaman and Nicobar Islands,64,4775,62,69,4781,62,4912,4901,2020-12-26 19:24:29.613929
Andhra Pradesh,3862,869124,7089,3861,869478,7091,880430,880075,2020-12-26 19:24:29.613929
Arunachal Pradesh,184,16438,56,168,16454,56,16678,16678,2020-12-26 19:24:29.613929
Assam,3456,211286,1033,3422,211381,1033,215836,215775,2020-12-26 19:24:29.613929
Bihar,5434,241546,1371,5504,242068,1373,248945,248351,2020-12-26 19:24:29.613929
Chandigarh,361,18634,314,345,18686,314,19345,19309,2020-12-26 19:24:29.613929
Chhattisgarh,15153,254024,3249,14759,255257,3263,273279,272426,2020-12-26 19:24:29.613929
Dadra and Nagar Haveli and Daman and Diu,8,3357,2,11,3357,2,3370,3367,2020-12-26 19:24:29.613929
Delhi,7909,602388,10384,7267,603758,10414,621439,620681,2020-12-26 19:24:29.613929
Goa,1001,48725,728,980,48826,728,50534,50454,2020-12-26 19:24:29.613929
Gujarat,10841,224092,4262,10631,225206,4268,240105,239195,2020-12-26 19:24:29.613929
Haryana,4983,251908,2854,4750,252545,2858,260153,259745,2020-12-26 19:24:29.613929
Himachal Pradesh,4681,48186,899,4347,48809,902,54058,53766,2020-12-26 19:24:29.613929
Jammu and Kashmir,3540,113944,1860,3414,114353,1861,119628,119344,2020-12-26 19:24:29.613929
Jharkhand,1595,111175,1016,1587,111351,1016,113954,113786,2020-12-26 19:24:29.613929
Karnataka,13629,887815,12039,13527,888917,12044,914488,913483,2020-12-26 19:24:29.613929
Kerala,63328,660445,2914,64203,664951,2930,732084,726687,2020-12-26 19:24:29.613929
Ladakh,246,8969,126,209,9020,126,9355,9341,2020-12-26 19:24:29.613929
Lakshadweep,0,0,0,0,0,0,0,0,2020-12-26 19:24:29.613929
Madhya Pradesh,10676,221169,3524,10461,222403,3536,236400,235369,2020-12-26 19:24:29.613929
Maharashtra,56022,1804871,49058,57955,1806298,49129,1913382,1909951,2020-12-26 19:24:29.613929
Manipur,1362,26173,341,1352,26247,344,27943,27876,2020-12-26 19:24:29.613929
Meghalaya,283,12922,135,294,12940,135,13369,13340,2020-12-26 19:24:29.613929
Mizoram,146,4024,8,134,4036,8,4178,4178,2020-12-26 19:24:29.613929
Nagaland,305,11508,77,274,11544,77,11895,11890,2020-12-26 19:24:29.613929
Odisha,2720,322972,1850,2636,323378,1853,327867,327542,2020-12-26 19:24:29.613929
Puducherry,364,36892,629,349,36936,629,37914,37885,2020-12-26 19:24:29.613929
Punjab,4812,154433,5260,4707,154845,5269,164821,164505,2020-12-26 19:24:29.613929
Rajasthan,11671,288388,2650,11700,289375,2657,303732,302709,2020-12-26 19:24:29.613929
Sikkim,420,5119,125,417,5142,125,5684,5664,2020-12-26 19:24:29.613929
Tamil Nadu,9217,789862,12036,9129,790965,12048,812142,811115,2020-12-26 19:24:29.613929
Telengana,6839,275708,1527,6618,276244,1529,284391,284074,2020-12-26 19:24:29.613929
Tripura,184,32657,384,169,32672,385,33226,33225,2020-12-26 19:24:29.613929
Uttarakhand,5331,81587,1458,5510,81871,1463,88844,88376,2020-12-26 19:24:29.613929
Uttar Pradesh,16099,554202,8267,16159,555544,8279,579982,578568,2020-12-26 19:24:29.613929
West Bengal,15193,518516,9505,14749,520470,9536,544755,543214,2020-12-26 19:24:29.613929
Andaman and Nicobar Islands,69,4781,62,61,4789,62,4912,4912,2020-12-27 18:57:10.322124
Andhra Pradesh,3861,869478,7091,3700,869920,7092,880712,880430,2020-12-27 18:57:10.322124
Arunachal Pradesh,168,16454,56,154,16477,56,16687,16678,2020-12-27 18:57:10.322124
Assam,3422,211381,1033,3389,211486,1035,215910,215836,2020-12-27 18:57:10.322124
Bihar,5504,242068,1373,5257,242767,1379,249403,248945,2020-12-27 18:57:10.322124
Chandigarh,345,18686,314,354,18754,315,19423,19345,2020-12-27 18:57:10.322124
Chhattisgarh,14759,255257,3263,14028,257021,3275,274324,273279,2020-12-27 18:57:10.322124
Dadra and Nagar Haveli and Daman and Diu,11,3357,2,8,3362,2,3372,3370,2020-12-27 18:57:10.322124
Delhi,7267,603758,10414,6911,604746,10437,622094,621439,2020-12-27 18:57:10.322124
Goa,980,48826,728,951,48913,731,50595,50534,2020-12-27 18:57:10.322124
Gujarat,10631,225206,4268,10512,226208,4275,240995,240105,2020-12-27 18:57:10.322124
Haryana,4750,252545,2858,4535,253145,2865,260545,260153,2020-12-27 18:57:10.322124
Himachal Pradesh,4347,48809,902,4291,49076,913,54280,54058,2020-12-27 18:57:10.322124
Jammu and Kashmir,3414,114353,1861,3288,114722,1867,119877,119628,2020-12-27 18:57:10.322124
Jharkhand,1587,111351,1016,1598,111530,1018,114146,113954,2020-12-27 18:57:10.322124
Karnataka,13527,888917,12044,13413,889881,12051,915345,914488,2020-12-27 18:57:10.322124
Kerala,64203,664951,2930,63927,668733,2951,735611,732084,2020-12-27 18:57:10.322124
Ladakh,209,9020,126,217,9051,126,9394,9355,2020-12-27 18:57:10.322124
Lakshadweep,0,0,0,0,0,0,0,0,2020-12-27 18:57:10.322124
Madhya Pradesh,10461,222403,3536,10329,223532,3545,237406,236400,2020-12-27 18:57:10.322124
Maharashtra,57955,1806298,49129,59223,1807824,49189,1916236,1913382,2020-12-27 18:57:10.322124
Manipur,1352,26247,344,1301,26331,344,27976,27943,2020-12-27 18:57:10.322124
Meghalaya,294,12940,135,248,12985,138,13371,13369,2020-12-27 18:57:10.322124
Mizoram,134,4036,8,128,4046,8,4182,4178,2020-12-27 18:57:10.322124
Nagaland,274,11544,77,274,11545,78,11897,11895,2020-12-27 18:57:10.322124
Odisha,2636,323378,1853,2595,323749,1857,328201,327867,2020-12-27 18:57:10.322124
Puducherry,349,36936,629,355,36962,630,37947,37914,2020-12-27 18:57:10.322124
Punjab,4707,154845,5269,4436,155409,5281,165126,164821,2020-12-27 18:57:10.322124
Rajasthan,11700,289375,2657,11488,290365,2664,304517,303732,2020-12-27 18:57:10.322124
Sikkim,417,5142,125,517,5157,125,5799,5684,2020-12-27 18:57:10.322124
Tamil Nadu,9129,790965,12048,9039,792063,12059,813161,812142,2020-12-27 18:57:10.322124
Telengana,6618,276244,1529,6579,276753,1531,284863,284391,2020-12-27 18:57:10.322124
Tripura,169,32672,385,157,32695,385,33237,33226,2020-12-27 18:57:10.322124
Uttarakhand,5510,81871,1463,5444,82298,1476,89218,88844,2020-12-27 18:57:10.322124
Uttar Pradesh,16159,555544,8279,15875,556912,8293,581080,579982,2020-12-27 18:57:10.322124
West Bengal,14749,520470,9536,14108,522331,9569,546008,544755,2020-12-27 18:57:10.322124
Andaman and Nicobar Islands,61,4789,62,64,4798,62,4924,4912,2020-12-28 20:00:41.224903
Andhra Pradesh,3700,869920,7092,3625,870342,7094,881061,880712,2020-12-28 20:00:41.224903
Arunachal Pradesh,154,16477,56,130,16503,56,16689,16687,2020-12-28 20:00:41.224903
Assam,3389,211486,1035,3356,211546,1037,215939,215910,2020-12-28 20:00:41.224903
Bihar,5257,242767,1379,5068,243461,1383,249912,249403,2020-12-28 20:00:41.224903
Chandigarh,354,18754,315,361,18810,315,19486,19423,2020-12-28 20:00:41.224903
Chhattisgarh,14028,257021,3275,13701,258155,3293,275149,274324,2020-12-28 20:00:41.224903
Dadra and Nagar Haveli and Daman and Diu,8,3362,2,9,3362,2,3373,3372,2020-12-28 20:00:41.224903
Delhi,6911,604746,10437,6713,605685,10453,622851,622094,2020-12-28 20:00:41.224903
Goa,951,48913,731,944,48992,731,50667,50595,2020-12-28 20:00:41.224903
Gujarat,10512,226208,4275,10435,227128,4282,241845,240995,2020-12-28 20:00:41.224903
Haryana,4535,253145,2865,4268,253765,2874,260907,260545,2020-12-28 20:00:41.224903
Himachal Pradesh,4291,49076,913,3834,49685,919,54438,54280,2020-12-28 20:00:41.224903
Jammu and Kashmir,3288,114722,1867,3284,114986,1867,120137,119877,2020-12-28 20:00:41.224903
Jharkhand,1598,111530,1018,1585,111664,1019,114268,114146,2020-12-28 20:00:41.224903
Karnataka,13413,889881,12051,13099,891095,12062,916256,915345,2020-12-28 20:00:41.224903
Kerala,63927,668733,2951,65344,672196,2976,740516,735611,2020-12-28 20:00:41.224903
Ladakh,217,9051,126,208,9072,126,9406,9394,2020-12-28 20:00:41.224903
Lakshadweep,0,0,0,0,0,0,0,0,2020-12-28 20:00:41.224903
Madhya Pradesh,10329,223532,3545,10097,224692,3563,238352,237406,2020-12-28 20:00:41.224903
Maharashtra,59223,1807824,49189,60347,1809948,49255,1919550,1916236,2020-12-28 20:00:41.224903
Manipur,1301,26331,344,1277,26404,348,28029,27976,2020-12-28 20:00:41.224903
Meghalaya,248,12985,138,226,13012,138,13376,13371,2020-12-28 20:00:41.224903
Mizoram,128,4046,8,127,4049,8,4184,4182,2020-12-28 20:00:41.224903
Nagaland,274,11545,78,251,11568,78,11897,11897,2020-12-28 20:00:41.224903
Odisha,2595,323749,1857,2575,324068,1861,328504,328201,2020-12-28 20:00:41.224903
Puducherry,355,36962,630,359,37005,631,37995,37947,2020-12-28 20:00:41.224903
Punjab,4436,155409,5281,4214,155892,5299,165405,165126,2020-12-28 20:00:41.224903
Rajasthan,11488,290365,2664,11157,291533,2670,305360,304517,2020-12-28 20:00:41.224903
Sikkim,517,5157,125,547,5173,125,5845,5799,2020-12-28 20:00:41.224903
Tamil Nadu,9039,792063,12059,8947,793154,12069,814170,813161,2020-12-28 20:00:41.224903
Telengana,6579,276753,1531,6231,277304,1533,285068,284863,2020-12-28 20:00:41.224903
Tripura,157,32695,385,148,32711,385,33244,33237,2020-12-28 20:00:41.224903
Uttarakhand,5444,82298,1476,5625,82537,1483,89645,89218,2020-12-28 20:00:41.224903
Uttar Pradesh,15875,556912,8293,15371,558303,8306,581980,581080,2020-12-28 20:00:41.224903
West Bengal,14108,522331,9569,13774,524071,9598,547443,546008,2020-12-28 20:00:41.224903
Andaman and Nicobar Islands,64,4798,62,64,4803,62,4929,4924,2020-12-29 20:11:01.450855
Andhra Pradesh,3625,870342,7094,3423,870752,7098,881273,881061,2020-12-29 20:11:01.450855
Arunachal Pradesh,130,16503,56,119,16521,56,16696,16689,2020-12-29 20:11:01.450855
Assam,3356,211546,1037,3323,211636,1038,215997,215939,2020-12-29 20:11:01.450855
Bihar,5068,243461,1383,4928,244076,1386,250390,249912,2020-12-29 20:11:01.450855
Chandigarh,361,18810,315,379,18856,316,19551,19486,2020-12-29 20:11:01.450855
Chhattisgarh,13701,258155,3293,12962,260056,3319,276337,275149,2020-12-29 20:11:01.450855
Dadra and Nagar Haveli and Daman and Diu,9,3362,2,9,3363,2,3374,3373,2020-12-29 20:11:01.450855
Delhi,6713,605685,10453,6297,606644,10474,623415,622851,2020-12-29 20:11:01.450855
Goa,944,48992,731,955,49083,734,50772,50667,2020-12-29 20:11:01.450855
Gujarat,10435,227128,4282,10223,228144,4288,242655,241845,2020-12-29 20:11:01.450855
Haryana,4268,253765,2874,4040,254336,2882,261258,260907,2020-12-29 20:11:01.450855
Himachal Pradesh,3834,49685,919,3680,50079,921,54680,54438,2020-12-29 20:11:01.450855
Jammu and Kashmir,3284,114986,1867,3157,115261,1875,120293,120137,2020-12-29 20:11:01.450855
Jharkhand,1585,111664,1019,1582,111818,1020,114420,114268,2020-12-29 20:11:01.450855
Karnataka,13099,891095,12062,12566,892273,12070,916909,916256,2020-12-29 20:11:01.450855
Kerala,65344,672196,2976,64205,676368,2990,743563,740516,2020-12-29 20:11:01.450855
Ladakh,208,9072,126,197,9088,126,9411,9406,2020-12-29 20:11:01.450855
Lakshadweep,0,0,0,0,0,0,0,0,2020-12-29 20:11:01.450855
Madhya Pradesh,10097,224692,3563,9874,225782,3572,239228,238352,2020-12-29 20:11:01.450855
Maharashtra,60347,1809948,49255,58294,1814449,49305,1922048,1919550,2020-12-29 20:11:01.450855
Manipur,1277,26404,348,1234,26478,348,28060,28029,2020-12-29 20:11:01.450855
Meghalaya,226,13012,138,199,13042,138,13379,13376,2020-12-29 20:11:01.450855
Mizoram,127,4049,8,114,4068,8,4190,4184,2020-12-29 20:11:01.450855
Nagaland,251,11568,78,243,11589,79,11911,11897,2020-12-29 20:11:01.450855
Odisha,2575,324068,1861,2482,324392,1864,328738,328504,2020-12-29 20:11:01.450855
Puducherry,359,37005,631,357,37040,631,38028,37995,2020-12-29 20:11:01.450855
Punjab,4214,155892,5299,4014,156342,5312,165668,165405,2020-12-29 20:11:01.450855
Rajasthan,11157,291533,2670,10742,292739,2677,306158,305360,2020-12-29 20:11:01.450855
Sikkim,547,5173,125,531,5188,126,5845,5845,2020-12-29 20:11:01.450855
Tamil Nadu,8947,793154,12069,8867,794228,12080,815175,814170,2020-12-29 20:11:01.450855
Telengana,6231,277304,1533,5999,277931,1535,285465,285068,2020-12-29 20:11:01.450855
Tripura,148,32711,385,140,32721,385,33246,33244,2020-12-29 20:11:01.450855
Uttarakhand,5625,82537,1483,5511,82850,1489,89850,89645,2020-12-29 20:11:01.450855
Uttar Pradesh,15371,558303,8306,14710,559888,8322,582920,581980,2020-12-29 20:11:01.450855
West Bengal,13774,524071,9598,13161,525685,9625,548471,547443,2020-12-29 20:11:01.450855
Andaman and Nicobar Islands,64,4803,62,63,4811,62,4936,4929,2020-12-30 20:38:01.087353
Andhra Pradesh,3423,870752,7098,3383,871116,7100,881599,881273,2020-12-30 20:38:01.087353
Arunachal Pradesh,119,16521,56,115,16538,56,16709,16696,2020-12-30 20:38:01.087353
Assam,3323,211636,1038,3300,211723,1040,216063,215997,2020-12-30 20:38:01.087353
Bihar,4928,244076,1386,4940,244599,1389,250928,250390,2020-12-30 20:38:01.087353
Chandigarh,379,18856,316,362,18937,316,19615,19551,2020-12-30 20:38:01.087353
Chhattisgarh,12962,260056,3319,12472,261663,3336,277471,276337,2020-12-30 20:38:01.087353
Dadra and Nagar Haveli and Daman and Diu,9,3363,2,9,3364,2,3375,3374,2020-12-30 20:38:01.087353
Delhi,6297,606644,10474,6122,607494,10502,624118,623415,2020-12-30 20:38:01.087353
Goa,955,49083,734,950,49199,735,50884,50772,2020-12-30 20:38:01.087353
Gujarat,10223,228144,4288,10021,229143,4295,243459,242655,2020-12-30 20:38:01.087353
Haryana,4040,254336,2882,3900,254880,2892,261672,261258,2020-12-30 20:38:01.087353
Himachal Pradesh,3680,50079,921,3338,50631,925,54894,54680,2020-12-30 20:38:01.087353
Jammu and Kashmir,3157,115261,1875,3088,115560,1879,120527,120293,2020-12-30 20:38:01.087353
Jharkhand,1582,111818,1020,1604,112021,1025,114650,114420,2020-12-30 20:38:01.087353
Karnataka,12566,892273,12070,11880,893617,12074,917571,916909,2020-12-30 20:38:01.087353
Kerala,64205,676368,2990,65039,681397,3014,749450,743563,2020-12-30 20:38:01.087353
Ladakh,197,9088,126,209,9100,127,9436,9411,2020-12-30 20:38:01.087353
Lakshadweep,0,0,0,0,0,0,0,0,2020-12-30 20:38:01.087353
Madhya Pradesh,9874,225782,3572,9595,226904,3582,240081,239228,2020-12-30 20:38:01.087353
Maharashtra,58294,1814449,49305,55672,1820021,49373,1925066,1922048,2020-12-30 20:38:01.087353
Manipur,1234,26478,348,1222,26521,353,28096,28060,2020-12-30 20:38:01.087353
Meghalaya,199,13042,138,183,13066,138,13387,13379,2020-12-30 20:38:01.087353
Mizoram,114,4068,8,103,4088,8,4199,4190,2020-12-30 20:38:01.087353
Nagaland,243,11589,79,243,11595,79,11917,11911,2020-12-30 20:38:01.087353
Odisha,2482,324392,1864,2358,324775,1868,329001,328738,2020-12-30 20:38:01.087353
Puducherry,357,37040,631,363,37074,633,38070,38028,2020-12-30 20:38:01.087353
Punjab,4014,156342,5312,3837,156719,5322,165878,165668,2020-12-30 20:38:01.087353
Rajasthan,10742,292739,2677,10213,293888,2683,306784,306158,2020-12-30 20:38:01.087353
Sikkim,531,5188,126,537,5201,126,5864,5845,2020-12-30 20:38:01.087353
Tamil Nadu,8867,794228,12080,8747,795293,12092,816132,815175,2020-12-30 20:38:01.087353
Telengana,5999,277931,1535,5878,278523,1538,285939,285465,2020-12-30 20:38:01.087353
Tripura,140,32721,385,138,32735,385,33258,33246,2020-12-30 20:38:01.087353
Uttarakhand,5511,82850,1489,5256,83416,1495,90167,89850,2020-12-30 20:38:01.087353
Uttar Pradesh,14710,559888,8322,14344,561257,8340,583941,582920,2020-12-30 20:38:01.087353
West Bengal,13161,525685,9625,12788,527272,9655,549715,548471,2020-12-30 20:38:01.087353
Andaman and Nicobar Islands,63,4811,62,59,4820,62,4941,4936,2020-12-31 20:55:28.098661
Andhra Pradesh,3383,871116,7100,3256,871588,7104,881948,881599,2020-12-31 20:55:28.098661
Arunachal Pradesh,115,16538,56,106,16549,56,16711,16709,2020-12-31 20:55:28.098661
Assam,3300,211723,1040,3258,211838,1043,216139,216063,2020-12-31 20:55:28.098661
Bihar,4940,244599,1389,4799,245156,1393,251348,250928,2020-12-31 20:55:28.098661
Chandigarh,362,18937,316,399,18967,316,19682,19615,2020-12-31 20:55:28.098661
Chhattisgarh,12472,261663,3336,11939,263251,3350,278540,277471,2020-12-31 20:55:28.098661
Dadra and Nagar Haveli and Daman and Diu,9,3364,2,9,3364,2,3375,3375,2020-12-31 20:55:28.098661
Delhi,6122,607494,10502,5838,608434,10523,624795,624118,2020-12-31 20:55:28.098661
Goa,950,49199,735,931,49313,737,50981,50884,2020-12-31 20:55:28.098661
Gujarat,10021,229143,4295,9979,229977,4302,244258,243459,2020-12-31 20:55:28.098661
Haryana,3900,254880,2892,3799,255356,2899,262054,261672,2020-12-31 20:55:28.098661
Himachal Pradesh,3338,50631,925,2796,51387,931,55114,54894,2020-12-31 20:55:28.098661
Jammu and Kashmir,3088,115560,1879,3034,115830,1880,120744,120527,2020-12-31 20:55:28.098661
Jharkhand,1604,112021,1025,1640,112206,1027,114873,114650,2020-12-31 20:55:28.098661
Karnataka,11880,893617,12074,11629,894834,12081,918544,917571,2020-12-31 20:55:28.098661
Kerala,65039,681397,3014,65572,687104,3042,755718,749450,2020-12-31 20:55:28.098661
Ladakh,209,9100,127,188,9132,127,9447,9436,2020-12-31 20:55:28.098661
Lakshadweep,0,0,0,0,0,0,0,0,2020-12-31 20:55:28.098661
Madhya Pradesh,9595,226904,3582,9387,227965,3595,240947,240081,2020-12-31 20:55:28.098661
Maharashtra,55672,1820021,49373,54206,1824934,49463,1928603,1925066,2020-12-31 20:55:28.098661
Manipur,1222,26521,353,1182,26601,354,28137,28096,2020-12-31 20:55:28.098661
Meghalaya,183,13066,138,184,13085,139,13408,13387,2020-12-31 20:55:28.098661
Mizoram,103,4088,8,105,4091,8,4204,4199,2020-12-31 20:55:28.098661
Nagaland,243,11595,79,218,11624,79,11921,11917,2020-12-31 20:55:28.098661
Odisha,2358,324775,1868,2332,325103,1871,329306,329001,2020-12-31 20:55:28.098661
Puducherry,363,37074,633,363,37100,633,38096,38070,2020-12-31 20:55:28.098661
Punjab,3837,156719,5322,3865,157043,5331,166239,165878,2020-12-31 20:55:28.098661
Rajasthan,10213,293888,2683,9835,295030,2689,307554,306784,2020-12-31 20:55:28.098661
Sikkim,537,5201,126,532,5218,127,5877,5864,2020-12-31 20:55:28.098661
Tamil Nadu,8747,795293,12092,8615,796353,12109,817077,816132,2020-12-31 20:55:28.098661
Telengana,5878,278523,1538,5974,278839,1541,286354,285939,2020-12-31 20:55:28.098661
Tripura,138,32735,385,128,32751,385,33264,33258,2020-12-31 20:55:28.098661
Uttarakhand,5256,83416,1495,4963,84149,1504,90616,90167,2020-12-31 20:55:28.098661
Uttar Pradesh,14344,561257,8340,14155,562459,8352,584966,583941,2020-12-31 20:55:28.098661
West Bengal,12788,527272,9655,12381,528829,9683,550893,549715,2020-12-31 20:55:28.098661
